AACTAY	actaeon
AALTJ	aaltje
AAMYNA	aamina
AARVN	aaron
ABA	aba
ABAD	abad
ABADA	awadia
ABADHBY	abudhabi
ABAJA	abuja
ABAR	aabar
ABCR	abcher
ABDJA	abidjan
ABDLRHMAN	abdulrahman
ABDVN	labdon
ABH	abe
ABHAY	abhay
ABHY	abhay
ABLA	abella
ABL	abel
ABL	abel
ABLH	able
ABLHYD	adelheid
ABLJ	abeltje
ABLT	ablett
ABLTJ	abeltje
ABLY	abley
ABLYSN	abelson
ABND	abend
ABNR	abner
'ABR	aabar
ABR	aubrie
ABRAHAM	abraham
ABRAHYM	abraham
ABRAHYM	abraham
ABRAM	abram
ABRAMSVN	abramson
ABRAPT	abrupt
ABRAYT	galbraith
ABRBAC	eberbach
ABRG	aberg
ABRG	aberg
ABRKRVMBY	abercrombie
ABRL	amberle
ABRLY	amberle
ABRMSKY	obremski
ABRT	abrupt
ABRT	abrupt
ABRVTR	oberreuter
ABRY	abery
ABRY	abery
ABRYN	cabrini
ABRYNY	cabrini
ABSTGARTN	obstgarten
ABST	pabst
ABSTRKT	abstract
ABT	abbot
ABTYN	abtine
ABV	abe
ABVBA	aboba
ABVDBY	abudhabi
ABVDHABY	abudhabi
ABVHBYB	abudhabi
ABVLYN	abolin
ABVRYMH	eboreime
ABVT	abbot
ABVT	abbot
ABVTSMYT	abbotsmith
ABYA	abia
ABYAB	abiab
ABY	abe
ABY	abe
ABYAD	abiad
ABYAN	abyan
ABYD	abend
ABY	abe
ABYL	abel
ABYLAK	abilock
ABYNA	sabina
ABYNGM	obbingem
ABYNGN	bingen
ACDL	adel
AC	ac
ACR	acrux
ACRNAR	achernar
ACTY	active
ACTYH	active
ACY	ace
ACYLS	ascolese
ACYSVN	acheson
ACYT	acee
ADAB	adab
ADAM	adam
ADAMV	adamo
ADANA	adana
ADAN	adan
ADANL	adan
ADARA	adhara
ADB	adab
ADBRG	edberg
ADGRYNGLND	adgeringelant
ADGRYNGLNT	adgeringelant
ADGYNGTVN	edgington
ADH	ade
ADKAK	adisak
ADKK	adik
ADKRYK	oudekirk
ADKVK	waikiki
ADKYNZ	adkins
ADKYRK	oudekirk
ADLA	adela
'ADL	adel
ADL	adel
ADLARDV	adelardo
ADLAYD	adelaide
ADLAYD	adelaide
ADLHYD	adelheid
ADLMA	adalma
ADL	adel
ADLR	adler
ADLSVN	adelson
ADLY	audley
ADMVND	edmond
ADMVNDS	edmonds
ADMVNDZ	edmond
ADMVNZ	caedmon
ADMYRALN	admiralen
ADMYRALZ	admiral
ADMYSTVN	edmiston
ADNAMS	adnams
ADNAMZ	adnams
ADNBRAG	edenborough
ADNBRG	brandenburg
ADNBRV	adventure
ADNBRVG	edenborough
ADNBVRG	brandenburg
ADRY	audrey
ADRY	audrey
ADRYANA	adriana
ADRYAN	adrian
ADRYANS	adrianas
ADRYN	adriene
ADRYNKLNT	adgeringelant
ADRYNS	aldrins
ADRYNY	adriene
ADRYNY	adriene
ADRYS	audreys
ADSAL	adusumalli
ADST	adsett
ADSVN	madsen
ADT	adit
ADVARD	adelardo
ADVARD	adelardo
ADVARDSN	edwardsson
ADVART	eduwart
ADVLF	adolf
ADVLFSVN	adolfsson
ADVLF	adolf
ADVNCR	adventure
ADVNL	advil
ADVNYS	adonis
ADVSVMALY	adusumalli
ADVVART	eduwart
ADY	eady
ADY	eady
ADY	eady
ADY	eady
ADY	eady
ADYH	radeyah
ADYK	adik
ADYKS	addicks
'ADYL	adel
ADYL	adel
ADYLRD	adelardo
ADYNA	adina
ADYNGTVN	addington
ADYNGTVN	addington
ADYS	adis
ADYSAK	adisak
ADYSVN	addison
ADYT	adit
AFA	afa
AFAF	afaf
AFRA	afra
AFRDYT	alfredo
AFRVDYT	alfredo
AFTAB	aftab
AFV	afou
AFVRYL	aurelio
AFYCART	aphichart
AFYF	afif
AFYGTN	safoutin
AFYNGTN	uffington
AFYS	afros
AFYSR	mafioso
AFYVN	afioun
AFZAL	afzal
AFZL	afzal
AGALY	agali
AGAS	agass
AGATY	agate
AGBRN	ogborn
AGBVRN	ogborn
AG	ag
AGLSTVN	eaglestone
AGMN	ageno
AGMVZ	gomez
AGNDY	agndie
AGNV	agni
AGNVYK	agnew
AGPYAN	agopian
AGR	auger
AGRAVALA	agrawala
AGRN	agren
AGRTN	agren
AGRTVN	egerton
AGRYNGLANT	adgeringelant
AGRYNGLND	adgeringelant
AGVLV	agullo
AGVR	auger
AGVSTV	auguste
AGVSTYN	augustyn
AGVSTYNLY	agostinelli
AGVSTYNY	agostini
AGVYRV	aguero
AGVYV	agoyo
AGYLA	angela
AGYL	argyle
AGYLSVN	eaglestone
AGYNST	against
AHAY	abhay
AHLAND	heiland
AHMAN	ahriman
AHMN	ahriman
AHRN	ahern
AHY	oahu
AHYH	yahweh
AJ	haj
AJAST	ojaste
AJAY	ajay
AJDA	aida
AJLVS	aeolus
AJNT	aint
AJRAYNGLND	carangelo
AJYNGTVN	alington
AJYNTVN	aventine
AKA	aka
AK	aik
AKADMY	akademik
AKADMYK	akademik
AKAKS	aquarius
AKAPADY	accapadi
AKBRG	ekberg
AKBVRN	ayckbourn
AKDAG	akdag
AK	aik
AKGAN	akgun
AKL	akl
AKLAND	oakland
AKLND	oakland
AKLVF	eklof
AKLY	oakley
AKLY	oakley
AKM	akeem
AKMAN	akman
AKMANDNSYS	ekmundensis
AKMANDSYS	ekmundensis
AKMAN	akman
AKMNA	amna
AKMN	akman
AKMR	akemi
AKMVNDNSYS	ekmundensis
AKMY	akemi
AKN	akin
AK	aik
AKR	auker
AKRM	akeem
AKRMAN	ackerman
AKRMN	akron
AKRSAND	eckersand
AKRSLATV	ekerslato
AKRSLYTV	ekerslato
AKRSTV	kristi
AKRT	ackeret
AKRVYD	ackroyd
AKRYL	akrill
AKS	aksu
AKSAYL	faisal
AKSDLM	barksdale
AKSFRD	ashford
AKSFVRD	ashford
AKSFVRD	ashford
AKSKRYTYA	amezquita
AKSLSVN	auslin
AKSLY	paisley
AKSS	xenakiss
AKSTRND	ekstrand
AKSTYN	austen
AKSV	aksu
AKSYL	akil
AKTS	yakuts
AKTVN	aquitaine
AKTVN	aquitaine
AKTY	makoto
AKTYV	akitomo
AKVAL	alukal
AKVAYLA	pakala
AKVAYL	quayle
AKVDV	lakewood
AKVKS	waikiki
AKVNA	aquinas
AKVNR	aquino
AKVSTA	pakistan
AKY	aki
AKY	aki
AKYF	backof
AKYHYKV	akihiko
AKYLA	aqila
AKYLA	aqila
AKYLAH	akilah
AKYL	akil
AKYL	akil
AKYLH	akilah
AKYLS	akilesh
AKYM	akeem
AKYN	akin
AKYTVMV	akitomo
AL'ADYN	alaaldin
ALAHAYDYKYA	alladhiqiyah
ALAHDVD	alhudud
ALALDYN	alaaldin
AL	al
ALAM	alamo
ALAMZ	alamo
ALANA	alana
ALANGKV	kalashnikov
ALAPATY	alapati
ALAQBH	alaqabah
ALARD	allard
ALASR	aleser
ALASVRS	alars
ALAVAY	allaway
ALAVY	malawi
ALAYN	alain
ALAYSDYR	alaisdair
ALAYS	malays
ALBAHAH	albahah
ALBHA	albahah
ALBHAH	albahah
ALBLJH	abeltje
ALBR	alber
ALBRAYT	galbraith
ALBRT	albert
ALBRTYNY	albertini
ALBRY	alberio
ALBRYJ	alberio
ALBVN	albion
ALBVZ	albee
ALBYNGR	albinger
ALDHAYD	almohad
ALDLHLD	adelheid
ALDN	alden
ALDN	alden
ALD	aldo
ALDR	alder
ALDRD	baldred
ALDRYC	aldrich
ALDRYDJ	aldridge
ALDRYG	aldridge
ALDRYG	aldridge
ALDRYJ	aldrin
ALDRYJ	aldrin
ALDRYJ	aldrin
ALDRYJH	aldrich
ALDYN	alden
ALDZ	valdez
ALFA	alfaro
ALF	alf
ALFANSV	alfonso
ALFARV	alfaro
ALF	alf
ALFRD	alford
ALFRDV	alfredo
ALFRS	alfors
ALFRYNG	elfering
ALFVRD	alford
ALFVRD	alford
ALGADV	alegado
ALGARD	aylward
ALGAYN	algerian
ALGRV	alger
ALGSAN	alagesan
ALGY	algie
ALGYNGTVN	alington
ALHDAD	alhudud
ALHDVD	alhudud
ALJ	aeltje
ALJH	aeltje
ALKAN	balkan
ALKBAH	alaqabah
ALKBR	alkabeer
ALKBYR	alkabeer
ALKK	alok
ALKMR	walker
ALKMRH	almeroth
ALKMRY	walker
ALKR	walker
ALKRTN	alkerton
ALKRTVN	alkerton
ALKS	walkers
ALKSANDR	alesandro
ALKSANDRVZ	alesandro
ALKSNDR	alesandro
ALKSY	walkers
ALKSYV	walkers
ALKVAB	alkabeer
ALKVK	waikiki
ALKVR	walker
ALKYNGTN	elkington
ALKYNGTVN	elkington
ALKYNTN	elkinton
ALLADHKYAH	alladhiqiyah
ALLADHYKYAH	alladhiqiyah
ALLAHYGYAH	alladhiqiyah
ALLDHYKYAH	alladhiqiyah
ALLDYKYAH	alladhiqiyah
ALLHYQYH	alladhiqiyah
ALM	alm
ALMAR	palomar
ALMAS	almas
ALMATVN	dalmatian
ALMGRN	almgren
ALMKVAST	almqvist
ALMKVYST	almqvist
ALMN	allman
ALMNTAJ	almintaqah
ALMR	almira
ALMRS	elmers
ALMRVT	almeroth
ALMVD	talmud
ALMVDYVAR	almudevar
ALMV	alamo
ALMVMAN	elmoman
ALMVR	almira
ALMYNAKAH	almintaqah
ALMYNTAGAH	almintaqah
ALMYNTAKAH	almintaqah
ALMYNTAKVA	almintaqah
ALMYNTKH	almintaqah
ALMYRAL	almirall
ALN	alien
ALN	alien
ALND	walend
ALNDR	alcindor
ALN	alien
ALNVR	alnoor
ALNY	aline
ALPN	alpen
ALPRT	alpert
ALPVRT	alpert
AL'QBH	alaqabah
ALRBK	ellerbeck
ALRD	alford
ALRTN	alkerton
ALRTVN	alkerton
ALRVY	alberio
ALRY	malory
ALRYGH	albright
ALRYJ	alberio
ALSANDRY	alesandro
ALSAN	alaskan
ALSAN	alaskan
ALSAP	alsop
ALSAP	alsop
ALSAP	alsop
ALSNDRV	alesandro
ALSN	alison
ALSN	alison
ALSNR	aleser
ALSP	alsop
ALSP	alsop
ALSPD	alsop
ALSR	aleser
ALSTRVM	ahlstrom
ALSVN	alison
ALSVN	alison
ALSVN	alison
ALSVP	alsop
ALSVP	alsop
ALSVRS	alistairs
ALSVRT	alsworth
ALSVZ	kalsow
ALSY	halsey
ALT	alto
ALTANYN	eltanin
ALT	alto
ALTAYR	altair
ALTMAN	altman
ALTMN	altman
ALTMN	altman
ALTRVAYD	aaltruide
ALTRVD	aaltruide
ALTRVYD	aaltruide
ALTRVYYD	aaltruide
ALTSVN	aitsen
ALTV	alto
ALTYR	walter
ALTZ	allowitz
ALVA	alva
ALVAN	alwan
ALVARV	alvaro
ALVARVS	alvaros
ALVARZ	alvarez
ALVAY	alleway
ALVF	alf
ALVKAL	alukal
ALVK	alok
ALVLD	alfeld
ALVRS	alvaros
ALVSA	alisa
ALVVD	alhudud
ALVVD	alhudud
ALVY	alexy
ALVY	alexy
ALVYN	alwyn
ALVYN	alwyn
ALVYN	alwyn
ALVYN	alwyn
ALVYN	alwyn
ALVYS	alves
ALVZ	alonzo
ALXZNA	alzena
'ALYA	alya
ALYA	alya
'ALY	aali
A'LY	aali
ALY	alyx
ALYA	alya
ALYA	alya
A'LYAH	aaliyah
ALYAH	aaliyah
ALY	alyx
ALY	alyx
ALY	alyx
ALYAN	alwan
ALYAS	alias
ALYASVN	eliason
ALYBY	alibey
ALY	alyx
ALY	alyx
ALYFAS	halifaxs
'ALYH	aaliyah
ALYJ	alyx
ALYKS	alexs
ALYLYVNAS	alelyunas
ALYMA	alima
AL'YN	alwyn
ALYN	alwyn
ALYN	alwyn
ALYN	alwyn
ALYN	alwyn
ALYNGR	albinger
ALYNGTVN	alington
ALYNGTVN	alington
ALYN	alwyn
ALYNYK	olenek
ALY	alyx
ALYSA	alisa
ALYS	alexs
ALYS	alexs
ALYS	alexs
ALYSN	alyson
ALYSTVN	alston
ALYSTYR	alistair
ALYSVN	alyson
ALYSVN	alyson
ALYSVN	alyson
ALYSVN	alyson
ALYSYA	alisa
ALYVA	aliya
ALYVRYA	algeria
ALYVT	aleut
ALYVT	aleut
ALYVY	alexy
ALYYA	aliya
ALYZA	galizia
ALYZABT	elizabeth
ALYZ	allyz
ALYZR	balzer
ALZ	alonzo
ALZNA	alzena
ALZN	alzena
ALZVRS	alzheimers
AMA	ama
AMADVR	amador
AMAGYV	gamage
A'MAL	amal
AMAL	amal
AMAND	amand
AMANVAL	emanuel
AMANV	amani
AMANVL	emanuel
AMANVYL	emanuel
AMANY	amani
AMANYVL	emanuel
AMARA	amara
AMARAL	amaral
AMARDYV	amardeo
AMARNT	amarit
AMARYT	amarit
AMBAR	amber
AMBASY	gambias
AMBLR	ambler
AMBRLY	amberle
AMBRLY	amberle
AMBRLYNG	emberling
AMBRVSS	ambrosius
AMBRVSVS	ambrosius
AMBRVSYV	ambrosio
AMBRVSYVS	ambrosius
AMBVS	ambers
AMBYJ	amber
AMDYV	amedeo
AMFN	amin
AMLAK	amlak
AML	amal
AMLK	amlak
AMLN	hamlin
AMLYA	amelia
AMNA	amna
AMN	amin
AMNVN	amnon
AMPN	ampon
AMPRVR	emperor
AMPSVN	sampson
AMPT	ampte
AMPTH	ampte
AMPY	campey
AMRALD	emerald
AMR	amir
AMRJYNG	darjeeling
AMRMAN	amerman
AMRVSYV	ambrosio
AMRY	amery
AMRY	amery
AMRY	amery
AMRYKA	amerikan
AMRYKN	amerikan
AMRYKN	amerikan
AMRYTA	amritha
AMS	ams
AMSTAT	amstadt
AMSTD	amstadt
AMSTR	amster
AMSY	amshey
AMT	amit
AMTYSTA	amethysta
AMVNA	amina
AMVNDSYZ	amundsen
AMVRVSV	amoroso
AMVRY	amery
AMVS	amos
AMY	amy
AMY	amy
AMYH	amish
AMYHAY	amihai
AMYKVS	almqvist
AMYLY	amelia
AMYLY	amelia
AMYLYYV	palmolive
AMYNA	amina
AMYNA	amina
AMYNH	yaminah
AMYRA	amira
AMYR	amir
AMYR	amir
AMYT	amyot
AMYTAVA	amitava
AMYT	amyot
AMYT	amyot
AMYVT	amyot
AMYVT	amyot
AMYZVTA	amezquita
ANAGRAM	anagram
ANAKYN	anakin
ANALVG	analog
ANANDA	ananda
ANAND	anand
AN	ain
ANANSA	ananias
ANANT	anant
ANAS	anas
ANASTASYA	anastasia
ANATVLY	anatoly
ANATY	anatoly
ANAY	anay
ANAYLYN	anatolian
ANAYZA	unaiza
ANAZ	anasazi
ANAZA	unaiza
ANBAR	anbar
ANBR	anbar
ANBV	anbu
ANCY	dancy
ANDAMZ	adametz
AND	and
AND	and
ANDNS	andenes
ANDRA	andra
ANDR	andr
ANDR	andr
ANDRBRG	anderberg
ANDRBVRG	anderberg
ANDRBY	enderby
ANDR	andr
ANDR	andr
ANDRR	anderer
ANDRS	andres
ANDRS	andres
ANDRSN	andersen
ANDRSN	andersen
ANDRSVN	andersen
ANDRVS	andres
ANDRVZ	andree
ANDRYA	andrea
ANDRY	andre
ANDRY	andre
ANDRYAS	andreas
ANDRYS	andres
ANDRYS	andres
ANDRYS	andres
ANDRYSN	andreasen
ANDRYSN	andreasen
ANDRYVZ	andree
ANDRYYA	andrea
ANDRYZ	andree
ANDSVRS	windsors
ANDSVRT	vandivort
ANDSVVRT	vandivort
ANDVLSN	andolsen
ANDYSL	andys
ANDYYVRANS	hanoverians
ANFANT	enfant
ANFYLD	arnfield
ANGBRTSN	engebretsen
ANGH	anghe
ANGLAND	langland
ANGLANDR	englander
ANGLASMA	anglesea
ANGLHARD	engelhardt
ANGLHLM	engelholm
ANGLHVRN	engelhorn
ANGLND	langland
ANGLS	angels
ANGLS	angels
ANGLSMA	anglesea
ANGLSVN	engelson
ANGLTH	langseth
ANGLTJ	engeltje
ANGLTJH	engeltje
ANGLYNA	angelina
ANGLYS	angles
ANGLZ	anglicize
ANGRSVL	ingresole
ANGVLV	angelo
ANH	anchi
ANHLD	anhold
ANJBRTSVN	engebretsen
ANJL	banjul
ANJLJY	ainley
ANJLS	angels
ANJLT	anujit
ANJLTJA	angelita
ANJLV	banjul
ANJLYNA	angelina
ANJLYS	angeles
ANJLYSYA	anglesea
ANJY	anujit
ANJYLYNY	angeline
ANKNY	ankeney
ANKR	anker
ANKRLY	enkerli
ANKSTAD	annexstad
ANKVRN	anckorn
ANPYNGKV	unpingco
ANQ	anu
ANQH	danih
ANRAH	andromache
ANR	anwer
ANRYK	enrique
ANRYKV	enrique
ANRYKYV	enrique
ANRYKYYVZ	enriquez
ANSAR	ainsaar
ANSKAMB	anscomb
ANSL	ansell
ANSLM	anselm
ANSLMV	anselmo
ANSLY	ansley
ANSLYN	ansselin
ANSPAC	anspach
ANSR	mansur
ANSTYTV	institut
ANSY	pansy
ANSY	pansy
ANSYH	anshu
ANSYKR	mansoor
ANTAL	antal
ANTANAYTYS	antanaitis
ANTARAMYAN	antaramian
ANT	aint
ANTH	anthea
ANTNA	antonia
ANTRAPY	entropy
ANTRV	antero
ANTRVSYV	antrosio
ANTRYKYN	entrikin
ANTSTL	anthistle
ANTSYTL	anthistle
ANTVN	anton
ANTVN	anton
ANTVN	anton
ANTVNVGLV	antonoglou
ANTVNVVYC	antonowich
ANTVNY	antony
ANTVNY	antony
ANTVNY	antony
ANTVNYS	antonys
ANTVNYS	antonys
ANTVNYV	antonio
ANTVNYVS	antonios
ANTVS	antevs
ANTY	antley
ANTYLA	antila
ANTYPDS	antipodes
ANTYSTL	anthistle
ANTYSTLH	anthistle
ANV	anu
ANV	anu
ANVAR	anwar
ANVCYN	anuchin
ANV	anu
ANV	anu
ANVJYT	anujit
ANVKVL	anukul
ANVN	anon
ANVPAM	anupam
ANVP	anoop
ANVR	anwer
ANVR	anwer
ANVR	anwer
ANVRS	anvers
ANVS	antevs
ANVS	antevs
ANVTYYADYS	enotiadis
ANVVY	envoy
ANYART	enyart
ANYJMA	manija
ANYL	anil
ANYL	anil
ANYL	anil
ANYMA	venema
ANYNG	dawning
ANYSA	anisa
ANYS	andys
ANYSH	anoosh
ANYSTYN	earnestine
ANYVRSRY	anniversary
ANYVS	antevs
ANYYV	baney
ANZALVNY	anzalone
ANZLVAR	anzlovar
ANZYNGR	enzinger
APCRC	upchurch
AP	apr
APL	apel
APL	apel
APLBAY	applebee
APLBRG	appelberg
APLBY	appleby
APLBY	appleby
APLMN	aplin
APLNDS	laplands
APLYBY	appleby
APLYBY	appleby
APLYN	aplin
APNDYS	andys
APRAYT	alpheratz
APRLY	april
APRSVN	aperson
APRYL	april
APSTN	austen
APSTVN	austen
APSTYN	austen
APSYLVN	epsilon
APVNTH	aponte
APVRVA	apoorva
APYDAL	oppedal
APYSTYN	augustyn
AQBAL	anibal
ARAM	abram
ARAND	aurand
ARAN	amran
ARARKH	parakh
ARAS	aras
ARAS	aras
ARASMVS	erasmus
ARAY	airay
ARAYZ	taraz
ARBANAS	arbanas
ARBR	arber
ARBVR	arber
ARBYD	harbud
ARBY	araby
ARBYL	arbil
ARBY	araby
ARCAL	archdale
ARCALH	archdale
ARC	arce
ARCARD	orchard
ARCDALY	archdale
ARCDL	archdale
ARCDYL	archdale
ARCR	archer
ARCYBALD	archibald
ARDALYC	ardalich
ARDMN	arden
ARDN	arden
ARDRZ	cardozo
ARDYS	ardis
AR	ar
ARFANAKYS	orfanakis
ARFVRD	barford
ARFYVS	orfeus
ARGAN	garagan
ARGAN	garagan
ARGAR	orgar
ARHARD	erhard
ARKARD	harvard
ARKDYL	markiel
ARKTYKY	arktiki
ARLAYJ	iarla
ARL	earl
ARL	earl
ARL	earl
ARLT	arlet
ARLY	early
ARLYJ	aurelio
ARLYNDH	verlinde
ARLYNG	arling
ARMAND	armand
ARM	arm
ARMASTRANG	armstrong
ARMATV	armato
ARMNY	armeni
ARMRY	armour
ARMSRVNG	armstrong
ARMSTRANG	armstrong
ARMVNTRVT	armontrout
ARMVR	armour
ARMYN	armeni
ARMYTAJ	armitage
ARMYT	armitt
ARMYTAZ	armitage
ARN	arne
ARNAT	argonaut
ARND	arend
ARNDT	arendt
ARNFYLD	arnfield
ARNH	arnhem
ARNLD	arnold
ARNST	earnest
ARNT	arnot
ARNT	arnot
ARNT	arnot
ARNTS	arantes
ARNVLD	arnold
ARNVT	arnot
ARNVT	arnot
ARP	earp
ARPYN	arpin
ARS	ars
ARSKAT	arsenault
ARSKAYN	carskadon
ARSNALT	arsenault
ARSY	ars
ARSYD	aristides
ARSYKR	arsikere
ARTL	bartle
ARTR	arter
ARTRS	arturos
ARTRZ	arturo
ARTVT	artie
ARTYS	arties
ARTYZ	artie
ARVAL	aral
ARVMA	aromaa
ARVN	aron
ARVNACALAM	arunachalam
ARVNAH	arunah
ARVND	arend
ARVNN	karvinen
ARVRKH	marrakesh
ARVSN	arvesen
ARVYNG	waring
ARVYVLA	arviola
ARYA	arya
ARYA	arya
ARY	ari
ARYC	arce
ARYFA	arrifa
ARYJ	marytje
ARYKA	arequipa
ARYKA	arequipa
ARYK	ark
ARYK	ark
ARYKSN	eriksen
ARYKSVN	eriksen
ARYKSVN	eriksen
ARYKSVN	eriksen
ARYN	aron
ARYNGTN	arlington
ARYS	ares
ARYS	ares
ARYS	ares
ARYSTVTL	aristotle
ARYZ	ariz
ARYZ	ariz
ARZAT	arzate
ARZ	ariz
ASAKVL	assakul
ASBL	asbell
ASBRN	asbrink
ASBRYNK	asbrink
ASBVRN	eastburn
ASCAFYLD	masefield
ASCAGN	mascagni
ASCRVVYC	screech
ASCVFYLD	masefield
ASCVYLAR	scoular
ASCYPLVDN	schipluiden
ASCYPLVYDN	schipluiden
ASCYPN	gascoyne
ASDS	eastwoods
ASFAR	mayfair
ASFYLD	ashfield
ASGVRYAN	asguarian
ASKADZ	carskadon
ASKAGN	saskatoon
ASKAHAN	skahan
ASKAJN	saskatoon
ASKALANT	escalante
ASKAL	pasquale
ASKALYK	pasquale
ASKALY	pasquale
ASKANL	pasquale
ASKANYL	pasquale
ASKARP	baskar
ASKARS	aquarius
ASKARTSYS	skartsis
ASKARY	baskar
ASK	ask
ASKATV	saskatoon
ASKATYA	saskatoon
ASKATY	saskatoon
ASKAVN	saskatoon
ASKAYA	kamskaya
ASKAYLR	pasquale
ASKAY	asoka
ASKAYT	asquith
ASKLDSVN	eskeldson
ASKLTN	skelton
ASKLTVN	skelton
ASKLVYR	sklower
ASKNL	haskel
ASKNS	gaskins
ASKP	aesop
ASKRAB	sorab
ASKRANTVN	austranten
ASKRAYZ	ashkenazim
ASKRNTN	austranten
ASKRNTVN	austranten
ASKRVYC	baskerville
ASKRYBLYNG	scribbling
ASKRYBNR	scribner
ASKRYC	arsikere
ASKRY	arsikere
ASKRYS	maserus
ASKRYV	arsikere
ASKVAYRL	pasquale
ASKVAYR	baskar
ASKVFYLD	wakefield
ASKVGAN	glaswegian
ASKVLY	haskel
ASKVLYNG	aveling
ASKVLYN	eskeldson
ASKVLY	haskel
ASKVLYZ	vasquez
ASKV	waskey
ASKVRR	arsikere
ASKV	waskey
ASKVTVNY	saskatoon
ASKVYLR	baskerville
ASKVYVYL	esquivel
ASKYBA	skiba
ASKYLS	pasquales
ASKYNR	baskin
ASKYN	baskin
ASKYN	baskin
ASKYPLADN	carskadon
ASKYPLVYDN	schipluiden
ASKYPN	baskin
ASKYP	waskey
ASKYPY	skype
ASKYRS	akers
ASKY	waskey
ASKYTR	skeeter
ASLANKARD	slankard
ASLAN	ameslan
ASLAN	ameslan
ASLAN	ameslan
ASLATKYN	slatkin
ASLATKYN	slatkin
ASLATR	slater
ASLATRY	slattery
ASLATVBR	slater
ASLAVK	eastlake
ASLAVMYZ	islamic
ASLAVNBRG	slavenburg
ASLAVYN	slavin
ASLAYK	eastlake
ASLBVTNN	slabotnen
ASLD	auld
ASLMN	asselman
ASLNGZVALD	slangsvold
ASLP	aesop
ASLR	basler
ASLS	basels
ASLSYNG	slashing
ASLTN	auslin
ASLTR	basler
ASLVAN	ameslan
ASLVKAM	asoka
ASLVKA	asoka
ASLVMN	asselman
ASLVN	auslin
ASLVN	auslin
ASLVP	ashlee
ASLY	waslo
ASLYGRZ	allegro
ASLYMAN	asselman
ASLYNY	auslin
ASLYPR	sleeper
ASLYP	aswalap
ASLYTY	ansley
ASLYVPAS	sliupas
ASLYV	ashlee
ASMA	asma
ASMADJ	smadja
ASMAL	ismael
ASMALY	adusumalli
ASMART	smart
ASMAYT	assimilate
ASMDLY	smedley
ASMLN	ashmolean
ASMVKY	smoky
ASMVLYK	smolik
ASMVLYN	ashmolean
ASMVR	ashmore
ASMVT	naismith
ASMYD	quasimodo
ASMYKLA	smikla
ASMYL	asimov
ASMYLY	smyley
ASMYRNV	smirnov
ASMYT	naismith
ASMYTSVN	smithson
ASMYTVYK	semotiuk
ASMYTZ	auschwitz
ASMYTZ	auschwitz
ASNAG	hasna
ASNAYDR	adenauer
ASNDN	ashenden
ASNL	avniel
ASNL	avniel
ASNLYNG	snelling
ASNR	casner
ASNVDN	ashenden
ASNVFYLD	snowfield
ASNVGRS	reasoners
ASNV	eason
ASNYD	aeneid
ASNYL	avniel
ASNYSL	sneissel
ASPANGLR	spangler
ASPARDAM	spaarndam
ASPARKS	sparks
ASPARNDAM	spaarndam
ASPAR	caspar
ASPARV	kasparov
ASPARZA	esparza
ASPATAFVRA	spatafora
ASPAT	asiatic
ASPATSVVD	spotswood
ASPATZ	spatz
ASPAVLDYNG	spaulding
ASPAYDR	caspar
ASPAYDRZ	esparza
ASPAYK	kasprzak
ASPAYKS	aspidiskes
ASPAYNYNG	souphanouvong
ASPAYRZ	esparza
ASPAYZ	kasparov
ASPLMN	speelmon
ASPLYD	spleid
ASPLYNTR	splinter
ASPNSR	aspens
ASPNS	aspens
ASPRAG	sprag
ASPR	gasper
ASPRVT	sprite
ASPRYBRY	sprayberry
ASPRY	gasper
ASPVLARYC	spolarich
ASPVLARYX	spolarich
ASPVR	gasper
ASPVRY	gasper
ASPVSTA	spousta
ASPVSYTV	esposito
ASPVTYS	iapetus
ASPYDN	aspen
ASPYLMN	speelmon
ASPYNAK	spinak
ASPYNDRYFT	spindrift
ASPYN	aspen
ASPYRAS	diasporas
ASPYR	gasper
ASPYR	gasper
ASPYRV	gasper
ASPYRV	gasper
ASPYRYNG	spearing
ASPYRZ	gasper
ASPYRZ	gasper
ASPYSAK	spisak
ASPYSYK	aspidiske
ASPYT	rasputin
ASPYTZR	spitzer
ASPYVAK	spivak
ASPZYTV	esposito
ASRAT	maserati
ASRAYYL	israel
ASRMN	asherman
ASTABRT	astarte
ASTABZ	astaire
ASTAD	wainstead
ASTAD	wainstead
ASTAFL	astaire
ASTAFVRD	stafford
ASTAG	eastway
ASTAJANV	stajano
ASTAKMN	astrakhan
ASTAKR	astaire
ASTAKSLAJR	stockslager
ASTAKS	eastlake
ASTAKY	eastlake
ASTAKY	eastlake
ASTALKH	masalkhi
ASTAMPR	stamper
ASTAM	eastway
ASTANGYR	stangier
ASTANVL	estanol
ASTAPLYC	stuplich
ASTARBAK	easterbrook
ASTARGS	astartes
ASTARGYL	castergine
ASTARK	astaire
ASTARKYP	starkey
ASTARKY	starkey
ASTAR	astaire
ASTAR	astaire
ASTARTLD	startled
ASTART	astarte
ASTARTZ	astarte
ASTARYNGR	staringer
ASTARZ	astaire
ASTAS	acostas
ASTATM	astarte
ASTATRZ	astaire
ASTATZMN	stutzman
ASTAYLZ	austerlitz
ASTAYNLS	istanbuls
ASTAYNMN	austbanen
ASTAYN	astana
ASTAYR	astaire
ASTBAY	eastway
ASTCNYK	eastick
ASTDLR	stadler
ASTDMN	autumn
ASTDYNA	stedina
ASTFANS	austrians
ASTFAN	austrian
ASTFAN	austrian
ASTFANVS	stefanies
ASTFANV	stefano
ASTFANZ	stefano
ASTFN	aston
ASTFNSVN	carstensen
ASTGN	aston
ASTK	astik
ASTLR	aster
ASTLY	astley
ASTLYK	eastlake
ASTLY	astley
ASTNFRD	stanford
ASTNFVRD	stanford
ASTNFVRT	stenfort
ASTNKAMB	gastineau
ASTNSL	austins
ASTNSRAD	stensrud
ASTN	aston
ASTNTJY	steentje
ASTPKN	stepken
ASTPK	astik
ASTRABRYJ	easterbrook
ASTRADR	ostrander
ASTRAKMN	astrakhan
ASTRAK	pasternak
ASTRANDR	ostrander
ASTRAP	kastrup
ASTR	aster
ASTRASYM	strasheim
ASTRAVB	straub
ASTRLYNG	sterling
ASTRMLR	stremler
ASTRN	austern
ASTRND	astrid
ASTRN	austern
ASTRVK	easterbrook
ASTRVM	ahlstrom
ASTRVS	asturias
ASTRVSTRAP	stroustrup
ASTRYAN	austrian
ASTRYBL	striebel
ASTRYD	astrid
ASTRYDM	strydom
ASTRYDR	astrid
ASTRYM	ahlstrom
ASTRYN	austrian
ASTRYNGR	stringer
ASTRYNJR	easterner
ASTRYN	austrian
ASTRYNY	austrian
ASTRYR	easterner
ASTRY	astore
ASTRYTY	astarte
ASTS	easts
ASTVARD	bastard
ASTVART	astarte
ASTVBRYJ	easterbrook
ASTVDVLA	stodola
ASTVFL	basterfield
ASTVKLAS	stoklas
ASTVK	astik
ASTVK	astik
ASTVKVL	astik
ASTVKY	astik
ASTVLK	eastlake
ASTVLR	aster
ASTVL	austvollen
ASTVN	aston
ASTVNBRAYJ	glastonbury
ASTVNSN	carstensen
ASTVN	aston
ASTVN	aston
ASTVR	aster
ASTVRGA	astoria
ASTVRLYR	storleer
ASTVRMZ	austerlitz
ASTVRR	austvorren
ASTVRYM	ahlstrom
ASTVRY	astore
ASTVRY	astore
ASTV	aster
ASTVVAL	eastway
ASTVY	astley
ASTYANSN	stiansen
ASTYBL	striebel
ASTYBR	eastburn
ASTYD	eastwood
ASTYGBRG	stigberg
ASTYGMN	castergine
ASTYGRS	pasteurs
ASTYG	astore
ASTYJH	aetje
ASTYK	astik
ASTYKLMN	stickelman
ASTYLR	aster
ASTYL	astley
ASTYL	astley
ASTYL	astley
ASTYLY	astley
ASTYLZ	austerlitz
ASTYN	aston
ASTYNBRG	stenberg
ASTYNSN	carstensen
ASTYN	aston
ASTYN	aston
ASTYNSVN	carstensen
ASTYNTH	asquith
ASTYNTJH	steentje
ASTYNTJ	steentje
ASTYNZ	aston
ASTYPLZ	austerlitz
ASTYP	kastrup
ASTYRN	austern
ASTYRNZ	austern
ASTYSY	austins
ASTYSY	austins
ASTYT	adsett
ASTYVDNT	student
ASTYVN	aston
ASTYVNSVN	stevenson
ASTYVS	eastwoods
ASTYVZ	vasquez
ASVALAP	aswalap
ASVALD	osvaldo
ASVANAY	astana
ASVK	wasik
ASVLT	iselt
ASVRS	easters
ASVSKY	aspidiske
ASVYSR	gasser
ASYA	asia
ASY	casey
'ASYF	asif
ASYF	asif
ASYMYLYT	assimilate
ATANSYV	satans
ATA	alta
ATA	alta
ATARAS	ataras
ATH	athow
ATJH	aetje
ATKA	atka
ATKYNSN	atkinson
ATKYNSVN	atkinson
ATKYNZ	aitken
ATKYNZ	aitken
ATL	atle
ATLS	atlas
ATMSFR	atmosphere
ATMZ	akitomo
AT	at
ATRAM	atram
ATR	atri
ATRTN	atherton
ATRY	awtrey
ATRYSPS	atriceps
ATRZ	beatriz
ATTLY	attlee
ATV	waite
ATVATR	atwater
ATVD	atwood
ATV	waite
ATVL	atul
ATVL	atul
ATV	waite
ATV	waite
ATVSAN	cartesian
ATVS	aites
ATVSY	atusi
ATVVD	atwood
ATVVL	atul
ATVYL	atul
ATYA	atiya
ATY	waite
ATYG	attig
ATYLRD	ethelred
ATYLRDH	ethilrede
ATYLYV	attilio
ATYNGR	latiner
ATYNY	antony
ATYNZVN	etinzon
ATYS	aites
ATYVL	atul
ATYYA	atiya
AVACA	oaxaca
AVAD	abiad
AVADYA	awadia
AVALD	ewald
AVAN	avian
AVANZ	avian
AVASTY	awasthi
AVBAJA	abuja
AVBRAYAN	amerasian
AVBRDVRFR	oberdorfer
AVBRHVLZ	oberholz
AVBRHYM	oberheim
AVBR	aubrie
AVBRTAS	albertas
AVBRY	aubrey
AVBRY	aubrey
AVBYD	ayyubid
AVBYNGM	obbingem
AVCARD	bacardi
AVCAR	bacar
AVCLND	auckland
AVCZ	averice
AVDDY	addy
AVDKRYK	oudekirk
AVDKYRK	oudekirk
AVDL	adel
AVDLY	audley
AVDRA	audra
AVDRGV	auldridge
AVDVAK	adisak
AVDVN	auden
AVDV	audi
AVDYVM	hasidim
AVFNR	fafnir
AVFYNGTVN	uffington
AVGAR	avogadro
AVGBVRN	pangborn
AVGLT	aoglat
AVGNH	avignon
AVGNYV	agnew
AVGVR	auger
AVGVRY	aogori
AVGVST	august
AVGVSTV	auguste
AVGVSTYN	augustyn
AVGYNH	ageno
AVHALVRAN	ohalloran
AVHRMN	ahriman
AVJN	taejon
AVKLND	auckland
AVKLY	oakley
AVKR	auker
AVKRAYN	ukraine
AVKR	auker
AVKSLY	paisley
AVKSTVN	augustin
AVKSVL	akil
AVKT	aoki
AVKTS	awketts
AVKTZ	savetz
AVKYNZ	aiken
AVKYTS	awketts
AVLAFSVN	olafson
AVLA	avila
AVL	wavle
AVLAYVVLA	malayalam
AVLD	auld
AVLDKVRN	aldrin
AVLDRAYT	gaudrault
AVLDRYJ	auldridge
AVLDZ	valdez
AVLMN	aileen
AVL	wavle
AVLSN	abelson
AVLSN	abelson
AVLSVN	abelson
AVLSVN	abelson
AVLVSTAD	ulvestad
AVLYMA	alima
AVLYNG	aveling
AVLY	wavle
AVLY	wavle
AVLYVYH	aliyyah
AVLYVYR	aylor
AVMAKY	bamako
AVMBRGR	baumberger
AVMGA	amiga
AVMLAS	amelias
AVMR	amir
AVNAT	anant
AVN	avon
AVNAYZA	unaiza
AVNAYZ	anay
AVNGLYSTA	evangelista
AVNG	auyeung
AVNSTY	wainstead
AVNSVN	anson
AVNVSKV	malinowski
AVNYL	avniel
AVNYL	avniel
AVNZ	alonzo
AVQVAQ	aviva
AVRAHAM	avraham
AVRAM	avram
AVRAYL	karayel
AVRAYS	averies
AVRAYZ	airay
AVRAYZ	airay
AVRBN	airoun
AVRCARD	orchard
AVRDALN	aurdalen
AVRFYVS	averies
AVRGAN	farrigan
AVRHAN	archean
AVRHAN	archean
AVRHART	earhart
AVRHRT	earhart
AVRHV	aurho
AVRKLYVN	aurkleven
AVRKNY	airouni
AVRLANDV	garland
AVRL	aurelio
AVRLYNZ	airlines
AVRMA	amerman
AVRM	avrum
AVRMSPVRDN	ormesporden
AVRN	airoun
AVRNVPN	aurnupen
AVR	avior
AVRSBRG	eversberg
AVRSLR	oursler
AVRTS	arts
AVRTYZ	artie
AVRVM	avrum
AVRV	averie
AVRVYL	aureole
AVRY	avery
AVRYGA	auriga
AVRYK	aveek
AVRYL	aurelio
AVRYL	aurelio
AVRYNTS	laurents
AVRYS	averys
AVRYS	averys
AVRYS	averys
AVRY	avery
AVRYVLY	aureole
AVRYVN	airoun
AVRYVRDAN	oriordan
AVRYZ	ariz
AVSAL	faisal
AVSBVRN	eastburn
AVSBVRN	eastburn
AVSLANDR	auslander
AVSLYNA	auslin
AVSN	ayson
AVSN	ayson
AVSNZ	ayson
AVSTBANN	austbanen
AVSTHAMARN	austhamaren
AVSTLYC	astley
AVSTNDVRP	oostendorp
AVSTRANDR	ostrander
AVSTRNDR	easterner
AVSTVLYN	austvollen
AVSTVRYN	austvorren
AVSTYN	austen
AVSYVN	ayson
AVSYZ	vasquez
AVTAGVRV	otaguro
AVTA	avesta
AVTH	faith
AVTJH	aetje
AVTJ	aetje
AVTLV	atle
AVTLV	atle
AVT	ait
AVT	ait
AVTRY	awtrey
AVTVLYNY	capitoline
AVTV	waite
AVTYS	aites
AVVLYV	avolio
AVVRDAL	airedale
AVVRPK	overpeck
AVYAN	avian
AVYARS	aquarius
AVYCAY	avichay
AVYK	aveek
AVYNAS	aquinas
AVYNG	auyeung
AVYNZ	alonzo
AVYRSA	aversa
AVYS	avis
AVYSNA	abyssinia
AVYVA	aviva
AVYVN	aoyoun
AVZBRN	rayburn
AVZGVR	auger
AVZMN	autumn
AVZVNYS	aquinos
AYALA	ayala
AYBAC	haibach
AYBAR	aabar
AYBL	aibel
AYBYRVNK	asbrink
AYCAS	alicias
AYCBVRN	ayckbourn
AYCYRV	raicer
AYDA	ayda
AYDA	ayda
AYDAN	adan
AYDMN	caedmon
AYDNBVRG	roodenburg
AYD	audi
AYDS	audis
AYDVAYSVZ	aidas
AYDVRY	audrey
AYDYD	aidid
AYDY	audi
AY	way
AYF	afif
AYFJH	nayfeh
AYFJ	baefje
AYFVFL	baffle
AYFV	afou
AYGAN	aegean
AYGLASTVN	eaglestone
AYGLSTVN	eaglestone
AYGLV	eagle
AYGLY	eagle
AYGRT	maigret
AYGRTVN	augustin
AYGV	aug
AYGVR	auger
AYJH	ayush
AYJLSTVN	alston
AYJVYN	taejon
AYK	aik
AYKAM	akeem
AYKARVS	aquarius
AYKBRN	ayckbourn
AYKBVRN	ayckbourn
AYKH	saukh
AYKLVZAN	aurkleven
AYKN	aiken
AYKVK	waikiki
AYLANA	alana
AYLAN	alan
AYLKA	walka
AYLMYN	aileen
AYLPV	alpo
AYLR	aylor
AYLSA	ailsa
AYLTH	walth
AYLVARD	aylward
AYLVR	aylor
AYLVT	aylott
AYLVT	aylott
AYLVYZA	galizia
AYLYA	alya
AYLYDYV	maldive
AYLYN	aileen
AYLYN	aileen
AYLYN	aileen
AYLYNG	ayling
AYLYN	aileen
AYLYS	aeolus
AYLYS	aeolus
AYLZ	alonzo
AYM	aim
AYMAN	ayman
AYMAN	ayman
AYMANTZ	umanetz
AYMAR	aymara
'AYMN	eamon
AYMN	ayman
AYMN	ayman
AYMRY	amery
AYMVN	amin
AYMY	aimee
AYNAC	anzac
AYN	ayn
AYNA	acuna
AYNANA	ananda
AYNAN	anand
AYNARYNV	eannarino
AYNAT	anant
AYN	ayn
AYNAYN	anacin
AYNC	faunce
AYNDALYS	andalusia
AYNDAYRSN	andersen
AYNDRA	andra
AYNDRAJYT	indrajit
AYNDRANYL	indranil
AYNDRLY	andree
AYNDSVRS	windsors
AYNDVY	andy
AYNGALZ	angelo
AYNG	auyeung
AYNG	auyeung
AYNG	auyeung
AYNGLD	angle
AYNGLF	angle
AYNGL	angel
AYNGLS	angels
AYNGLYS	angles
AYNGLYS	angles
AYNGMAR	ingmar
AYNGMAR	ingmar
AYNGRAHAM	ingraham
AYNGRAM	anagram
AYNGRM	waingrow
AYNGRSVL	ingresole
AYNGRYA	angora
AYNGRYD	waingrow
AYNGRYSL	ingresole
AYNGRYSVL	ingresole
AYNGVAR	ingvar
AYNGYJD	aeneid
AYNHV	anchi
AYNJH	danih
AYNJJNRY	tianjin
AYNKH	anker
AYNKVGNYTA	incognita
AYNLY	ainley
AYNMN	anon
AYNR	gaynor
AYNS	aquinos
AYNS	aquinos
AYNSR	ainsaar
AYNT	aint
AYNTAYR	anntar
AYNT	aint
AYNTH	anthea
AYNTJ	eyntje
AYNTJH	eyntje
AYNTLSAT	intelsat
AYNTRNT	internet
AYNTRNT	internet
AYNVKSN	enoksson
AYNVN	anon
AYNVSNT	bakeneset
AYNYSA	ainissa
AYNZ	alonzo
AYNZHNRY	inzhenery
AYNZ	alonzo
AYNZ	alonzo
AYPRSVN	aperson
AYPRT	alpert
AYR	air
AYRARDY	ierardi
AYRAY	airay
AYRBYD	ayyubid
AYRD	aird
AYRDV	airdo
AYR	air
AYR	air
AYRLAYNZ	verlaine
AYRL	aurelio
AYRLND	verlinde
AYRNST	earnest
AYRNVT	arnot
AYRP	earp
AYRS	ayers
AYRVN	airoun
AYRVN	airoun
AYRVNSVN	aronson
AYRVVD	ayurveda
AYRVYNG	airouni
AYRVYN	airoun
AYRVYN	airoun
AYRVYYN	airoun
AYRY	avery
AYRYK	ark
AYRYS	ayres
AYRYZARY	irizarry
AYRZ	ariz
'AYSA	walesa
AYSA	ayesha
'AYSA	walesa
AYSA	ayesha
AYS	ayse
AYSA	ayesha
AYSAK	adisak
AYSAK	adisak
AYSAKS	wesaks
AYSAMA	aissama
AYSAN	maysan
AYSASK	adisak
AYSBL	asbell
AYSFALZ	parsifal
'AYSH	ayush
AYSH	ayush
'AYSH	ayush
AYSH	ayush
AYS	ayse
AYSKANDR	iskander
AYSK	ask
AYSLT	agoult
AYSLYK	basilisk
AYSMAN	tasman
AYSMN	ayson
AYSNSTAT	aisenstat
AYSPVRT	davenport
AYSRAT	maserati
AYSRT	eisert
AYSRT	eisert
AYSTBRN	eastburn
AYSTLND	eastland
AYSTMAS	austrias
AYSTMN	austen
AYSTMVS	austins
AYSTRAGV	australoid
AYSTRBRVK	easterbrook
AYSTR	aster
AYSTR	aster
AYSTVVD	eastwood
AYSTVY	astley
AYSTYK	astik
AYSTYN	austen
AYSVN	ayson
AYSVN	ayson
AYSY	ayse
AYSYZAKY	ishizaki
AYT	ait
AYT	ait
AYTAMAR	itamar
AYTCV	aitcho
AYTCVN	aitken
AYTH	faith
AYTH	faith
AYTJ	aetje
AYTJ	aetje
AYTJY	aetje
AYTKN	aitken
AYTR	hayter
AYTSN	aitsen
AYVA	aviva
AYVALD	mahowald
AYVANZ	americanize
AYVAR	aquarius
AYVAYNG	auyeung
AYVGNH	avignon
AYV	axe
AYVJNH	aquino
AYVLYN	aileen
AYVND	yaounde
AYVNS	aquinos
AYVRS	ayers
AYVRSVN	amerson
AYVRY	avery
AYVS	ayuso
AYVS	ayuso
AYVSTYS	augustus
AYVSV	ayuso
AYVSYN	ayson
AYVTYK	aveek
AYVYN	aoyoun
AYZAK	ganzak
AYZAKSVN	kazakhstan
AYZCYL	faizel
AYZDY	audi
AYZ	fayiz
AYZL	faizel
AYZMN	autumn
AYZRVDA	ayurveda
AYZV	azov
AZAD	azad
AZALYA	azalea
AZALY	azalea
AZANA	azana
AZAR	azhar
AZBVRN	rayburn
AZCYL	ezechiel
AZHR	azhar
AZLA	azlan
AZLN	azlan
AZR	azure
AZVR	azure
AZYCL	ezechiel
BAABAR	baabar
BAAFJ	baefje
BABA	baba
BABA	baba
BABAH	babah
BABAR	babar
BABAR	babar
BAB	babu
BAB	babu
BAB	babu
BABK	babikow
BABK	babikow
BABL	babel
BABR	babur
BABT	babitz
BABV	babu
BABVRAV	baburao
BABVSKYN	babushkin
BABY	babu
BABY	babu
BABY	babu
BABYKV	babikow
BABYRL	buberel
BABYTZ	babitz
BACALTR	buchalter
BACARAC	bacharach
BACAS	backas
BAC	bach
BACLDR	batchelder
BAD	ubaid
BAD	ubaid
BADKK	baedeker
BADKVK	baedeker
BADLVC	badeloch
BADMN	baden
BADNYK	budnick
BADR	badr
BADRMN	baderman
BADRYK	badrick
BADVYN	bauduyn
BADVYYN	baudouin
BADY	badry
BADYG	bandung
BADYN	bauduyn
BADYN	bauduyn
BADYNGTN	baldington
BADYNGTVN	baldington
BADYVN	baudouin
BADZ	baez
BADZYAK	budziak
BAFL	baffle
BAFY	baefje
BAFY	baefje
BAGA	bagga
BAGAM	baugham
BAGARLY	baggarly
BAGAY	bagade
BAGDAN	bragdon
BAGHAM	baugham
BAGLY	bagley
BAGLY	bagley
BAGM	baum
BAGSAV	bagshawe
BAGVLY	baguley
BAGYD	bagade
BAGZ	baez
BAGZ	baez
BAHYH	yahweh
BAJVA	bajwa
BAJYK	bajic
BAKAR	baskar
BAKAS	backas
BAKAYA	bakaya
BAKLY	beakley
BAKNR	baker
BAKR	baker
BAKR	baker
BAKSKA	baskar
BAKSR	baker
BAKSY	bakos
BAKVM	bakkum
BAKVS	bakos
BAKY	baku
BAKYR	baker
BALAK	balike
BALANDR	balendra
BALANS	balkans
BALARD	ballard
BALARY	balarie
BALAS	balash
BALAST	ballast
BAL	bale
BAL	bale
BALBYR	balbir
BALCVNAS	balchunas
BALD	bald
BALDRD	baldred
BALDVR	balder
BALDYNGTN	baldington
BALDYNGTVN	baldington
BALFNZ	balfanz
BALGA	baliga
BALHAM	balham
BALKA	balqa
BALKVSKY	bulkowski
BALMA	balma
BALMASDA	balmaseda
BALMR	balmer
BALNDRA	balendra
BALNY	baleine
BALSAM	balsam
BALSARA	bulsara
BALSK	basilisk
BALSLY	balsley
BALSVN	balson
BALTAKS	baltais
BALTAYS	baltais
BALTAZAR	balthazar
BALTZL	baltzell
BALV	bale
BALY	bailey
BALYGA	baliga
BALYK	balike
BALYN	balin
BALYN	balin
BALYSTYK	bialystok
BALYT	balit
BAMBRGR	baumberger
BAMN	beaman
BAMSV	bamse
BANA	banan
BANABYV	barnaby
BAN	bain
BAN	bain
BAND	bandi
BANDD	banded
BANDYRDY	bandireddi
BANDZ	bandi
BANGARTZ	bongarts
BANG	bang
BANGRZ	bangor
BANKLR	bankler
BANKRAFT	bancroft
BANKRVFT	bancroft
BANKS	banks
BANKVALA	bankwalla
BANL	banjul
BANR	bangor
BANTVN	banton
BANTY	bantu
BANTYNG	banting
BANY	baney
BANY	baney
BANY	baney
BANYTA	benita
BANYTV	bantu
BANYVRA	bonura
BAP	bai
BAPTYSTA	baptista
BAPTYST	baptist
BARAKVTA	barracouta
BARAS	barash
BARASV	bearnaise
BARAT	barath
BARBAGALV	barbagallo
BAR	bar
BARBAS	barbas
BARBR	barber
BARBVRAK	barborak
BARBVR	barber
BARBY	barbee
BARD	bard
BARDVLVMZ	bartholomew
BARDYK	bardeen
BARF	barff
BARFRD	barford
BARFVRD	barford
BARFYT	burfitt
BARG	bargh
BARGS	bargus
BARGVS	bargus
BARH	bargh
BARJYL	bargiel
BARKALV	barksdale
BARKASFYLD	barksfield
BARKAY	barkai
BARK	bark
BARKLY	barkley
BARKRAFT	barcroft
BARKR	barker
BARKSDYLY	barksdale
BARKSFYLD	barksfield
BARKVLV	barkley
BARKVS	barkus
BARLAS	barlas
BARL	barlow
BARL	barlow
BARLV	barlow
BARNABY	barnaby
BARNAM	barnum
BARNARD	barnard
BARNAS	barnas
BARN	barn
BARND	barend
BARNSA	barnshaw
BARNSAV	barnshaw
BARNSV	barnes
BARNT	barents
BARNY	barney
BARNYK	baronick
BARQARD	beauregard
BARS	barrs
BARSY	barsai
BARTA	barta
BART	bart
BART	bart
BARTHVLVMYVS	bartholomeus
BARTK	bartok
BARTKVR	barthakur
BARTL	bartle
BARTL	bartle
BARTLMAS	bartelmus
BARTLMVS	bartelmus
BARTLT	bartelt
BARTLT	bartelt
BARTLY	bartley
BARTMVS	bartelmus
BARTN	barton
BARTN	barton
BARTVK	bartok
BARTVLVMVS	bartelmus
BARTVLVMYVS	bartholomeus
BARTVLYNY	bartolini
BARTVN	barton
BARTVNYKV	bartonico
BARTY	baertie
BARTY	baertie
BARTYH	barth
BARTYS	baertie
BARTZ	bartz
BARVA	barua
BARVC	barich
BARVN	baron
BARVN	baron
BARVNS	barents
BARVNYA	baronia
BARVZ	beatriz
BARYAKS	baracks
BARY	bare
BARY	bare
BARY	bare
BARY	bare
BARYNGR	barringer
BARYNGTN	barrington
BARYNGTVN	barrington
BARYS	barneys
BASA	basha
BAS	bas
BAS	bas
BASKAR	baskar
BASKRVYL	baskerville
BASKY	basque
BASL	basel
BASMA	basma
BASN	basin
BASR	basir
BASSA	bassam
BASSN	basson
BASTARD	bastard
BAST	basit
BASTYK	bialystok
BASTYLVS	bastilles
BASTYN	bastien
BASTYN	bastien
BASTYN	bastien
BASTYVN	bastien
BASVAL	basel
BASV	basu
BASV	basu
BASVM	basem
BASYL	basel
BASYLYKA	basilica
BASYLYSK	basilisk
BASYLYVS	basilius
BASYN	basin
BATALS	baals
BATAN	bataan
BAT	bat
BATL	batel
BATLR	baxter
BATNAT	bratina
BATN	beaton
BATRA	batra
BATRBY	batterbee
BATRS	baxters
BATRSS	waterss
BATRST	bathurst
BATRVRS	beatrixs
BATRYS	beatrixs
BATRZ	beatriz
BATY	batu
BATYL	batel
BATYNG	banting
BAVA	bawa
BAV	bai
BAVCMP	basecamp
BAVDN	baudin
BAVDN	baudin
BAVDVYYN	baudouin
BAVDYN	bauduyn
BAVDYN	bauduyn
BAVDYSYN	baudissin
BAVGMN	baughman
BAVKAM	baikal
BAVKVS	baukus
BAVM	baum
BAVMGARTNR	baumgartner
BAVPRS	baupres
BAVRY	beaver
BAVS	beavis
BAVYZ	baez
BAXVM	baum
BAYARD	bayard
BAY	buay
BAYDA	bayda
BAYDN	baudin
BAYFYLD	byfield
BAYKRASTAF	bickerstaffe
BAYKRZTAF	barzilai
BAYLA	bayla
BAYLS	baylors
BAYLY	bayly
BAYLYNGSLY	billingsley
BAYLYNGTVN	baldington
BAYLYV	bayly
BAYLZ	bayly
BAYNVN	bayonne
BAYPRT	baupres
BAYR	bayer
BAYRD	baird
BAYRN	bayern
BAYRN	bayern
BAYRTAY	baertie
BAYRTYH	bayreuth
BAYRVN	bayern
BAYSVT	basit
BAYZ	baez
BAZBY	buzby
BAZBY	buzby
BAZT	bazett
BBKAK	bobak
BBYT	abbot
BCLDR	boulder
BCLR	bachelor
BDAL	bdale
'BDALH	bdale
'BDALLH	abdullah
'BDALRHMAN	abdalrahman
'BDALRHMAN	abdalrahman
'BDALRHMN	abdalrahman
'BDALRHMN	abdalrahman
'BDAL'ZYR	balzer
'BDAL'ZYZ	abdulaziz
'BDHBY	abudhabi
BDKK	bekki
BDKVK	bekki
'BDL	abdul
BDLAK	blaik
BDL	beedle
BDLVC	badeloch
'BDL'ZYZ	abdulaziz
BDMY	badami
BDNAR	bednar
BDRK	badrak
BDRYK	badrick
'BDVAL'ZYZ	abdulaziz
'BDVL	abdul
'BDVLRHMN	abdulrahman
BDYN	boudeweyn
BDYRA	bdira
BDYR	budur
BFJ	baefje
BGDAD	baghdad
BGLY	bigelow
BGNVLD	bagnold
BGVYL	beguelin
BGYR	benger
BHAMND	bahamonde
BHARA	behara
BHNAM	behnam
BHRV	bahro
BHST	best
BHYJA	bahija
BJLY	boily
BKA	benka
BKAR	baskar
BK	bk
BK	bk
BK	bk
BKDVR	budur
BKHVRST	backhurst
BKMN	beckman
BKMN	beckman
BKMYR	beckmeyer
BKR	boker
BKR	boker
BKR	boker
BKR	boker
BKS	bks
BKT	becket
BKVA	ikea
BKVF	backof
BKVK	bekki
BKVY	bekesy
BKVYT	bakelite
BKVYYR	bowyer
BKY	biko
BKY	biko
BKYNGSAL	beckingsale
BKYNGSL	beckingsale
BKYNGSYL	beckingsale
BKYR	boker
BKYS	bekis
BLA	bela
BLAC	black
BLAF	olaf
BLAFS	olafs
BLAHA	blaha
BLAK	blaik
BLAKSVM	blacks
BLALAK	blalock
BLAL	blal
BLAL	blal
BLAM	balham
BLAMKH	blaik
BLAMY	bellamy
BLANCARD	blanchard
BLANCH	blanche
BLANSDAN	blanstan
BLANSDN	blunsdon
BLANSTAN	blanstan
BLANZDVN	blunsdon
BLAS	blas
BLASDN	blunsdon
BLASK	blask
BLASR	blair
BLASY	blasi
BLASYVS	blasius
BLAVADNYK	blavatnik
BLAVYZ	blazquez
BLAYT	blatt
BLAZ	blaz
BLAZK	blazek
BLAZKYYVZ	blazquez
BL	blu
BLDN	bolden
BLDRD	baldred
BLDVYJN	boldwijn
BLDVYN	baldwin
BLDVYYN	boudeweyn
BLDYNG	belding
BLDYNGTVN	baldington
BLGA	baliga
BLKA	balqa
BLK	blaik
BLKLND	blokland
BLKLY	blackley
BLKMN	blakeman
BLKMN	blakeman
BLKSVM	bloxom
BLKSYR	blacksher
BLKVL	bokel
BLNK	blank
BLNKHVRN	blenkhorn
BLNKV	belenky
BLNKY	belenky
BLS	blues
BLTBRG	blattberg
BLTRAV	beltrao
BLV	blu
BLVC	bloch
BLVHM	blohm
BLVKSVM	bolshevism
BLVM	blom
BLVMBRG	bloomberg
BLVMN	blumen
BLVMNFLD	blumenfeld
BLVNSDVM	blunsdon
BLVNSDVN	blunsdon
BLVNZDM	blenheim
BLVRNJ	blorenge
BLVSKVM	bulkowski
BLVYN	boleyn
BLVZ	belize
BLVZVM	bloxom
BLYK	blaik
BLYK	blaik
BLYN	boleyn
BLYN	boleyn
BLYNDA	belinda
BLYNGASLY	billingsley
BLYNGTN	billington
BLYNKV	belenky
BLYNKV	belenky
BLYNKVV	belenky
BLYR	bloor
BLYSTVN	blystone
BLYTA	baltaxe
BLYVYS	blevins
BLYZ	belize
BNAKSY	bernankes
BNAMAR	benamar
BNAN	banan
BNARY	benari
BN	ben
BNDANG	bandung
BNDASTVN	bandstone
BNDK	bendek
BNDLY	brindle
BNDR	bender
BNDRVB	banderob
BNDY	bendix
BNG	beng
BNG	beng
BNG	beng
BNGT	bengt
BNH	bench
BNJYMAN	benjiman
BNKR	benker
BNKR	benker
BNKS	banks
BNR	abner
BNS	bens
BNSN	bensen
BNSN	bensen
BNSVN	bensen
BNT	benet
BNT	benet
BNT	benet
BNTLY	bentley
BNTN	benten
BNTN	benten
BNTV	benito
BNTVN	benten
BNTZ	bentz
BNTZ	bentz
BNYA	baniya
BNYAMYN	beniamin
BNYFASYVS	bonifacius
BNYN	benin
BNZ	benz
BNZN	benzene
BQYR	beyer
BRABANT	brabant
BRABY	barnaby
BRACMN	brachman
BRAD	brad
BRAD	brad
BRADLY	bradly
BRADR	bradbury
BRADRTN	braden
BRADRTVN	bridgetown
BRADSAV	bradshaw
BRADY	brady
BRADYS	bradlys
BRAFVRD	bradford
BRAGHAM	brigham
BRAHAM	braham
BRAHYM	brahim
BRAK	brake
BRAKLY	beakley
BRAKNY	brackney
BRAMBAV	brumbaugh
BRAM	bram
BRAMR	bram
BRAN	bran
BRAN	bran
BRAN	bran
BRANDL	brandel
BRANDY	brandy
BRANN	bormann
BRANSAV	branshaw
BRANSDVN	brunsdon
BRANSKVMB	branscombe
BRANSVYK	brunswick
BRANT	brant
BRANT	brant
BRARDY	berardi
BRASARD	brassard
BRASAYR	brashier
BRASRZ	brashier
BRASYRZ	brashier
BRAT	brat
BRATLT	bratlie
BRATR	brater
BRATYNA	bratina
BRAVN	brain
BRAVN	brain
BRAVNFYLD	brownfield
BRAVNR	browner
BRAVNYNG	browning
BRAVTVN	bratina
BRAVV	bravo
BRAVYC	braque
BRAYAN	brazilian
BRAY	bray
BRAYD	breaud
BRAYN	brain
BRAYNKLR	brinkler
BRAYR	brar
BRAYS	brays
BRAYS	brays
BRAYSLAV	bratislava
BRAYSVN	bryson
BRAYT	brat
BRAYTN	bratina
BRAYTVN	bratina
BRAYTVYT	braithwaite
BRAZVN	brazelton
BR	br
BRBVR	berber
BRCA	bearcat
BRCR	bourcier
BRD	bird
BRD	bird
BRDLY	bradly
BRDLY	bradly
BRDLY	bradly
BRDN	borden
BRDN	borden
BRDN	borden
BRDSANG	birdsong
BRDSAV	bradshaw
BRDY	brode
BRDYK	burdick
BRDYT	bridget
BRFVRD	barford
BRGANTY	briganti
BRGARD	burgaard
BRGAYLV	borgailo
BRG	berg
BRG	berg
BRGDAN	burgundian
BRGLAND	berglund
BRGL	bergel
BRGMN	bergman
BRGR	berger
BRGS	borgs
BRGS	borgs
BRGSVN	bergson
BRGYVT	bergeot
BRHAN	burhan
BRJ	brij
BRKAH	barkah
BRKASPYR	breakspear
BRKAT	barakat
BRKAT	barakat
BRK	berk
BRK	berk
BRK	berk
BRKLY	berkley
BRKSFYLD	barksfield
BRKT	bret
BRKVL	boerkoel
BRKVVYC	berkeley
BRKY	berkey
BRLACR	berlocher
BRL	burl
BRLND	borland
BRLSVN	burleson
BRLV	berle
BRLYN	berlin
BRLYNG	burling
BRLYNG	burling
BRML	bermel
BRMN	bremen
BRMN	bremen
BRNADVS	bernadus
BRNAL	bernal
BRNAN	brownian
BRNARD	bernard
BRNARD	bernard
BRNARDV	bernardi
BRNARDY	bernardi
BRNARDYN	bernardin
BRNARDZ	bernardi
BRNCAVD	branchaud
BRNC	bernice
BRNCLY	brenchley
BRNDAN	brendan
BRND	bernd
BRND	bernd
BRND	bernd
BRNDL	brindle
BRNDL	brindle
BRNDS	berends
BRNDVN	brendon
BRNDY	burundi
BRNDY	burundi
BRNDYS	burundis
BRNHARD	bernhard
BRNHART	barnhart
BRNHR	bernher
BRNR	bruner
BRNSAV	barnshaw
BRNSV	berns
BRNT	bernt
BRNT	bernt
BRNT	bernt
BRNV	brno
BRNVL	brunelle
BRNY	burney
BRNY	burney
BRNYR	bruner
BRNZ	benz
BRQ	bri
BRSAV	berislav
BRS	brs
BRSFVRD	beresford
BRSLAV	berislav
BRSLR	bresler
BRSMN	bremen
BRSVN	burson
BRSY	bresee
BRT	bert
BRTLSVN	bertelson
BRTN	berton
BRTRAND	bertrand
BRTR	brater
BRTS	berts
BRTVN	berton
BRTVN	berton
BRTVN	berton
BRTY	bruty
BRTY	bruty
BRTYH	british
BRVANHAT	braunhut
BRVARK	browarek
BRVDA	broda
BRVD	brod
BRVDFYLD	broadfield
BRVDHAST	broadhurst
BRVDLY	breedlove
BRVDR	broder
BRVDRTVN	bridgetown
BRVHL	brohl
BRVKAV	brokaw
BRVK	brevik
BRVK	brevik
BRVK	brevik
BRVK	brevik
BRVKN	broken
BRVKNR	bruckner
BRVKR	brooker
BRVKS	brooks
BRVKSL	brooks
BRVKVL	brookwell
BRVKZ	brooke
BRVMBRG	bromberg
BRVMBRGR	bromberger
BRVMFYLD	brumfield
BRVMLY	bromley
BRVMYJ	eboreime
BRVNL	brownlee
BRVNR	bruner
BRVNVYYN	brunwin
BRVNYYV	brunei
BRVR	brier
BRVSRD	beresford
BRVSTR	brewster
BRVSYAV	brousseau
BRVTY	bruty
BRVTZMN	brutzman
BRVVR	brier
BRVYK	brevik
BRVYLV	broilo
BRVYN	bruyn
BRVYNS	bruines
BRVYNYNG	browning
BRVYR	breyer
BRVYR	breyer
BRVZ	broz
BRXARD	berardi
BRYAN	bryan
BRYAN	bryan
BRYANT	bryant
BRY	bury
BRY	bury
BRY	bury
BRY	bury
BRYBR	briber
BRY	bury
BRY	bury
BRYDLAV	breedlove
BRYDVL	bridwell
BRYDY	bryde
BRYDYNG	breeding
BRYGVY	bryguy
BRYJ	brij
BRYJ	brij
BRYJMN	bremen
BRYKASPYR	breakespear
BRYKSPYR	breakspear
BRYL	beryl
BRYM	eboreime
BRYMR	brimmer
BRYMSTVN	brimstone
BRYN	bryn
BRYN	bryn
BRYNDAN	brendan
BRYND	brind
BRYNDL	brindle
BRYNGARDNR	bringardner
BRYNGTN	barrington
BRYNGTVN	barrington
BRYNK	brink
BRYNKMN	brinkman
BRYNR	bryner
BRYNSN	brinson
BRYR	breyer
BRYR	breyer
BRYS	bowerys
BRYS	bowerys
BRYSBYN	brisbin
BRYSBYN	brisbin
BRYSNV	bryson
BRYSTVL	bristol
BRYSYNDA	brisinda
BRYTA	brita
BRYT	bret
BRYTLYNG	breitling
BRYTV	brito
BRYTVN	breton
BRYTYS	brutus
BRYVN	bryon
BRYVNY	bryony
BRYVR	breyer
BRYVRY	brewery
BRYYKPR	brooker
BRYYTVN	breton
BRYZA	bereza
BRZA	bereza
BSAK	bosak
BSAM	besam
BS	bs
BSBRYS	besbris
BSKT	baskett
BSKV	besko
BSL	basel
BSMA	basma
BSMY	basem
BST	best
BSVAL	boswall
BSVL	basel
BSVN	ibsen
BSYL	basel
BSYM	basem
BSYRA	basira
BSYT	basit
BTAN	boeotian
BTCLDR	batchelder
BTHVN	beethoven
BTL	beetle
BTMN	batman
BTRYS	butrus
BTSY	betsy
BTVL	beutel
BTY	btu
BTY	btu
BTYG	bettig
BTYYV	bettye
BTZA	betza
BVALY	beale
BVAS	boas
BVAY	buay
BVAY	buay
BVAYVYN	bauduyn
BV	bev
BVBY	booby
BVBYS	beebes
BVCA	biocca
BVCA	biocca
BVC	bic
BVCGA	boschga
BVDA	beda
BVDA	beda
BVDAPATY	bodapati
BVDAR	bednar
BVD	bud
BVD	bud
BVD	bud
'BVDHABY	abudhabi
BVDLA	bodla
BVDN	biden
BVDN	biden
BVDNMYLR	bodenmiller
BVDRA	boudreau
BVDRV	budur
BVDV	bede
BVDVR	budur
BVDVYN	boudeweyn
BVDY	bede
BVDYVN	bedouin
BVDYVYN	boudeweyn
BVFALV	buffalo
BVGARD	bogaard
BVGHAM	baugham
BVGS	bugs
BVHL	buhl
BVHR	bohr
BVJY	boije
BVKL	bokel
BVKL	bokel
BVKLY	beakley
BVKR	boker
BVKSY	bekesy
BVKVN	bockoven
BVLA	bela
BVLARD	abelard
BVL	biol
BVLDN	bolden
BVLDT	boldt
BVLDVYJN	boldwijn
BVLDZR	bulldozer
BVLF	bolef
BVLN	bolen
BVLR	beeler
BVLR	beeler
BVLTAN	beltane
BVLTN	bolton
BVLTVN	bolton
BVLV	boole
BVLVC	bolecek
BVLVS	bulus
BVLVYJN	boldwijn
BVLYNG	bowling
BVMBR	bomber
BVMBRGR	bomberger
BVM	bum
BVMGARDNR	bumgardner
BVMHARD	bomhard
BVMN	bimini
BVNANDR	bonander
BVNAR	bonar
BVNAVGLYA	bonavoglia
BVN	bevin
BVN	bevin
BVNGARD	bongard
BVNSTRA	boonstra
BVNTN	benten
BVNVMV	bonomo
BVNVNV	benin
BVNY	binoy
BVNYFASS	bonifacius
BVNYFASYVS	bonifacius
BVNYFKYVS	bonifacius
BVNYFYSS	bonifacius
BVNYN	benin
BVNYTZ	bonitz
BVQAM	besam
BVRA	beria
BVRAD	brad
BVRAP	burrup
BVRASCY	buraschi
BVR	bir
BVRCRT	borchert
BVRDR	border
BVRDYK	burdick
BVRGA	borgia
BVRG	berg
BVRGV	birge
BVRGYVYS	bourgeois
BVRJYA	beria
BVRKVAL	boerkoel
BVRKVL	boerkoel
BVRKVYL	boerkoel
BVRKY	berkey
BVRL	burl
BVRL	burl
BVRLN	berlin
BVRM	borm
BVRML	bermel
BVRMN	berman
BVRSL	bursell
BVRST	borst
BVRSYR	berster
BVRVS	beris
BVRYJ	brij
BVRYL	beryl
BVRYLLV	brillo
BVRYS	bowerys
BVRYVN	borione
BVRYZ	bereza
BVRZ	bereza
BVSA	busa
BVSAL	boswall
BVSART	bossart
BVSARV	busarow
BVSAYSN	boshuysen
BVS	bes
BVS	bes
BVS	bes
BVS	bes
BVS	bes
BVS	bes
BVSCA	biscay
BVSCGA	boschga
BVSGA	boschga
BVSKA	bocska
BVSK	besko
BVSLY	bosley
BVSNL	bushnell
BVSNY	bosnia
BVSTAK	bostak
BVSTAMNT	bustamante
BVST	best
BVSTRAM	bostrom
BVSTRVM	bostrom
BVSTVN	boston
BVSTYK	bostwick
BVSVAL	boswall
BVSVL	bessel
BVSVM	bossom
BVSVN	bensen
BVSVR	boisvert
BVSVYSN	boshuysen
BVSY	boisy
BVSY	boisy
BVSYK	busick
BVSYSN	boshuysen
BVSYVYSN	boshuysen
BVTARY	botari
BVTAYS	butaysh
BVT	bot
BVT	bot
BVTCR	butcher
BVTLR	butler
BVTRL	beutel
BVTRS	butrus
BVTSYH	bootsie
BVTVN	beeton
BVTZ	bitz
BVVDVYN	boudeweyn
BVVN	bevin
BVVY	booey
BVXNY	binoy
BVY	booey
BVYKV	boyko
BVYLN	boylan
BVYR	beyer
BVYRKVYL	boerkoel
BVYS	boyes
BVYS	boyes
BVYSVYKS	bisquicks
BVYSYV	beusee
BVYVN	boivin
BVYZY	belize
BVZANCYV	bojanchev
BVZ	baez
BVZKART	bozkurt
BVZMAN	bozeman
BVZVA	bozuwa
BVZVAL	beuzeville
BVZVVA	bozuwa
BVZVVYL	beuzeville
BVZYDAR	bozhidar
BVZYD	bouzid
BYAKV	baku
BYAN	bean
BYANG	bang
BYANGTAY	byungtae
BYATLYNG	beutling
BYAVYS	beavis
BY	oxby
BYBL	bible
BYBR	buber
BYCAM	beacham
BYC	bic
BYCLY	buckley
BYCMP	basecamp
BYCYNGSYL	beckingsale
BYCZ	buice
BYDA	beda
BYDL	beedle
'BYD	boyd
BYDV	bede
BYDVL	bedell
BYDY	bede
BYF	biff
BYFJH	baefje
BYFRAST	bifrost
BYG	big
BYGLHL	beaglehole
BYGND	bigend
BYGNVALD	bigenwald
BYGV	bigo
BYGVRDAN	bigourdan
BYGZ	bigo
BYHAN	beyhan
BYHYV	beehive
BYJ	boije
BYJH	boije
BYKA	benka
BYKARD	burkhard
BYK	boyko
BYK	boyko
BYK	boyko
BYK	boyko
BYKLY	beakley
BYKN	broken
BYKNST	bakeneset
BYKRASTAF	bickerstaffe
BYKRASTAFY	bickerstaffe
BYKRASTF	bickerstaffe
BYKRASTYF	bickerstaffe
BYKR	boker
BYKRSTF	bickerstaffe
BYKRTN	bickerton
BYKSLR	buckser
BYKVL	bokel
BYKVN	bockoven
BYLAL	bilal
BYLANY	billany
BYL	beyl
BYL	beyl
BYL	beyl
BYLHAR	bilhar
BYLKY	belenky
BYLNGTVN	billington
BYLR	byler
BYLR	byler
BYLR	byler
BYLS	byles
BYLV	boyle
BYLYKVK	bulkowski
BYLYNGASLAY	billingsley
BYLYNG	bowling
BYLYNGSLY	billingsley
BYLYNGTVN	billington
BYLYNGZ	bowling
BYLYNSKY	bilinsky
BYLYR	byler
BYLZ	belize
BYLZYBAB	beelzebub
BYMN	bimini
BYMYNG	beeming
BYN	ben
BYN	ben
BYN	ben
BYN	ben
BYNDMN	bindemann
BYNFNG	bienfang
BYNG	byung
BYNH	bench
BYNJN	bynon
BYNMDART	bainmedart
BYNQAM	beniamin
BYNR	bryner
BYNS	bens
BYNS	bens
BYNVD	binod
BYNVY	binoy
BYNY	binoy
BYNY	binoy
BYNY	binoy
BYNYYVN	binion
BYNZ	benz
BYNZ	benz
BYNZ	benz
BYPYN	bipin
BYRA	byra
BYR	byer
BYR	byer
BYR	byer
BYR	byer
BYR	byer
BYRBK	bourbaki
BYRC	bierce
BYRD	byrd
BYRD	byrd
BYRDMR	beardmore
BYRDN	borden
BYRFYS	bowerys
BYRG	berg
BYRGL	bergel
BYRK	berk
BYRLA	berilla
BYRMN	berman
BYRNBVYM	birenboim
BYRN	byrne
BYRNH	bernher
BYRNS	byrnes
BYRTAY	berta
BYRT	bert
BYRTRYK	browarek
BYRTYH	bayreuth
BYRTYH	bayreuth
BYRVT	beirut
BYRYC	bryce
BYRYGANTY	briganti
BYRYNG	bering
BYRZ	bereza
BYSAYV	busarow
BYS	boyes
BYSH	bush
BYSKMP	besko
BYSL	bessel
BYSLY	bosley
BYSMARK	bismark
BYSM	besam
BYSR	buster
BYSTANDR	bystander
BYST	best
BYST	best
BYSYN	bryson
BYTANKRT	bethancourt
BYTARD	bittard
BYT	bot
BYT	bot
BYTMN	brotman
BYTN	beeton
BYTRAYS	bertrams
BYTRYK	beatrix
BYTZ	bitz
BYVAN	bevan
BYV	bev
BYVCAMP	beauchamp
BYVCMP	beauchamp
BYVDVYN	boudeweyn
BYVFYZ	boulez
BYVGAM	brougham
BYVKMP	weikamp
BYVKRAFT	kraft
BYVLY	boily
BYVLYV	boily
BYVMNT	beaumont
BYVMVNT	beaumont
BYVNGS	byungse
BYVR	byer
BYVRLY	beverly
BYVRZ	bereza
BYVSH	beresh
BYVTL	beetle
BYVYS	bowes
BYVZVYL	beuzeville
BYYVCMP	beauchamp
BYYVNYK	dubrovnik
BYZ	baez
BYZR	bizer
BYZVANAT	byzantine
BYZVAS	bolivias
BYZVYL	beuzeville
BYZYR	bizer
BZVA	bozuwa
CAGN	cagney
CAKV	chiaki
CALK	chalk
CAMBRLAYN	chamberlain
CAMPLYN	champlin
CAND	candy
CANDRAN	chandran
CANDR	chander
CANDVNYA	chandonia
CANSY	cains
CANY	cano
CAPLA	capella
CAPL	capitol
CAPMN	chapman
CAPRA	capra
CAPYN	capone
CARD	caird
CARLTN	carlton
CARLTVN	carlton
CARLVT	carlton
CARLY	carly
CARLYH	carly
CARLYN	carolyn
CARLZ	carlo
CARNG	carnegie
CARTVN	carlton
CARYK	clark
CAS	cas
CASMZ	casio
CASTYN	cawston
CATANY	castano
CAV	cave
CAVDA	chavda
CAVHAN	chauhan
CAVN	cain
CAVVYN	chauvin
CAVVYV	cleavey
CAVZ	chavez
CAY	cao
CAYKN	chaiken
CAYLD	called
CAYLDZ	valdez
CAYZ	cadiz
CH	che
CKRD	ackroyd
CLATVN	clanton
CLYVS	clovis
CLYYAN	euclidean
CMALY	chemaly
CMBRLYN	cumberland
CMBRZ	chimborazo
CMBZY	chembezi
CNADR	chenader
CN	coen
CND	cindy
CNDLR	chandler
CNSLVR	consuelo
CNTH	chenteh
CNY	cinq
CPDY	chopde
CPZ	cape
CRAG	craig
CRASKAYNT	carskadon
CRBL	cherbel
CRC	circe
CRCYL	courcoul
CRPY	cherepy
CRSKYNAY	cristina
CRVBYNY	cherubini
CRVYC	croce
CRY	cory
CRY	cory
CRYL	croyle
CRYSKYNTY	chrescyntie
CRYSTAL	crystal
CRYSYNTH	chrescyntie
CSBRV	chesbro
CS	cs
CSNY	chesny
CSNY	chesny
CSTR	custer
CTAL	chetal
CT	oct
CTVYN	chetwin
CVA	cia
CVA	cia
CV	cove
CV	cove
CV	cove
CV	cove
CV	cove
CVDHARY	choudhary
CVKRY	chokri
CVKSY	cokes
CVLKA	chwolka
CVN	coen
CVNPYG	chunping
CVRN	coren
CVSAK	chusak
CVVANAK	chovanak
CVY	coy
CVY	coy
CVYLR	coulter
CYA	cia
CYA	cia
CYAKY	chiaki
CYANG	chiang
CYBANSKY	cybanski
CY	coy
CY	coy
CYCSTR	chichester
CYK	coke
CYK	coke
CYK	coke
CYKN	cookson
CYKRY	chokri
CYKY	coke
CYKZ	coke
CYLDZ	coldewey
CYLT	celt
CYLTH	clotho
CYLTJ	celetje
CYLTJH	celetje
CYLY	coley
CYLYJH	celetje
CYLYNGVRS	challengers
CYLYNGVRT	chillingworth
CYM	com
CYN	coyne
CYN	coyne
CYNN	conn
CYNV	coyne
CYP	chip
CYP	chip
CYPLVYDN	schipluiden
CYPMN	cheapman
CYPN	chopin
CYRAG	cherag
CYRAK	cormack
CYSM	chism
CYSMN	coisman
CYSTY	costco
CYSVLM	chisholm
CYTA	cetia
CYTAM	cheetham
CYTAN	chetan
CYT	cote
CYT	cote
CYTRDY	chitrady
CYTVVD	cotswold
CYTVYN	chetwin
CYTYK	cutie
CYV	cove
CYV	cove
CYZVBA	chizoba
CYZV	chizu
CYZVRV	chizuru
DABAC	dalbec
DABAS	debras
DABL	diaboli
DABNY	dabney
DABS	danubes
DABSVN	dawson
DABVS	danubes
DABVYS	darbys
DABYL	diaboli
DABYNSKY	dubinsky
DABYNSN	dobinson
DABYNSVN	dobinson
DABYNZ	dabin
DADA	dada
DAD	dade
DADGYVN	dudgeon
DADH	dade
DADK	dade
DADLY	dailey
DADS	dadas
D'A	dea
DADV	dade
DADYR	drader
DAF	dax
DAGAN	dagan
DAGAN	dagan
DAG	dag
DAG	dag
DAG	dag
DAGLY	dagley
DAGN	dagan
DAGR	dangoor
DAGRTY	daugherty
DAGRZ	daguerre
DAGVAC	dogwatch
DAGZ	dag
DAHAK	dahuk
DAHAML	duhamel
DAHN	daphne
DAHRTY	daugherty
DAHVD	dawud
DAHVK	dahuk
DAJ	dax
DAJ	dax
DAJYVN	dauwen
DAKAS	dakars
DAK	doake
DAK	doake
DAK	doake
DAKHVRN	dockhorn
DAKLVZ	dailey
DAKMN	dakin
DAKN	dakin
DAKRYNG	duckering
DAKS	dawkins
DAKS	dawkins
DAKTRZ	datri
DAKV	doake
DAKVRS	dakars
DAKYNG	dakin
DAKYNZ	dakin
DAKZ	doake
DALAJR	dalager
DALAN	dalian
DALAS	doualas
DALAYR	dalager
DALBK	dowaliby
DALBRGR	dulberger
DALBYR	dauber
DAL	dal
DAL	dal
DAL	dal
DALFR	dulfer
DALMN	dailene
DALMS	diwalis
DALMYYA	dalmia
DALNZ	dailene
DALRS	daimlers
DALRYMPL	dalrymple
DALTVN	dalton
DALY	daly
DALY	daly
DALY	daly
DALY	daly
DALYNAR	dolinar
DALYNGR	dellinger
DAMAR	dhamar
DAMBL	duhamel
DAMLR	daimler
DAMPLTVN	dumpleton
DAMVN	damon
DAMVNTT	dumontet
DAMYAN	damian
DAMYANV	damiano
DAMYLA	djamila
DAMYNGS	demings
DAMYNY	damiano
DAMYNYKAS	dominiques
DAMYTRV	dimitri
DAMYVN	damien
DANA	dana
DANALD	danald
DANA	dana
DANAVAN	danubian
DAN	dan
DANDAS	dundas
DAN	dan
DAN	dan
DAN	dan
DANDY	deandre
DANFRD	dunford
DANFY	dabney
DANG	dangel
DANG	dangel
DANGTAY	dongtai
DANGVY	dangoor
DANGYV	dangoor
DANGYVN	dungeon
DANHAM	denham
DANH	danih
DANJL	daniel
DANKAN	danekind
DANKV	danko
DANKV	danko
DANKY	danko
DANLVP	danilo
DANLY	danilo
DANNBARGR	danenbarger
DANNLY	danilo
DANR	deaner
DANSMVR	dinsmoor
DANSTR	dunster
DANSY	danes
DANSYNG	dawning
DANTN	danton
DANVAN	danubian
DANY	dane
DANY	dane
DANYDYN	dunedin
DANYL	daniel
DANYL	daniel
DANYL	daniel
DANYLSVN	danielson
DANYLV	danilo
DANYLZ	danilo
DANYS	danes
DANYYLS	daniels
DANZ	danz
DAPAY	bodapati
DAPNYK	doupnik
DAPRK	dierk
DAPRRY	duperre
DAPRY	draper
DARANG	darling
DARA	edara
DARBY	darby
DAR	dare
DARHAM	durham
DARL	darla
DARLY	darley
DARLYNGTN	darlington
DARNAL	darnall
DARNL	darnell
DARNL	darnell
DART	dart
DARV	dare
DARVN	darvon
DARYGVS	darrigues
DARYL	daryl
DAS	das
DAS	das
DASN	dawson
DASVN	dawson
DASYNG	daswani
DASYVK	doseok
DAT	dart
DATH	darth
DATJH	daatje
DATRY	datri
DATSVN	dawson
DATVN	dalton
DATVYT	dartmouth
DATY	dante
DATY	dante
DAVAD	davao
DAVARK	devarque
DAVBR	dauber
DAVD	david
DAVD	david
DAVD	david
DAV	dave
DAV	dave
DAV	dave
DAVKNYZ	danz
DAVKYNZ	dawkins
DAVN	dawn
DAVNPRT	davenport
DAVNY	dwaine
DAVNYNG	dawning
DAVNYNG	dawning
DAVRS	darios
DAVRYN	daverin
DAVSAN	daswani
DAVS	daves
DAVSN	davison
DAVSVN	davison
DAVT	dayton
DAVVD	david
DAVVD	david
DAYAL	danial
DAYAN	dalian
DAYAN	dalian
DAYANYSYA	dionysia
DAYANYSYS	taiwaneses
DAYAZ	davao
DAYBALA	dyballa
DAYBL	diaboli
DAYCYNC	duyckinck
DAY	day
DAY	day
DAYDRYC	diedrich
DAY	day
DAYK	dahuk
DAYKSVN	davison
DAYKY	doake
DAYKYNK	duyckinck
DAYKYNZ	dawkins
DAYLAYGAN	dalmatian
DAYLVN	dailene
DAYMND	diamond
DAYN	dwayne
DAYN	dwayne
DAYR	dayr
DAYRDRYK	dierderick
DAYR	dayr
DAYRKTVR	dartmoor
DAYRT	dart
DAYS	douays
DAYT	dayton
DAYVD	dawud
DAYVRJH	dievertje
DAYVRJH	dievertje
DAYVRT	dart
DAYVRTH	darth
DAYVRTJ	dievertje
DAYVRTJ	dievertje
DAYVRYA	dauria
DAYVVN	dauwen
DAYVYN	dauwen
DBATVNYA	debathonia
DBLR	deibler
DBYT	godbout
DDFYLD	deadfield
DDJN	goddijn
DDRYK	dedrick
DDY	eddy
DFRVY	defroy
DGLY	dagley
DGRAF	degraff
DGRF	degraff
DGRLVND	degerlund
DGVTARDY	degotardi
DHA	doha
DHAMAR	dhamar
DHNR	dehner
DHNRT	dehnert
DHVK	dahuk
DJAMYLA	djamila
DJLY	dooley
DKAN	dekan
DKK	dekok
DKLRK	oudekirk
DKR	decker
DKSTR	dikstra
DKYAH	zedekiah
DKY	dike
DK	dik
DLAL	dalal
DLANY	delaney
DL	del
DLH	delhi
DLMAN	dolman
DLNY	delaney
DLRD	dillard
DLRYV	delrio
DLTN	dilten
DLTVVYA	deltuvia
DLVRA	deloura
DLVRYZ	delacruz
DLVYS	dooleys
DLY	dooley
DLYKATNY	delikatny
DLYS	dooleys
DLYSYV	delisio
DMA	dema
DMA	dema
DMKAK	dekok
DMKH	demke
DML	dehmel
DMLR	demler
DMN	demon
DMPSTR	dempster
DMR	widmer
DMRZ	dmitri
DMSQ	diems
DMYLA	djamila
DMYNYSVS	dionysus
DMYS	deimos
DNALD	donald
DNAQY	donahue
DNAVLT	denault
DN	den
DNDLR	dandler
DN	den
DNDRYJ	deandre
DNG	deng
DNHAM	denham
DNJVR	denver
DNKVALTR	denkewalter
DNKYND	danekind
DNL	daniel
DNMN	denman
DNNL	dennell
DNRYJ	dirkje
DNSR	dingsor
DNTVN	denton
DNV	deno
DNVKS	dominiques
DNYH	danih
DNYL	daniel
DNYLZ	danilo
DNYNG	downing
DNYS	downys
DNYSVN	dionysian
DRABK	drabek
DRADR	drader
DRAGAN	dragan
DRAGANYS	draganis
DRAGN	dragon
DRAGR	dragomir
DRAKMN	drukman
DRAL	dordal
DRALT	drolet
DRAMATYS	dramatis
DRAM	dream
DRAP	draper
DRAPR	draper
DRAST	droste
DRATMN	dratman
DRATY	durante
DRAVN	draine
DRAVR	drader
DRAYNH	draine
DRAYR	drader
DRBS	drebes
DRBY	derby
DRCMN	drachman
DRDH	darde
DRG	drag
DRGVMYR	dragomir
DRGVN	dragon
DRGVNS	dragons
DRK	dirk
DRKSL	dirks
DRMVT	dermott
DRNAL	darnall
DRNK	drnek
DRNTR	drenter
DRSNR	dressner
DRTCN	dortchen
DRTH	darth
DRV	drew
DRV	drew
DRVDYNG	druding
DRVDYS	drudis
DRVMAND	drummond
DRVMR	droomer
DRVNY	drune
DRVNYS	dervenis
DRVR	drover
DRVT	drout
DRVYK	drevik
DRVYT	drout
DRVZN	drown
DRYDJY	dryden
DRYFVS	dreyfus
DRYJR	dreyer
DRYK	derek
DRYK	derek
DRYM	drum
DRYMR	droomer
DRYMZ	drum
DRYNKS	drinks
DRYNZ	derienze
DRYR	dreyer
DRYRY	drury
DRYS	doris
DRYSKVL	driskill
DRYSKYL	driskill
DRYV	drew
DRYV	drew
DRYVT	drout
DRYXA	adria
DS	ds
DSL	desle
DSMVLYNZ	desmoulins
DSMVND	desmond
DSMYT	desmet
DSNVYRZ	desnoyers
DSRAZYRS	desrosiers
DSRVZYRZ	desrosiers
DSTLY	distel
DSVTV	desoto
DTLFS	detlefs
DTMN	demon
DTRYJ	detroit
DTS	dots
DTVYLR	detweiler
DVA	dea
DVAK	doake
DVALYBAY	dowaliby
DVAN	dean
DVANYR	deaner
DVAR	dear
DVARTH	darth
DVAYKYNK	duyckinck
DVBAY	dubay
DVBRATZ	dobbratz
DVBRYDJ	dubridge
DVBRYKYN	dobrikin
DVBRYZ	dobro
DVBSVN	dobson
DVBVYS	dubois
DVBYNSVN	dobinson
DVBYNYN	dubinin
DVBYR	dueber
DVCARM	ducharme
DVCAYLARD	duchaylard
DVCT	doctor
DVCYNC	deconinck
DVDA	duda
DVDAMANY	dodamani
DVD	dido
DVDGVN	dodgen
DVDJ	dido
DVDL	dodell
DVDLY	dudley
DV	dov
DV	dov
DVFVR	dufour
DVGAN	dogan
DVGAN	dogan
DVG	dog
DVGYVN	degen
DVHA	doha
DVHH	delhi
DVHRTY	doherty
DVHVR	douhour
DVHYRST	dewhirst
DVJN	dijon
DVK	dik
DVK	dik
DVLAN	dilan
DVL	del
DVLKYA	delia
DVLMAN	dolman
DVLR	delrio
DVLY	dooley
DVLYN	devlin
DVMBA	domba
DVM	dem
DVM	dem
DVMN	demon
DVMNYKV	dominique
DVMYKV	domeyko
DVMYKZ	domeyko
DVMYNGV	domingo
DVMYNYKAS	dominiques
DVMYNYK	dominique
DVMYNYK	dominique
DVMYNYKS	dominiques
DVMYNYKYVS	dominiques
DVMYNYN	dominion
DVMYNYVS	dominiques
DVNACY	donachie
DVNA	dvina
DVNALD	donald
DVNAT	donati
DVNATV	donati
DVNATY	donati
DVNAY	dunae
DVN	deven
DVN	deven
DVNG	deng
DVNHAM	denham
DVNKN	dunki
DVNLY	dinler
DVNPK	devenpeck
DVNPYK	devenpeck
DVNS	devins
DVNTSK	donetsk
DVNVAN	donovan
DVNYNY	donini
DVNYS	downys
DVPALM	depalm
DVPLR	doppler
DVPLT	doppelt
DVPRY	dupree
DVPYVYS	dupuis
DVRA	devereaux
DVRAND	durand
DVRAND	durand
DVRAN	doran
DVRAN	doran
DVRAPT	durupt
DVRAS	doras
DVRASY	doras
DVRATH	dorathee
DVRATY	durante
DVRAVKS	dereks
DVRAYA	devereaux
DVRAZYV	dorazio
DVRCAK	derick
DVRCN	doren
DVRDAL	dordal
DVRFMAN	dorfman
DVRHAM	durham
DVRKN	dorken
DVRKYN	dorken
DVRL	dorel
DVRLD	degerlund
DVRMA	dorma
DVRND	durand
DVRND	durand
DVRN	dorn
DVRN	dorn
DVRRANS	dorians
DVRST	dorset
DVRSY	dorsey
DVRSY	dorsey
DVRTCN	dortchen
DVRT	divertje
DVRTH	dorthy
DVRTJ	divertje
DVRTJH	divertje
DVRTVN	doreen
DVRTY	dorthy
DVRTY	dorthy
DVRVC	doric
DVRVTY	dorothy
DVRVYN	doreen
DVRY	dory
DVRYNDA	dorinda
DVRYS	devries
DVRYS	devries
DVRYSVMY	doraiswamy
DVS	devis
DVSKV	dusko
DVSN	dusen
DVSTALYK	dostalik
DVSTY	dusty
DVTA	udita
DVVAYKYNK	divakaruni
DVVL	deol
DVY	duy
DVYKYNK	duyckinck
DVYKYNK	duyckinck
DVYN	deven
DVYNDR	devender
DVYNY	deviney
DVYNYNG	downing
DVYR	diver
DVYSR	devisser
DVYT	devito
DVYTV	devito
DVYVYR	duvivier
DVYYKYNK	duyckinck
DVZAT	duzat
DVZYYR	dozier
DYAB	diab
DYA	diya
DYA	diya
DYALA	diyala
DYAMANTARAS	diamantaras
DYAMDY	diamond
DYAMVND	diamond
DYANA	deana
DYAN	dean
DYAZ	diaz
DYBAT	debathe
DYBATH	debathe
DYBATVNYA	debathonia
DYB	dib
DYBL	double
DYBT	djibouti
DYBTVNYA	debathonia
DYBV	debow
DYBYT	djibouti
DYCYR	decker
DYDA	duda
DY	duy
DY	duy
DY	duy
DYDRYSZ	deidres
DYDRYX	deidre
DYDYRYCS	diederichs
DYGAN	dogan
DYGAZMN	deguzman
DYGH	dighe
DYGNARV	degennaro
DYGRAF	degraff
DYGRF	degraff
DYGRV	degraw
DYGV	diego
DYGVYD	digweed
DYKANYNK	danone
DYKAVTY	delikatny
DYK	dik
DYK	dik
DYKL	dekel
DYKNS	dykins
DYKNZ	dokkene
DYKNZ	dokkene
DYKSAY	desai
DYKS	dykes
DYKSN	dickson
DYKSTRA	dikstra
DYKSVN	dickson
DYKSVN	dickson
DYKV	dike
DYKV	dike
DYKY	dike
DYKY	dike
DYKYNZ	dokkene
'DYL	adel
DYLAN	dylan
DYLAYR	delaere
DYL	doyle
DYLMA	dilma
DYLN	dolin
DYLNY	delaney
DYLR	delrio
DYLVRS	delores
DYLY	doyle
DYLY	doyle
DYLYNGR	dellinger
DYLYNGTN	darlington
DYLYP	dilip
DYLYP	dilip
DYLYV	deleeuw
DYMAD	demavend
DYMA	dema
DYMA	dema
DYMARS	demars
DYMARST	demarest
DYMARYP	dimaryp
DYMAS	dumas
DYMASK	dimashq
DYM	dem
DYMN	demon
DYMRS	demers
DYMSAK	domesday
DYMVK	domeyko
DYMYNG	deming
DYMYTAR	dimitar
DYMYTRY	dimitry
DYMYTRYS	dimitris
DYMYTRYV	demetrio
DYMYTRYV	demetrio
DYMYTRYVS	demetrius
DYNA	dyna
DYNA	dyna
DYNA	dyna
DYNAMYT	dynamite
DYNBYM	denebeim
DYN	den
DYN	den
DYN	den
DYNG	deng
DYNGLV	deangelo
DYNGSVR	dingsor
DYNGY	dingyi
DYNGY	dingyi
DYNL	dinler
DYNLR	dinler
DYNN	dinn
DYNPYK	devenpeck
DYNR	deaner
DYNS	dons
DYNS	dons
DYNSMVR	dinsmoor
DYNT	dent
DYNV	deno
DYNY	downy
DYNYNGR	deininger
DYPAK	dipak
DYPAYVLA	depaola
DYPAYVLV	dipaolo
DYPBVY	dipboye
DYPLD	dippold
DYPRSYV	depressive
DYPRTR	deporter
DYPYTRV	dipietro
DYR	dyer
DYR	dyer
DYR	dyer
DYRDRK	dierderick
DYRDRYK	dierderick
DYRK	dirk
DYRK	dirk
DYRKS	dirks
DYRVKV	derek
DYRVRTJ	dievertje
DYSANTV	desanto
DYSAV	desai
DYSAY	desai
DYS	deweys
DYSGY	disegi
DYSMVND	desmond
DYSNT	desanto
DYSTL	distel
DYTJY	dientje
DYTMAR	dietmar
DYTR	dexter
DYTVRZ	dexter
DYTVTALA	ditutala
DYVA	diya
DYVAKARVNY	divakaruni
DYVANATAN	devanathan
DYVAN	dewan
DYVAR	dewar
DYVAYN	dewayne
DYVAYN	dewayne
DYVAYZR	duvalier
DYVHA	doha
DYVN	deven
DYVNH	devine
DYVNPK	devenpeck
DYVNYDA	dionida
DYVRT	divertje
DYVRT	divertje
DYVRTH	dorthy
DYVRTJ	divertje
DYVRTJH	divertje
DYVRTJH	divertje
DYVVSR	devisser
DYVYA	divya
DYVY	devi
DYVYD	dawood
DYVYD	dawood
DYVYD	dawood
DYVY	devi
DYVYDSVN	davidson
DYVYDYAN	davidian
DYVYLDH	dewilde
DYVYS	devis
DYVYSN	dixson
DYVYSVN	dixson
DYVYT	devito
DYYALA	diyala
DYZNY	dizon
DYZR	dozier
DYZVN	dizon
DZ	dezio
DZGAGNH	desgagne
FABLR	faber
FABRH	fabre
FABRV	fabre
FABRYS	fabris
FABYANV	fabiano
FACS	face
FAD	fadl
FADL	fadl
FADNBRG	fudenberg
FADVR	feder
FADYLA	fadila
FADYL	fadil
'FAF	afaf
FAGAN	fagan
FAGANS	fagans
FAJN	fayne
FAJYVAR	fujiwara
FAKS	fawkes
FALCVK	falchuk
FALK	falk
FALKNR	faulkner
FALKRSVN	fulkerson
FALKV	falk
FALKVNR	faulkner
FALN	fallon
FALSAM	balsam
FALTAK	foltak
FALTLS	faultless
FALTVN	fulton
FALVN	fallon
FALY	farley
FALYVT	iqaluit
FALZ	faiz
FAMYVS	famus
FANDRYC	fandrich
FANG	fanger
FANGVS	fungus
FANTS	fontes
FARA	farag
FARAG	farag
FARAGV	farago
FARAT	furat
FARKAS	farkas
FARL	farley
FARLY	farley
FARMR	farmer
FARSBRG	forsberg
FARST	farsi
FARTK	farouk
FARVANYA	farwaniyah
FARVANYAH	farwaniyah
FARVGYA	farrugia
FARVK	farouk
FARVK	farouk
FARVQ	farooq
FARVZ	fairuz
FARYD	farid
FARY	faeroe
FARYHA	fariha
FARYVR	farer
FASBRG	forsberg
FAS	ufas
FAS	ufas
FASL	fasel
FATYMA	fatima
FATYS	fates
FAVAZ	fawaz
FAVL	fauvel
FAVNS	fagins
FAVNS	fagins
FAVST	faust
FAVST	faust
FAVST	faust
FAVST	faust
FAVZYA	fawziyya
FAVZY	fawzi
FAVZYYA	fawziyya
FAXRY	faeroe
FAYF	faye
FAYK	farouk
FAYLS	fales
FAYN	fayne
FAYNK	fayne
FAYNLY	fauntleroy
FAYNRTY	finerty
FAYNSTVN	faustino
FAYNTVN	quainton
FAYRBANK	fairbank
FAYRVZ	fairuz
FAYT	fayette
FAYYZ	fayiz
FAYZA	faiza
FAYZ	fayiz
FAYZ	fayiz
FAYZL	faizel
FAZA	faiza
FAZ	faiz
FAZL	faizel
FAZYA	fawziyya
FAZY	fawzi
FAZY	fawzi
FBRV	fabre
FCNR	fechner
FDL	fidel
FDR	feder
FDR	feder
FDRL	federle
FDRMN	federman
FDVR	feder
FDYLA	fadila
FDYL	fidel
FHD	fahd
FHT	fichte
FK	fike
FLAGLLY	flaglelee
FLAHRTY	flaherty
FLAKYGR	fluckiger
FLARDYNGA	flardinga
FLAT	flat
FLAT	flat
FLAVKA	felawka
FLAY	finlay
FLAYGYR	fluckiger
FLAYS	fulanis
FLDMAN	feldman
FLDMAR	feldmar
FLDMN	feldman
FLDR	felder
FLDSPAR	feldspar
FLJ	fletje
FLK	foulk
FLKYNZ	folkins
FLMR	flemmer
FLSTY	flesti
FLTH	flute
FLTJ	fletje
FLTJH	fletje
FLTYV	felteau
FLVCH	fluche
FLVDYN	flodin
FLVRA	flora
FLVR	flor
FLVR	flor
FLVRK	florek
FLVRNS	florines
FLVRS	flores
FLVRY	flory
FLVRYN	florine
FLVRZ	flory
FLVT	flute
FLVVRZ	fleury
FLVYD	floyd
FLYJH	elijah
FLYKS	folkes
FLYKYNGR	flickinger
FLYM	folsom
FLYMYNG	fleming
FLYNDRZ	flinders
FLYNT	flint
FLYNY	fellini
FLYSZ	flesti
FLYVRY	fleury
FLYZARDV	felizardo
FMMTH	femmetje
FMT	emit
FMTJ	femmetje
FMYA	femea
FNCARC	fenchurch
FNDR	fender
FN	fin
FN	fin
FNG	feng
FNGR	fanger
FNR	elfner
FNSKY	fenske
FNTVN	fenton
FNTYMAN	fentiman
FNVYK	foniok
FNY	feeney
FNYS	fenyes
FRA	fera
FRAGVRGYA	frageorgia
FRAM	frame
FRAMSAN	framson
FRAMSVN	framson
FRANDSN	frandsen
FRAN	fran
FRANGAKYS	frangakis
FRANKL	frankel
FRANKL	frankel
FRANKLYN	franklin
FRANKV	franke
FRANKV	franke
FRANKVY	frankie
FRANKVYS	frankies
FRANKVYZ	frankie
FRANS	frans
FRANSR	franser
FRANSSYDTJ	franscyntje
FRANSVYZ	franser
FRANSYKA	fransiska
FRANSYNTAY	franscyntje
FRANSYNTH	franscyntje
FRANSYNTJH	franscyntje
FRANSYNTY	franscyntje
FRANSYNTYH	franscyntje
FRANSYNTZ	franscyntje
FRANSYSKA	fransiska
FRANSYSKA	fransiska
FRANSYSKAS	fransiska
FRANSYSKVS	fransiska
FRANSYSYVS	francoises
FRANTYSK	frantisek
FRANTZN	frantzen
FRAQ	frame
FRARY	february
FRASR	fraser
FRAST	frost
FRASTY	frosti
FRAYDA	freida
FRAYDMAN	freedman
FRAYDMN	freedman
FRAYDY	faraday
FRAY	friday
FRAYGRSA	fritgersa
FRAYTGRSA	fritgersa
FRAZR	frazer
FRAZYR	frazer
FRAZYYR	frazier
FRDA	freda
FRDAYNND	ferdinand
FRD	ford
FRDKYN	fradkin
FRDRKYNG	frederking
FRDRYK	fredrik
FRDRYK	fredrik
FRDRYK	fredrik
FRDRYK	fredrik
FRDRYKV	frederique
FRDT	fredette
FRDYA	freda
FRDY	forde
FRDY	forde
FRDYG	ferdig
FRG	fargo
FRGT	forget
FRGVSN	ferguson
FRH	frith
FRJ	fri
FRJN	efren
FRLANG	furlong
FRLY	farley
FRM	fermi
FRNANDS	fernandes
FRNANDV	fernando
FRNANDZ	fernandez
FRNASYSKAS	fransiska
FRNASYSKAZ	fransiska
FRNC	france
FRNK	frink
FRNK	frink
FRNKH	franke
FRNKL	frenkel
FRNKL	frenkel
FRNKLYN	franklin
FRNKSVN	frankson
FRNKVYS	frankies
FRNKVYZ	frankie
FRNSAYNT	franscyntje
FRNS	ferns
FRNSNYT	fontenot
FRNSNYT	fontenot
FRNSVYS	furness
FRNSYNTY	franscyntje
FRNSYSKA	fransiska
FRNSYSKA	fransiska
FRNZL	frenzel
FRQ	fri
FRR	furr
FRSR	fraser
FRTYK	fertik
FRVANYAH	farwaniyah
FRVANYH	farwaniyah
FRVK	frink
FRVK	frink
FRVMYN	fremont
FRVNYAH	farwaniyah
FRVZ	fritz
FRYBRG	freeburg
FRYDA	freda
FRYDBRGR	friedberger
FRYD	fred
FRYDGYR	fridgeir
FRYDH	fred
FRYDL	friedl
FRYDMAR	friedmar
FRYDMN	fridman
FRYDMN	fridman
FRYDRYK	fredrik
FRYDYN	freidin
FRY	fry
FRY	fry
FRYHA	fariha
FRYKS	fryes
FRYLND	freeland
FRYLYNG	freiling
FRYLYNGR	freilinger
FRYLZ	fritz
FRYMAL	freemal
FRYMVT	fremont
FRYNGTVN	ferrington
FRYNK	frink
FRYNK	frink
FRYR	freer
FRYR	freer
FRYRMAT	freyermuth
FRYS	freys
FRYS	freys
FRYS	freys
FRYTAG	freitag
FRYTAS	freitas
FRYT	frito
FRYTGRSA	fritgersa
FRYTN	freetown
FRYTS	frits
FRYTV	frito
FRYTVL	fretwell
FRYTZYVS	fritzius
FRYVALD	freiwald
FRYVVGL	freivogel
FRYZ	fritz
FRYZR	frazer
FRYZR	frazer
FSDAL	fosdal
FST	feist
FSYG	fasig
FTC	fetch
FTCN	fetchen
FTRA	fetra
FTR	fetra
FVD	fed
FVJY	fiji
FVJYTA	fujita
FVJYVKA	fujioka
FVKV	fike
FVLDZ	felder
FVLGAM	fulghum
FVLKANYS	folkins
FVLK	foulk
FVLKS	folkes
FVLMN	feldman
FVLN	fulani
FVLR	feiler
FVLR	feiler
FVLY	feely
FVMRTVN	fumerton
FVNDAL	fundal
FVNDV	fondo
FVNGN	fongen
FVNG	feng
FVNKY	funky
FVNTNVT	fontenot
FVN	fin
FVNYVK	foniok
FVRBS	forbes
FVRBZ	fairuz
FVRD	ford
FVRDHAM	fordham
FVRDSANDN	furdesanden
FVRJY	furey
FVRK	fork
FVRLANG	furlong
FVRMN	forman
FVRMN	forman
FVRNR	fournier
FVRNY	fourney
FVRNY	fourney
FVRNYR	fournier
FVRR	furr
FVRRV	ferree
FVRSAYT	forsyth
FVRSAYT	forsyth
FVRSBLAM	forsblom
FVRSBRG	forsberg
FVRS	ferns
FVRSYL	forsale
FVRT	forte
FVRTS	forts
FVRY	feury
FVSNG	fosseng
FVT	foot
FVTRR	fuetterer
FVTS	fotis
FVTYNVS	fotinos
FVY	foy
FVYS	foxs
FVYY	feely
FVZARD	fozzard
FVZY	fuzzy
FVZYH	fuzhou
FXRYA	freya
FXRY	feury
FXRYYA	freya
FXYR	fiore
FYABAN	fiabane
FYAKSY	fawkes
FYASKVNARV	fiasconaro
FYBR	ferber
FYDALGV	fidalgo
FYDL	fidel
FYDLR	fidler
FYDVR	feder
'FYF	afif
FYGARD	figard
FYGVRA	figura
FYHAN	feehan
FYK	fike
FYKS	fisks
FYLAKS	fulanis
FYL	feil
FYLK	foulk
FYLPAT	flat
FYL	feil
FYL	feil
FYLPS	felipes
FYLR	feiler
FYLVS	felixs
FYLVZ	felix
FYLYAS	filias
FYLY	feely
FYLYP	felipe
FYLYPS	felipes
FYLYPS	felipes
FYLZ	filzek
FYMTJH	femmetje
FYMYJH	femmetje
FYNAN	finan
FYNAN	finan
FYNC	finch
FYN	fin
FYN	fin
FYNK	fink
FYNKL	finkle
FYNLY	finley
FYNLY	finley
FYNLY	finley
FYNSTAD	finstad
FYNY	feeney
FYNYN	fenian
FYNYS	fenyes
FY	foy
FYPS	felipes
FYRBNKS	fairbanks
FYRBRYN	fairbairn
FYR	fore
FYRHRST	fairhurst
FYRMA	firma
FYRN	fern
FYRVDR	fourier
FYRVK	fertik
FYRVZ	fairuz
FYRVZ	fairuz
FYSBYN	fishbein
FYS	fes
FYS	fes
FYSK	fisk
FYSR	fisher
FYTA	fetra
FYTC	fetch
FYTZJRALD	fitzgerald
FYTZVL	fitzwell
FYVR	fiore
FYVSTL	feustel
FYZA	fizeau
FYZ	fez
FYZH	fuzhou
FYZL	faizel
FZYA	fizeau
GABA	gaba
GABARA	gabara
GABBL	gabel
GABLR	gabler
GABRYLH	gabriele
GABRYLH	gabriele
GABRYYLSVN	gabrielsson
GABVR	gabor
GABYN	gabon
GACR	gacrux
GADBRY	gadbury
GADBT	godbout
GADBVRY	gadbury
GADBVYS	gadbois
GADFRVYD	godfroid
GADFRY	godfrey
GADGL	gadil
GADMN	gaiman
GADRV	gaudreau
GADSN	gadsden
GADSVARD	goudswaard
GADVYN	godewyn
GADY	gadi
GADYJN	goddijn
GADYL	gadil
GAF	graf
GAF	graf
GAFNY	gaffney
GAFRAN	ghufran
GAFYN	gaffin
GAGNH	gagne
GAHRTY	gaherty
GAJNH	gawne
GAJR	gair
GALA	galea
GALAGHR	gallagher
GALAGR	gallagher
GALAHAD	galahad
GALAN	galvan
GALANT	gallant
GALATYN	gallatin
GALAVY	galbavy
GALBAVAY	galbavy
GALC	gaelic
GALDN	geraldine
GAL	gael
GAL	gael
GAL	gael
GAL	gael
GALJ	gale
GALKV	galko
GALN	galen
GALP	gallop
GALPYN	galpin
GALT	gaillot
GALV	gale
GALVLA	galila
GALVSN	galveston
GALVVY	galilee
GALVY	galley
GALYBRT	galibert
GALY	gale
GALY	gale
GALY	gale
GALY	gale
GALYLA	galila
GALYLH	galilee
GALYLH	galilee
GALYTY	gaillot
GALYVN	galen
GALYZYA	galizia
GAMAK	gamay
GAMAL	gamal
GAMBYNV	gambino
GAML	gamil
GAML	gamil
GAMRV	gamero
GAMRVS	gaeris
GAMVN	gammon
GAMYJ	gamow
GAMYSH	gilgamesh
GANAPATY	ganapathy
GANAR	ganatra
GANATRA	ganatra
GANAVAN	ghanaian
GANDLC	gundlach
GANDRSVN	gunderson
GANDRZYK	gonderzik
GANDVRP	glandorf
GANDY	gandy
GAN	gan
GANG	gang
GANG	gang
GANGVLY	gangolli
GANL	granli
GANRVS	guarnieris
GANS	gans
GANSVN	ganesan
GANTRAM	guntram
GANTR	ganter
GANTR	ganter
GANTR	ganter
GANTRP	gantry
GANTRT	gantert
GANTVRP	ganter
GANTVRPH	gunthorpe
GANTY	ganti
GANVN	granvin
GANVYL	gonville
GANYR	gainor
GANYSAN	ganesan
GANZAK	ganzak
GANZALZ	gonzalez
GAPTA	gupta
GAPYSTY	gopisetty
GARADVAN	gurudevan
GARAFALV	garofalo
GARANS	guaranis
GARBH	garbe
GARBY	garbe
GARDNR	gardner
GARDYNR	gardner
GARFYLD	garfield
GARFYNKL	garfinkel
GARLYK	garlick
GARMZ	garms
GARN	garon
GARNR	garner
GARNT	garnett
GARNY	garner
GARSKY	gursky
GARSS	gauss
GARSVL	garshol
GARSYA	warsaw
GART	garito
GARTMN	gartin
GARTRYJ	gertrude
GARTYN	gartin
GARVD	garrod
GARVFALV	garofalo
GARVLA	gabriela
GARVTV	garito
GARYK	garlick
GARYK	garlick
GARYS	gaeris
GARYTV	garito
GASARD	gossard
GAS	gas
GASKAT	saskatoon
GASKVN	gaskin
GASKVYN	gaskin
GASKVYYN	gaskin
GASKYN	gaskin
GASKYNZ	gaskin
GASLR	gashler
GASLR	gashler
GASLYK	guslick
GASLYNG	gosling
GASPAR	gaspar
GASPR	gasper
GASTA	gastineau
GASTAVS	gustavs
GASTAVVS	gustavos
GASTLAV	eastlake
GASTLV	gastli
GASTYLV	gastli
GASTYN	gastineau
GASTYNYV	gastineau
GASVL	garshol
GASY	gas
GASYK	wasik
GASYNK	gascoyne
GATA	gatta
GAT	gat
GAT	gat
GATHARD	gotthard
GATKVMB	gatcombe
GATLYB	gateley
GATLY	gateley
GATLYN	gatlin
GATMN	gatun
GATMN	gatun
GATRYJ	gantry
GATSF	gates
GATS	gates
GATS	gates
GATVYN	gatun
GATYS	gates
GATYZ	gatz
GATZ	gatz
GATZVYLR	gutzwiller
GAVAZNY	gavazzeni
GAV	gao
GAVRD	goward
GAVR	gair
GAVTYR	gautier
GAVYNDAN	govindan
GAVYND	gaitonde
GAVYN	gavin
GAYA	gaya
GAYAT	gaya
GAYBS	gabons
GAYDA	gayda
GAYDRY	gaudreau
GAYDVAL	gaudrault
GAYDV	gadi
GAYGL	giegel
GAY	gay
GAYLR	gayler
GAYLVN	galen
GAYMN	gayman
GAYMVND	guimond
GAYNL	gaynell
GAYNVR	gaynor
GAYNVR	gaynor
GAYR	gair
GAYT	gaut
GAYVN	gavin
GAYYTZ	gaetz
GAZK	ganzak
GAZMN	gaiman
GBY	gobi
GDARD	goddard
GDBRY	gadbury
GDK	gedeck
GDRALT	gaudrault
GDR	goudier
GDYRA	goudreau
GDYRH	goodrich
GDYR	goudier
GDYS	gades
GF	gift
GFRAN	ghufran
GLAS	gilas
GLASKV	glasgow
GLASYR	glaser
GLASYYR	glaser
GLATZ	glatz
GLAYR	glaser
GLDASTYYN	goldsteen
GLDBRG	goldberg
GLDBRGR	goldberger
GLDFSMAN	geldefsman
GLDFSMN	geldefsman
GLDFVT	goldfoot
GLD	gold
GLDKMP	goldkamp
GLDMN	goldman
GLDR	golder
GLDYNG	golding
GLDZMN	goldman
GLDZVRSY	goldwaters
GLF	gulf
GL	gil
GLNDVRF	glandorf
GLN	glen
GLRYK	gorik
GLS	gils
GLSYRZ	glaser
GLTR	gelter
GLVB	golub
GLVJ	ogilvie
GLVRYA	gloria
GLVVY	ogilvie
GLYB	golub
GLYC	gaelic
GLYCMN	gleichman
GLYK	gleick
GLYKSMN	glicksman
GLYN	glen
GLYNZ	glen
GLYSVN	gulovsen
GLYVS	gleaves
GLYZR	gleizer
GMBL	gumbel
GMG	gog
GML	gamil
GML	gamil
GMYJ	gamow
GNAGY	gnagy
GNKS	genks
GNVSYS	gnosis
GNYSYLDA	gnishilda
GNZALS	gonzales
GNZALS	gonzales
GNZALZ	gonzalez
GNZALZ	gonzalez
GNZ	gimenez
GPH	gopher
GPJ	gepje
GRAB	graben
GRABNAR	grabnar
GRABN	graben
GRABYNR	grabiner
GRAD	grad
GRAF	graf
GRAFT	graft
GRAG	grau
GRAGTY	geraghty
GRAHAM	graham
GRAHAM	graham
GRAH	grah
GRAHRNA	grahorna
GRALYN	gralian
GRAMSS	gramsas
GRANBRGR	grunberger
GRANDASTRVM	grandmaster
GRAND	grand
GRAN	gran
GRANTAM	grantham
GRANT	grant
GRANVYN	granvin
GRANYT	granite
GRANZYV	granzeau
GRARDYN	gerardin
GRASKYN	gruskin
GRASR	graser
GRATR	grater
GRAV	gorav
GRAV	gorav
GRAV	gorav
GRAV	gorav
GRAYM	groom
GRAYNGR	grainger
GRAYSLDYZ	griseldis
GRAYSYLD	griswold
GRAYVAS	gracielas
GRAYY	gray
GRAYYNGR	grainger
GRAYYV	giraudoux
GRBS	gerbes
GRBYAH	gharbiyah
GRBYH	gharbiyah
GRDAN	gordan
GRDN	gorden
GRDNR	gardner
GRDY	gorde
GRFYT	graft
GRG	greg
GRG	greg
GRG	greg
GRGVR	gregor
GRGVR	gregor
GRHARD	gerhard
GRHART	gerhart
GRHART	gerhart
GRJVAYSN	greyson
GRKV	gorki
GRL	girl
GRLY	gurley
GRLYK	grilk
GRMAK	germack
GRMBAN	gremban
GRM	gorm
GRNANDR	grenander
GRND	greenwood
GRNDMSTR	grandmaster
GRNDYDYR	grandidier
GRN	goren
GRNGR	granger
GRNJR	groner
GRNJR	groner
GRNLY	grindley
GRNSYNG	grensing
GRNT	grant
GRNVYL	grenville
GRNYCR	granicher
GRNY	gurney
GRQTY	gerrity
GRSAPH	gersappe
GRSDVRF	gersdorf
GRS	gris
GRS	gris
GRSLDYS	griseldis
GRSR	graser
GRSTL	gerstl
GRSTY	grasty
GRSTYNN	grasteinen
GRTA	greta
GRTCN	gretchen
GRT	grit
GRT	grit
GRTRVD	gertrude
GRTRVYD	geertruyd
GRVBY	groebe
GRV	grov
GRVGVRY	gregory
GRVHVL	grohol
GRVLAYT	geervliet
GRVLYT	geervliet
GRVM	groom
GRVNR	groner
GRVNVALD	greenwald
GRVNYNK	groenink
GRVS	groves
GRVSJVHAN	grossjohann
GRVSK	grosek
GRVSR	grosser
GRVSY	groves
GRVT	grit
GRVT	grit
GRVTHAVS	grothause
GRVVR	grover
GRVVY	groovy
GRVYNCM	gorinchem
GRVYN	green
GRVYNLND	greenland
GRVYNVLD	groenveld
GRYBH	groebe
GRYBL	gribble
GRYBYH	groebe
GRYF	griff
GRYF	griff
GRYFR	greifer
GRYFR	greifer
GRYFR	greifer
GRYFY	griffy
GRYFYS	griffis
GRYFYTS	griffiths
GRYFYTZ	gorwitz
GRYG	greg
GRY	grey
GRYGR	gregor
GRYGVR	gregor
GRYKV	gromyko
GRYLK	grilk
GRYLNBK	grillenbeck
GRYNBRG	greenberg
GRYNDLY	grindley
GRYNG	goering
GRYNGH	greenough
GRYN	goren
GRYNGR	grainger
GRYNHAM	grinham
GRYNJ	greene
GRYNJR	groner
GRYNSVN	grinsven
GRYNVALD	greenwald
GRYNV	greene
GRYNVP	greenop
GRYNVVD	greenwood
GRYNYAS	greanias
GRYNYJ	geronimo
GRYPNKRL	griepenkerl
GRYR	greer
GRYSAYLD	griswald
GRYS	goreys
GRYSLD	griswold
GRYSLDYS	griseldis
GRYSMVR	grismore
GRYSR	grosser
GRYST	grist
GRYSVALD	griswald
GRYSVLD	griswold
GRYSVN	greyson
GRYSYLD	griswold
GRYSYLDH	griseldis
GRYT	grit
GRYTS	grotius
GRYTZ	gritz
GRYTZN	gerritzon
GRYTZVN	gerritzon
GRYVL	greuel
GRYVLYT	geervliet
GRYVNVD	greenwood
GRYYN	green
GRYYNVALD	greenwald
GRYZLY	grizzly
GRYZVN	gerritzon
GSAN	guan
GS	gs
GSKVYN	gaskin
GSKVYNH	gaskin
GSKYN	gaskin
GSKYNS	gaskins
GSKYNZ	gaskin
GSTAVVS	gustavos
GST	guest
GSTL	gostelow
GTYS	gettys
GVADA	gayda
GVANG	guang
GVAN	guan
GVAN	guan
GVANYAV	guanyao
GVARD	goward
GVBL	goble
GVBYN	gebing
GVCAN	grecian
GVDA	godau
GVDA	godau
GVDA	godau
GVDAL	goudal
GVDARD	goddard
GVDATA	gudata
GVDAT	gudat
GVDAYNAF	guiana
GVD	god
GVDGR	goodger
GVDHV	goodhew
GVDL	godel
GVDMAN	godman
GVDMN	godman
GVDNAF	godunov
GVDRAM	goodrum
GVDRAN	gudrun
GVDRV	guidry
GVDRV	guidry
GVDRYC	goodrich
GVDSN	godson
GVDSVN	godson
GVDVYN	godewyn
GVDVYN	godewyn
GVDYNG	gooding
GVDYN	godewyn
GVDYR	goudier
GVDYVAYN	gurudevan
GVDYVYN	godewyn
GVGAN	goegan
GVGR	geiger
GVGVAN	georgian
GVHD	gohde
GVH	goh
GVHYN	goheen
GVKYANV	guoqiano
GVLAND	goland
GVLAN	golan
GVLDYNG	golding
GVL	govil
GVLSBY	goolsbee
GVLT	geervliet
GVLVMB	golomb
GVLY	gilby
GVMZ	gomez
GVMZ	gomez
GVNAR	genaro
GVNNA	gonna
GVNTVRP	gunthorpe
GVNVT	genet
GVNY	gony
GVNZALS	gonzales
GVNZALS	gonzales
GVNZALV	gonzalo
GVNZALZ	gonzalez
GVPALA	gopala
GVPALAN	gopalan
GVPTA	gupta
GVPTH	gupte
GVPVL	gospel
GVPYNAT	gopinath
GVRALAVALA	goralwalla
GVRAL	gural
GVRALP	guralp
GVRAN	goran
GVRAPARTAP	gurupartap
GVRASPY	gorospe
GVRAV	gorav
GVRBRG	gorberg
GVRDF	gorde
GVRD	goverd
GVRD	goverd
GVRDN	gorden
GVRDYN	gorden
GVRGAN	georgian
GVRGANZ	georgian
GVR	ger
GVR	ger
GVRKY	gorky
GVRL	girl
GVRLY	gurley
GVRM	gorm
GVRMT	gourmet
GVRNAL	gornall
GVRNY	gurney
GVRTVN	gorton
GVRV	gorev
GVRVSAMY	gurusamy
GVRVYTZ	gorwitz
GVRY	gorey
GVRYK	gorik
GVRYNCM	gorinchem
GVRYNDR	gurinder
GVRYNG	goering
GVRYNMN	geronimo
GVRYS	goreys
GVSF	guse
GVS	ges
GVSTAV	gustav
GVSTAVS	gustavs
GVSTAVVS	gustavos
GVSTLV	gostelow
GVSVL	gospel
GVSVYL	goswell
GVSY	guse
GVTHARD	gotthard
GVTJS	gootjes
GVTLYB	gottlieb
GVTY	gootee
GVTYK	gitnick
GVVDGR	goodger
GVVDYNG	gooding
GVVRD	goverd
GVVVSYS	gouvousis
GVVYNDR	govinder
GVYAT	guyatt
GVYDV	guido
GVY	guy
GVYKARYS	geocaris
GVYLAM	guillaume
GVYL	govil
GVYL	govil
GVYL	govil
GVYLRMV	guillermo
GVYN	gwyn
GVYN	gwyn
GVYVDA	gouda
GVYYDV	guido
GVYYJR	gooijer
GVYYLYM	gwillim
GVYYN	givon
GVZVYTZ	goerwitz
GYANASY	guyanas
GYAT	guyatt
GYBSN	gibson
GYBSVN	gibson
GYBVNY	gibboni
GYBVNZ	gibboni
GYBVR	gerber
GYDRY	guidry
GYDV	gide
GYDVN	gideon
GYDZ	gide
GYFT	gift
GY	guy
GYGR	geiger
GYJSBRTAS	gijsbertus
GYJSBRTVS	gijsbertus
GYLAGLY	gillogly
GYLAM	gillam
GYLAM	gillam
GYLBAY	galbavy
GYLBRT	gilbert
GYLFRD	guilford
GYLFVRD	guilford
GYL	gil
GYL	gil
GYL	gil
GYL	gil
GYLMN	gilman
GYLMN	gilman
GYLMR	gilmer
GYLN	golan
GYLNR	gilner
GYLPYN	gilpin
GYLR	gayler
GYLRM	guillerm
GYLRMV	guillermo
GYLRVY	gilroy
GYLRY	gilroy
GYLSPAY	gillespie
GYLSPY	gillespie
GYLT	agoult
GYLVT	geleta
GYLYAM	gilliam
GYLY	gayle
GYLY	gayle
GYLYS	giles
GYLYS	giles
GYLYTA	geleta
GYLYZ	gleizer
GYLYZ	gleizer
GYML	gumbel
GYMNV	gemini
GYMNZ	gimenez
GYN	gwyn
GYNKZ	gimenez
GYNSBRG	ginsberg
GYNTN	ginton
GYNTVN	ginton
GYPJH	gepje
GYPN	gilpin
GYRARD	gerard
GYR	guyer
GYR	guyer
GYRHART	gerhart
GYRTRVYD	geertruyd
GYRTSN	geertsen
GYRVLAYT	geervliet
GYRVLYT	geervliet
GYSBRTVS	gijsbertus
GYS	guys
GYSH	gish
GYSYLDA	gnishilda
GYTARD	guitard
GYT	gootee
GYT	gootee
GYTGY	geitgey
GYTLMN	gitlin
GYTLYN	gitlin
GYTN	gutwein
GYTNYK	gitnick
GYTS	egypts
GYTVMR	gitomer
GYTVND	gaitonde
GYVF	geoff
GYVLYTY	giulietti
GYVN	givon
GYVVANY	guoqiano
GYVVN	givon
GYVYN	givon
GYVZ	gomez
GYYANKVLA	giancola
GYZAV	gizaw
HABA	haba
HABRDR	habereder
HABR	haber
HABR	haber
HABRKAM	abram
HABRLC	haberlach
HABRMN	haberman
HABRT	habert
HABS	ahabs
HABVRA	habura
HABVRG	hamburg
HABYN	chabun
HABZ	haber
HACHALTR	hochhalter
HACYNSVN	hawkinson
HACYNZ	haynie
HACYSVN	acheson
HADGZ	hodge
HADLND	headlund
HADLSTVN	huddleston
HADLY	hadley
HADRAMAT	hadramawt
HADRAMAVT	hadramawt
HADSN	hardison
HADSVN	hardison
HADSVN	hardison
HADVBA	hudoba
HADYA	hadiya
HADY	haddy
HADYL	hadil
HAFBK	hoffbeck
HAFMN	hageman
HAFMN	hageman
HAFMN	hageman
HAFNYLYNG	havoline
HAFR	hafer
HAFSAH	hafsah
HAFS	hafs
HAGA	haga
HAGAN	hagan
HAGARD	haggard
HAGARD	haggard
HAGDAL	hugdahl
HAG	hague
HAGKYNZ	hawken
HAGLR	hagler
HAGLYN	hagelin
HAGMN	hageman
HAGMN	hageman
HAGN	hagen
HAGR	hager
HAGS	changs
HAGSVN	hagelin
HAGTN	hagen
HAGYN	hagen
HAHTAHA	chihuahua
HAJ	haj
HAJKYNZ	hawken
HAJR	hajar
HAJRZ	hajery
HAJS	hays
HAJYR	hajery
HAJZ	hafiz
HAKABAY	huckaby
HAKDT	hakluyt
HAK	hak
HAK	hak
HAKLY	hackley
HAKNYS	hawkins
HAKSA	hausa
HAKSAV	hackshaw
HAKS	hawks
HAKSL	haskel
HAKSV	hawks
HAKVLYNN	hakulinen
HAKVYL	haskel
HAKY	hak
HAKYNG	hawking
HALAM	hallam
HALAN	harlan
HALAT	halat
HALDR	haldre
HALFLDR	holfelder
HALGR	haleger
HAL	hal
HAL	hal
HALKDYS	halkedis
HALK	chalk
HALKNR	holkner
HALM	halm
HALMN	halon
HALND	headlund
HALN	halon
HALPYN	halpin
HALR	halar
HALR	halar
HALRT	hallert
HALSTD	halsted
HALST	halsted
HALTGRN	hultgren
HALTSYNGR	holtsinger
HALTVN	healton
HALTZ	hiltz
HALVB	ghalib
HALYBRTVN	halliburton
HALYDY	haldre
HALYFYLD	hollifield
HALY	haley
HALY	haley
HALYMN	halon
HALYVL	hall
HALZR	holzer
HAMACY	hamachi
HAMAH	hamah
HAMANS	hamans
HAMANZ	haman
HAMARKVYYST	hammarquist
HAMBYG	hamburg
HAMBYJ	hambidge
HAMD	hamid
HAMFRY	hamer
HAMFRYZ	ramirez
HAMFRYZ	ramirez
HAMH	hamah
HAML	hamel
HAML	hamel
HAMMANZ	hammans
HAMNS	hamans
HAMPRYVN	hamparian
HAMPSAYR	hampshire
HAMPSYR	hampshire
HAMPTVN	hampton
HAMR	hamer
HAMSAYR	hampshire
HAMVND	hammond
HAMVNDZ	bahamonde
HAMY	hami
HAMYL	hamel
HAMYLTN	hamilton
HAMYLTVN	hamilton
HANAFVRD	hannaford
HANA	ghana
HANBVT	hanebuth
HANDL	handel
HANDRSVN	henderson
HANG	huang
HANGRFVRD	hungerford
HAN	han
HANKH	hanke
HANKLR	hunkler
HANKZ	hanke
HANSAKR	hunsaker
HANSN	hansen
HANSN	hansen
HANSR	hansher
HANSVN	hansen
HANSVN	hansen
HANT	thant
HANTYNGTVN	huntington
HANV	hani
HANYA	haniyya
HANYFA	hanifa
HANY	haney
HANYH	hanoi
HANYMN	hannemann
HAPKARFT	havarti
HAPKRAFT	hopcraft
HAPKRFT	hopcraft
HAPKYNZ	hawken
HAPR	harper
HAPSVN	hopson
HARALD	harald
HARALDSN	haraldsen
HARARY	harare
HARATZ	haratz
HARBD	harbud
HARBR	harber
HARBR	harber
HARBR	harber
HARBRN	harburn
HARBRYJ	harber
HARBVD	harbud
HARBVR	harber
HARBYG	harbidge
HARBYJ	harbour
HARDN	harden
HARDYMN	hardiman
HARDYNG	harding
HARDYN	harden
HARDYSVN	hardison
HARGRAVZ	hargreaves
HAR	har
HARKL	harker
HARKR	harker
HARKVM	harkcom
HARKYN	harkin
HARKYNZ	harkin
HARLD	harold
HARLD	harold
HARL	harlow
HARLND	harland
HARLN	harlan
HARLV	harlow
HARMAN	harman
HARMANVS	harmanus
HARMN	harmon
HARMNVS	harmanus
HARMVTV	haramoto
HARMZ	hormuz
HARNR	harincar
HARP	harpe
HARPR	harper
HARPVLD	harpold
HARR	harrow
HARRYG	harrig
HARSA	harsha
HARS	hares
HARS	hares
HARTAG	hartog
HARTAH	hurtah
HARTFYLD	hartfield
HART	hart
HART	hart
HARTL	hartel
HARTLP	hartlep
HARTLY	hartley
HARTMN	hartman
HARTR	harter
HARTVL	hartel
HARTVYL	hartel
HARTYGAN	hartigan
HARVARD	harvard
HARV	harv
HARVHYSA	haruhisa
HARVLD	harold
HARVL	harvell
HARVN	haroon
HARVN	haroon
HARVNY	haruni
HARVY	harvey
HARYCN	haricken
HARYHARAN	hariharan
HARYKN	haricken
HARYNKAR	hardikar
HARYS	hares
HARYSVN	hardison
HARYV	harvie
HARYZ	khwarizmi
HASAKAH	hasakah
HASAL	hascall
HASBRVK	hasbrouck
HASBY	hasbro
HAS	chas
HAS	chas
HASKAL	haskel
HASK	haskel
HASKL	haskel
HASKL	haskel
HASKYNZ	vasquez
HASLVM	haslum
HASMN	yasmine
HAST	haste
HASTTLR	hostetler
HASTVN	wheatstone
HASTYNGZ	hastings
HASYK	heeswyk
HATAP	chatane
HATCSVN	hutcheson
HATCYNSVN	hutchinson
HATCYNZ	hawtin
HATCYSVN	hutcheson
HAT	hate
HATLNDNSYS	holtlandensis
HATLY	heatlie
HATM	hatem
HATMYKR	hatmaker
HATR	harter
HATRL	hatrell
HATVN	hawtin
HATVN	hawtin
HATVRY	hattori
HAVARD	havard
HAVDVN	hawdon
HAVGTAYLYNG	houghtailing
HAV	hao
HAV	hao
HAV	hao
HAVK	haik
HAVK	haik
HAVKR	hawker
HAVKYN	hawken
HAVKYNZ	hawken
HAVL	havel
HAVLY	hailey
HAVLZ	hailey
HAVN	haven
HAVN	haven
HAVS	hays
HAVSR	hasbro
HAVTVN	hawtin
HAVTYLYNG	havoline
HAVTYN	hawtin
HAVVLA	havola
HAVVNN	hann
HAVY	harvey
HAVYS	hayes
HAYBRD	habereder
HAYBZ	chavez
HAYC	haich
HAYDAR	haidar
HAYD	haydu
HAYDMN	hayden
HAYDN	haydn
HAYGDAN	hagan
HAYKY	haik
HAYLND	thailand
HAYLT	haylett
HAYLVRD	halford
HAYLY	hailey
HAYM	hakim
HAYNGH	hainge
HAYN	haynie
HAYN	haynie
HAYNLY	haynie
HAYNS	haynes
HAYNS	haynes
HAYNY	haynie
HAYNZ	haynie
HAYNZ	haynie
HAYPLY	hailey
HAYR	hayter
HAYRVNYMVS	hieronymus
HAYSLVP	hyslop
HAYSVN	hamson
HAYTR	hayter
HAYTS	haitis
HAYTZ	haiti
HAYVARD	hayward
HAYVKYNSVN	hawkinson
HAYVKZ	chavez
HAYVL	haxel
HAYZ	hafiz
HAYZ	hafiz
HAZN	hazen
HBNTVN	hebenton
HBRN	hebborn
HBRVQ	hebrew
HBVRN	hebborn
HBYBA	habiba
HBYBH	habib
HDAD	haddad
HDAK	odwak
HDAVY	hadavi
HDAYA	hadaya
HDAYA	hadaya
HDAYDAH	hudaydah
HD	hood
HDLND	hedlund
HDLND	hedlund
HDLVND	hedlund
HDLY	hadley
HDRAMAVT	hadramawt
HDRAMVT	hadramawt
HDRMAT	hadramawt
HDRYK	hedrick
HDSA	rhodesia
HDS	heidis
HDYA	hadiya
HDYDA	hudaydah
HDYDH	hudaydah
HDYH	heidrich
HDYL	hadil
HDYN	hedin
HFRVN	heffron
HFSA	hafsah
HFSAH	hafsah
HFS	hfs
HFSH	hafsah
HGARTY	hegarty
HGLND	hoogland
HGTYLYNG	houghtailing
HGY	hegyi
HGY	hegyi
HGYR	hager
HHMN	hehman
HJR	hajar
HJRY	hajery
HK	heke
HKR	hooker
HKR	hooker
HKSAV	hokusai
HKSV	hokusai
HKT	heke
HKTVR	heeter
HKYM	hakim
HKYNG	hawking
HKZN	hekezen
HLAB	halab
HLAL	helal
HLAN	hulan
HLAVYN	hlavin
HLB	holub
HLBLYNG	helbling
HLBYG	helbig
HLBYNG	helbing
HLD	child
HLDN	holden
HLFMN	helfman
HLGA	helga
HL	heel
HLKANT	hellekant
HLK	helke
HLLR	heller
HLMN	helman
HLMN	helman
HLMNSTAYN	helmenstine
HLMR	hilmer
HLMZ	hulme
HLMZ	hulme
HLNA	helena
HLND	ohlund
HLNDR	hendrix
HLN	helen
HLN	helen
HLR	wheeler
HLSTRVM	ahlstrom
HLT	helt
HLTLANDNSYS	holtlandensis
HLTLNDNSYS	holtlandensis
HLTVN	hilton
HLV	helou
HLVJ	helou
HLVM	holum
HLY	holy
HLY	holy
HLYNDN	hollinden
HLYVL	hillel
HLZGNG	holzgang
HLZMN	holzman
HMAH	hamah
HMAM	hamam
HMANS	humanes
HMANZ	homan
HMAR	dhamar
HMBAYJ	bombay
HMBYJ	chembezi
HMDAN	hamdan
HMD	ahmed
HMH	hamah
HML	hamel
HMP	hempe
HMPSAYR	hampshire
HMPSR	hampshire
HMRA	hamra
HMR	hemer
HMR	hemer
HMR	hemer
HMSTD	hemstede
HMSYRH	hampshire
HMYD	ahmed
HMYLTN	hamilton
HMYLTVN	hamilton
HMZA	hamza
HMZ	hormuz
HMZH	chembezi
HNA	china
HNA	china
HNAN	hanan
HNCLYF	hinchliffe
HND	hind
HNDL	handel
HNDRSN	henderson
HNDRSVN	henderson
HNDRYCVZ	hendricus
HNDRYCY	hendricus
HNDRYKA	hendrikje
HNDRYKAS	hendriks
HNDRYK	hendriks
HNDRYKH	hendrikje
HNDRYKJ	hendrikje
HNDRYKJH	hendrikje
HNDRYKS	hendriks
HNDRYKS	hendriks
HNDRYKS	hendriks
HNDRYKSH	hendrikse
HNDRYKSN	hendrickson
HNDRYKSVN	hendrickson
HNDRYKVS	hendriks
HNDRYKY	hendrikje
HNDY	hindi
HNDZ	hindi
HN	hin
HN	hin
HNJ	hentje
HNJY	hentje
HNKL	henkel
HNKS	hanks
HNL	henle
HNLY	heinly
HNNFNT	hennenfent
HNRYK	henrik
HNRYT	henriet
HNSLY	hensley
HNSN	henson
HNT	hunt
HNTH	chenteh
HNTJ	hentje
HNTJH	hentje
HNTYG	hentig
HNYA	chunyan
HNYFA	hanifa
HNYFH	nayfeh
HNYGAN	henegan
HNYG	honig
HNY	hine
HNY	hine
HNYJ	hentje
HNYK	henrik
HNYNGSN	henningsen
HNY	hine
HNZ	hinz
HPKRAFT	hopcraft
HPLR	hepler
HQYR	huyer
HRABY	hrabi
HRAK	horak
HRAN	horan
HRANYKY	hranicky
HRAYZYNG	thorazine
HRBAYJ	charbray
HRBRT	herbert
HRBVRT	herbert
HRBYJ	hirobumi
HRDASFYLD	herdsfield
HRD	herd
HRD	herd
HRDSFYLD	herdsfield
HRDZFYLD	herdsfield
HR	heuer
HRLAYNDYZ	hernandez
HRLNDYS	herlindis
HRLVY	hurley
HRLYNDYS	herlindis
HRMAN	herman
HRMAN	herman
HRMAN	herman
HRMAN	herman
HRMANS	hermans
HRMN	harmon
HRMN	harmon
HRMN	harmon
HRMN	harmon
HRMNVS	herminias
HRMNYVS	herminias
HRMS	hermes
HRMVSV	hermoso
HRMZ	hormuz
HRNAKY	hernacki
HRNANDZ	hernandez
HRNDVN	herndon
HRN	horn
HRN	horn
HRN	horn
HRNKR	hornecker
HRNSBAY	hornsby
HRRA	herrera
HRSFAL	horsfall
HRT	hirt
HRTLYNG	hertling
HRTVK	hertweck
HRV	horio
HRVN	huron
HRVNYMVS	hieronymus
HRVS	horus
HRVY	hervey
HRYK	shrek
HRYKN	haricken
HRYNG	behring
HRYNGSAV	herringshaw
HRYS	horus
HRYSVN	thoresen
HRYT	hirota
HRYVL	cheryl
HSAKA	hasakah
HSAKAH	hasakah
HS	hs
HS	hs
HSH	honshu
HSKAH	hasakah
HSKH	hesketh
HSMANS	heismans
HSMNS	heismans
HSNA	hasna
HSN	hosn
HSN	hosn
HST	haste
HSTR	hester
HSTYNGZ	hastings
HSYMANZ	houseman
HSYN	hyson
HSYN	hyson
HSYN	hyson
HSYN	hyson
HTCR	whitacre
HTKVKS	shikokus
HTRYK	hetrick
HTZLR	hetzler
HVADLY	headley
HVA	hua
HVAR	hoar
HVBR	huber
HVBRMN	hoberman
HVBVRVG	heiberg
HVBVRV	huber
HVBVRVQ	hebrew
HVCYNSVN	hutchinson
HVDAYDAH	hudaydah
HVDGY	hodge
HVD	hviid
HVDKYNS	hodgkins
HVDKYNZ	hodgkin
HVDSN	hodson
HVDSVN	hodson
HVFGARD	hofgaard
HVFRD	hoford
HVFRYN	heffron
HVFT	hooft
HVGAN	hogan
HVGARD	hugard
HVGARD	hugard
HVGARTY	hegarty
HVG	hug
HVG	hug
HVG	hug
HVGLND	hoogland
HVGNBVM	hoogenboom
HVGN	huigen
HVGS	hugos
HVGTAYLYNG	houghtailing
HVGTYLYNG	houghtailing
HVGV	hoge
HVGVYN	hoogeveen
HVHNSVN	hohensohn
HV	he
HV	he
HVK	heke
HVKN	hawken
HVLAND	heiland
HVLDN	holden
HVLDZVRS	holders
HVL	heel
HVL	heel
HVLKAMB	holcomb
HVLKNR	holkner
HVLM	holm
HVLMN	helman
HVLMZ	hulme
HVLNDNSYS	holtlandensis
HVLRVYD	holroyd
HVLS	hulse
HVLSTN	holsten
HVLTLNDNSYS	holtlandensis
HVLYMN	hollyman
HVLZN	holzen
HVLZVARS	hilarios
HVMAK	ohmaki
HVM	heim
HVM	heim
HVMN	hymen
HVNG	hong
HVNYGBRG	honigberg
HVP	heep
HVP	heep
HVPR	hooper
HVQTYLYNG	hertling
HVQYM	heim
HVRGAN	horgan
HVRKAN	horkan
HVRN	horn
HVRNR	horner
HVRSFVRD	horsford
HVRST	herst
HVRTMN	hortmann
HVRTR	howerter
HVRVAT	horvat
HVRVT	horvat
HVRVVYTZ	horowitz
HVRVYTZ	horowitz
HVRYGMV	horrigmo
HVRYHAN	hourihan
HVRY	horio
HVRYNG	herring
HVRYV	horio
HVS	hovis
HVSMN	heisman
HVSTVN	heston
HVTN	hawtin
HVVART	howarth
HVVN	hooven
HVVR	hoover
HVYA	choua
HVYBRG	heiberg
HVYD	hviid
HVYGN	huigen
HVYJN	hixon
HVYMAN	hoyman
HVYNG	hewing
HVYSR	huyser
HVYT	cheviot
HVYTYNK	hoitink
HVYYSKN	huisken
HVZ	hinz
HYBAX	chiba
HYBRG	heiberg
HYBRT	hebert
HYBVRN	hebborn
HYCMN	hickman
HYCNS	holocenes
HYDAJAT	hidajat
HYDLAND	headland
HYDN	hedin
HYDN	hedin
HYDNR	heidner
HYDR	hydra
HYDRYC	hedrick
HYDRYS	theodores
HYFA	haifa
HYFLR	heffler
HYFTZ	heifetz
HYGARTY	hegarty
HYGL	hegel
HYGN	huigen
HYGRMN	hegermann
HYGVNT	huguenot
'HYH	yahweh
HY	huey
HYJDAN	wijdan
HYJMN	hymen
HYKARV	hikaru
HYK	heke
HYKMN	hickman
HYKSVN	hawkinson
HYKV	heke
HYKY	heke
HYKY	heke
HYLBRY	hillberry
HYLDBRAND	hildebrand
HYLD	child
HYL	hoyle
HYL	hoyle
HYL	hoyle
HYL	hoyle
HYL	hoyle
HYLKR	hilker
HYLMR	hilmer
HYLNBRND	hillenbrand
HYLND	hyland
HYLND	hyland
HYLNTH	heleentje
HYLRY	hilary
HYLS	hulse
HYLSNTYGR	hilsenteger
HYLSVN	hilson
HYLT	helt
HYLTH	hollerith
HYLT	helt
HYLTJ	heyltje
HYLTJH	heyltje
HYLTJH	heyltje
HYLTJ	heyltje
HYLTN	hilton
HYLYARD	hillyard
HYLY	holy
HYLYRSTYN	hellerstein
HYLYS	huxleys
HYLYTH	hollerith
HYLZ	hiltz
HYM	heim
HYMN	hymen
HYMN	hymen
HYMSTD	hemstede
HYNCLY	hinchley
HYNCY	hince
HYND	hind
HYNDRYKA	hendrikje
HYNGAN	henegan
HYNG	hong
HYN	hyun
HYNJ	hentje
HYNLY	heinly
HYNR	henri
HYNS	hynes
HYNS	hynes
HYNS	hynes
HYNSVN	henson
HYNTVN	hinton
HYNTZ	heintz
HYNV	hine
HYNVNN	heinonen
HYNVZ	hinz
HYNZ	hinz
HYNZ	hinz
HYNZ	hinz
HYNZ	hinz
HYNZ	hinz
HYPGRYV	hipgrave
HYP	heep
HYPS	heeps
HYRAY	hirai
HYRDGN	heerdegen
HYRD	herd
HYRLY	hurley
HYRN	horn
HYRNH	horne
HYRN	horn
HYRT	hirt
HYRVNYMAS	hieronymus
HYRVNYMVS	hieronymus
HYRVTA	hirota
HYSAN	hisan
HYS	hueys
HYSKVKS	hoskins
HYSKVT	hesketh
HYSLAP	hyslop
HYSL	hisel
HYSLVP	hyslop
HYSMANS	heismans
HYSMNS	heismans
HYSR	huyser
HYTN	hawtin
HYTR	heeter
HYTR	heeter
HYTS	whites
HYTSVN	hitson
HYTVN	hawtin
HYTZ	hitz
HYTZ	hitz
HYVARD	howard
HYVGN	huigen
HYV	hei
HYVKYNZ	heinz
HYVM	heim
HYVNGAN	henegan
HYVNSV	hyunsoo
HYVVYT	cheviot
HYVZ	heinz
HYVZR	hoover
HYYN	hyun
HYZ	hinz
HYZMAN	holzman
HYZMANS	heezemans
HYZMNS	heezemans
HYZMNZ	heinz
HYZYMNZ	heezemans
HZLTVN	hazelton
HZMNZ	heinz
JABJH	jacobje
JAB	joab
JAB	joab
JAD	jared
JAD	jared
JAD	jared
JAGARD	jagard
JAG	jago
JAGR	jager
JAGV	jago
JAHMANH	jahmane
JAHNS	johns
JAKAMYNTH	jacomyntie
JAKSVN	jackson
JAKVAS	javas
JAKVBH	jakobsson
JAKVB	jackie
JAKVBJH	jacobje
JAKVBJ	jacobje
JAKVBS	jakobsson
JAKVBSVN	jakobsson
JAKVBSVN	jakobsson
JAKVBY	jakobsson
JAKVBZ	jakobsson
JAKVMYNTAY	jacomyntie
JAKVMYNTYH	jacomyntie
JAKVMYNTY	jacomyntie
JAKVMYT	jacomyntie
JAKVS	jakes
JAKVYZ	vasquez
JAKVZ	jackie
JAKYVZ	vasquez
JALA	jala
JALVNN	jalonen
JAMVNA	jamuna
JANA	jana
JANARDHAN	janardhan
JANATVN	jonathon
JANCS	janices
JANG	jang
JANG	jang
JANG	jang
JANGNYKL	jungnickel
JANGR	jahangir
JANGTAYY	jongtae
JAN	jan
JAN	jan
JAN	jan
JAN	jan
JANK	jahnke
JANK	jahnke
JANKYNSVN	jenkinson
JANSH	jans
JANS	jans
JANSJH	jansje
JANSJ	jansje
JANSKY	jansky
JANSN	jansen
JANSN	jansen
JANSVN	jansen
JANSVN	jansen
JANTH	janet
JANT	janet
JANT	janet
JANTJ	janotje
JANTVJ	janotje
JANTYH	janette
JANVTH	janet
JANVT	janet
JANVTJH	janotje
JANY	jane
JANYKA	janecka
JANZ	janzen
JANZ	janzen
JAP	jaepje
JAPJH	jaepje
JAPJ	jaepje
JARAS	jarash
JARBVT	jarbot
JARDYN	jardine
JARS	jareds
JART	jarbot
JARVALA	jarwala
JARVYS	jarvis
JARYTJN	zjarritjen
JASCK	jaschek
JAS	ouijas
JASPR	jasper
JASPRZ	jasper
JASTAM	justham
JASTAS	juanitas
JASTJH	justje
JASTJ	justje
JAST	ojaste
JASTJY	justje
JASTYH	ojaste
JASTYN	jamestown
JASTYN	jamestown
JASTYN	jamestown
JASTYN	jamestown
JASTYS	justus
JASVA	java
JASVYNDR	jasvinder
JATJY	janotje
JATYNDR	jatinder
JAVF	jawf
JAVYD	javed
JAVYKA	janecka
JAVYR	javier
JAYAN	jayan
JAYANT	jayant
JAYARAM	jayaram
JAYN	jayne
JAYN	jayne
JAYNVR	joyner
JAYP	jaepje
JBHH	jehovah
JBH	john
JBYR	jabir
JDY	jody
JF	jawf
JF	jawf
JFKK	jiok
JFRY	jeffry
JFRYZ	juarez
JHAMANH	jahamane
JHANG	jhang
JHAN	jehan
JHAR	johar
JHMANH	jahmane
JHRA	jahra
JKBS	jobs
JK	jiok
JKMN	jakeman
JKMN	jakeman
JKSVN	jackson
JKVBS	jobs
JKVBSVN	jakobsson
JKVBZ	joubin
JKYN	jokin
JLA	julia
JLAL	jalal
JL	jul
JLJ	jeltje
JLNY	jolene
JLTH	walth
JLT	joliet
JLTJH	jeltje
JLVMARK	jelvemark
JMAL	jamal
JMAL	jamal
JMAR	jamar
JML	jamel
JML	jamel
JMML	jimmie
JMVLA	djamila
JMYLA	djamila
JMYLAH	jamilah
JMYLA	djamila
JMYL	jamel
JMYLH	jamilah
JMYLH	jamilah
JMYL	jamel
JNAH	jenah
JNA	juneau
JNDRYAV	gendreau
JNDRYC	gendrich
JNG	jeng
JNG	jeng
JN	jen
JNK	junk
JNK	junk
JNKS	jenks
JNKS	jenks
JNKYNSVN	jenkinson
JNKZ	junkie
JNT	janet
JNTJS	janotje
JNTRY	gentry
JNYFR	jenifer
JNYKH	jenneke
JNYK	junk
JNYNGZ	jenings
JNYRV	joiner
JNYSYLDA	gnishilda
JPSN	jeppesen
JPY	jeep
JRADA	jerada
JRALD	jerald
JRARD	ierardi
JRARD	ierardi
JRARDY	ierardi
JRGNZ	jorgen
JRHARD	erhard
JRMYAS	jeremias
JRMY	jeremy
JRMYK	jeremy
JRMYS	jeremys
JRS	jrs
JRSTL	gerstl
JRTRVD	gertrude
JRVNYMVS	jeronimus
JRVNYVS	jeronimus
JRVYS	jarvis
JRYNG	irving
JRYNGR	junger
JRYTSMA	jorritsma
JRYTY	verity
JRYTZVN	gerritzon
JSF	josef
JSPR	jesper
JSTR	jester
JSTVN	justin
JSYKA	fujioka
JSYK	jeske
JTRV	jethro
JTSAM	jetsam
JVAB	joab
JVANA	juana
JVANDR	juvander
JVANG	juang
JVAN	jovian
JVAN	jovian
JVANYTA	juanita
JVAV	joao
JVAY	juay
JVBAL	jubal
JVBJ	jobje
JVB	job
JVB	job
JVBYN	joubin
JVDAS	judas
JVD	jed
JVDY	jody
JVDY	jody
JVF	jawf
JVF	jawf
JVFL	joel
JVGLA	jougla
JVHANA	johanna
JVHAN	jehan
JVHANSN	johansen
JVHANSN	johansen
JVHANSVN	johansen
JVHANSVN	johansen
JVHANSVN	johansen
JVHANY	juhani
JVHANZ	juhani
JVHANZ	juhani
JVLAY	julia
JVL	jul
JVL	jul
JVLTZ	jeltje
JVLYANTH	juliaantje
JVLYANTJH	juliaantje
JVLYANTJ	juliaantje
JVLYANT	juliaantje
JVLYANY	julian
JVLYF	jolee
JVLY	joly
JVLY	joly
JVLY	joly
JVNAS	jonas
JVNGAN	jungian
JVNGANZ	joungane
JVN	jen
JVN	jen
JVN	jen
JVNV	joni
JVNY	joni
JVNYN	jonin
JVNYVR	junior
JVPRV	joppru
JVRAH	jurah
JVRA	joura
JVRAN	jirman
JVRAVLV	jouravlev
JVRGNZ	jorgen
JVRJ	jeri
JVRJN	jorgen
JVRJN	jorgen
JVRJYA	jurua
JVRJYV	jeremy
JVRK	jurek
JVRVYTZ	goerwitz
JVRY	jory
JVRYNG	coevering
JVRYSMA	jorritsma
JVRYTSMA	jorritsma
JVS	joves
JVSLYN	joslin
JVSTH	justham
JVSTJ	justje
JVSTY	justo
JVSVA	josefa
JVSVYG	joswig
JVSYP	josip
JVTLYN	jocelyn
JVVN	joon
JVYDYP	joydeep
JVYNR	joyner
JVYNR	joyner
JVYSF	josef
JVYS	joys
JVYT	jesuit
JVYT	jesuit
JVZA	juza
JVZF	josef
JVZFVS	jenifers
JVZP	jeep
JVZY	jezire
JVZYH	jewish
JVZY	jezire
JVZY	jezire
JYAF	jawf
JYA	jia
JYAKVB	joaquin
JYAN	jean
JYANY	jeanie
JYAVRDANY	jayawardene
JYBSVN	jebsen
JYBYNS	jacobins
JYGANG	jigang
JY	joy
JY	joy
JYJSBRTVS	gijsbertus
JYKMN	jokin
JYLAM	welam
JYLBRT	joubert
JYL	jul
JYLT	joliet
JYLYAN	julian
JYLZ	jolee
JYM	jim
JYML	jamel
JYMSVN	jameson
JYMY	jimmy
JYMYNY	jiminey
JYMZ	jimenez
JYMZ	jimenez
JYMZ	jimenez
JYNAKYRAMAN	janakiraman
JYNG	jeng
JYN	jen
JYN	jen
JYN	jen
JYN	jen
JYN	jen
JYNS	jeynes
JYNTVN	johnston
JYNYK	junk
JYNZ	jimenez
JYPH	joesph
JYRARDYN	jayawardene
JYRMASKA	germuska
JYRVSK	jirousek
JYSH	josh
JYS	joys
JYSR	jesper
JYSTR	jester
JYSVZ	josie
JYTA	jitta
JYVK	jiok
JYVRDANV	jordan
JYVVANY	jovian
JYVVYL	jewel
JYVYL	jewel
JYZAN	jizan
JYZN	jizan
JYZSBRTVS	gijsbertus
JZYRH	jezire
KAB	kalb
KABRYLV	gabriele
KACLYNG	kuchling
KACV	katowice
KACVN	kayvon
KACY	katowice
KACYH	kaveh
KADLASK	kailas
KADMN	kaden
KADMVS	kalemis
KADN	kaden
KADRYBYSYK	kadribasic
KADRYKYS	kudreikis
KADV	kado
KADYN	kaden
KAFRY	afro
KAFY	kaifeng
KAFYN	kaifeng
KAGBVRN	pangborn
KAGL	kagle
KAGL	kagle
KAGLYN	katelyn
KAGSAL	kasai
KAGSVL	kagle
KAHAN	kahane
KAHVN	kahane
KAKALK	koukalik
KAKANDS	oaklands
KA	kai
KAKBRYD	cakebread
KAKDKAR	kakodkar
KAKRAFT	kraft
KAKRYL	karol
KAKSHD	kitakyushu
KAKTVS	kuwaitis
KAKY	kaki
KAKYVLA	aquila
KAKYVR	kakure
KALA	kalia
KALAFATAS	kalafatas
KALAFVT	kalafut
KALAHAN	kalahari
KALANAN	kalpana
KALATVR	kalathur
KALBAVT	kalafut
KALB	kalb
KALB	kalb
KALBRYJ	alberio
KALBYDA	kulbida
KAL	kale
KALDL	kaldis
KALDVL	kuldell
KALDVL	kuldell
KALDYS	kaldis
KALHYN	kielhorn
KALHYNH	kielhorn
KAL	kale
KALKAN	kalkan
KALKLASVR	alkabeer
KALMAN	kalman
KALMN	kalman
KALMN	kalman
KALMYS	kalemis
KALPAK	kalpak
KALPANA	kalpana
KALPS	kalpesh
KALPYN	kalpana
KALR	kale
KALRTY	karty
KALRY	kilroy
KALSGH	kalish
KALSVN	kalsow
KALSYN	kalsow
KALT	kalt
KALTVN	walton
KALV	kalev
KALVM	kalemis
KALVNLV	kalle
KALVRT	iqaluit
KALVYN	kalyan
KALYA	kalia
KALYAN	kalyan
KALYANY	kalliany
KALYARV	kalahari
KALY	kale
KALYGY	kalgoorlie
KALYLA	kalila
KALYNSAN	waldensian
KALYNT	iqaluit
KALYNZ	alonzo
KALYS	kalis
KALYS	kalis
KALYSYAK	kalisiak
KALYYVS	kalemis
KAMACV	kama
KAMALA	kamala
KAMAL	kamal
KAMAMA	kamehameha
KAMAR	qamar
KAMAT	kamath
KAMB	kamb
KAMBS	kamb
KAMBYTZ	korambath
KAMBYY	kamb
KAMBZ	kamb
KAMDAR	kamdar
KAMHVLZ	kamholz
KAM	kam
KAM	kam
KAML	kamel
KAMLN	kamelen
KAMLYS	kamlish
KAMN	kamen
KAMNS	kamens
KAMPAGNA	campagna
KAMPAR	kamper
KAMPBL	kampala
KAMP	kampe
KAMPR	kamper
KAMPTVN	hampton
KAMPVS	kamphuis
KAMPYLV	kampala
KAMPYVTR	kamper
KAMR	kamper
KAMRVD	kamerud
KAMRVN	kamien
KAMRVS	kramers
KAMSKAYA	kamskaya
KAMSTAK	kalisiak
KAMYA	kamiya
KAMYNG	kamenev
KAMYN	kamen
KAMYV	kamenev
KANAKAKVRN	kanakakorn
KANA	kana
KANAK	kanak
KANAL	kanal
KANAL	kanal
KANAN	kannan
KANAVA	kanaka
KANBVY	quinby
KAN	kan
KANDAYV	kanda
KANDLY	kandell
KANDV	kandi
KANDVYYT	vandivort
KANDY	kandi
KANFR	kanpur
KANFYLD	canfield
KANG	kang
KANG	kang
KANG	kang
KAN	kan
KANKNT	keanini
KANLN	keanini
KANLY	kanal
KANLY	kanal
KANN	keanini
KANR	kanpur
KANRLY	kinnersley
KANRVY	kazunori
KANSL	kans
KANSTABARYS	constabaris
KANSTABV	konestabo
KANTARA	cantara
KANTH	kant
KANT	kant
KANT	kant
KANTRA	kantian
KANTR	kanter
KANTRL	kantola
KANV	kane
KANVRY	kazunori
KANYA	kania
KANYF	kandolf
KANYG	kang
KANYNGHAM	cunningham
KANYS	kanes
KANYSNA	karenina
KANYTZ	yanowitz
KANYVN	keanini
KANZY	kanze
KAPA	kappa
KAPANGA	kapanga
KAP	kapp
KAPK	kalpak
KAPLAN	kaplan
KAPLN	kaplan
KAPLYNK	kaplenk
KAPNR	kapner
KAPRAL	kapral
KAPS	kaposi
KAPSVN	kapson
KAPVR	kapoor
KAPYLA	kapila
KARABVLVT	karabulut
KARAGR	kariger
KARAHR	karachi
KARA	kara
KARANJLV	karayel
KARAN	karan
KARARA	karaca
KARASA	karasu
KARAS	karas
KARASKV	karasu
KARASV	karasu
KARAYL	karayel
KARBAJAL	carbajal
KARBALA	karbala
KARBN	karen
KARBVNLY	carbonelli
KARBVNYA	karenina
KAR	kar
KARDAL	kardal
KARDL	kardel
KARDL	kardel
KARDLYS	kardelis
KARDNAS	karinas
KARDYNALY	cardinali
KARGYL	argyle
KARHART	earhart
KARKARN	kevorkian
KARKAS	karakash
KARLAYL	karayel
KARL	karl
KARL	karl
KARLKVYST	karlquist
KARLS	karls
KARLSVN	karlsson
KARLTVN	carlton
KARLTVN	carlton
KARLVS	karls
KARLVT	karlquist
KARLYN	karlsson
KARLYN	karlsson
KARMAN	karmann
KARMVDY	quasimodo
KARMVNA	karenina
KARMYCAYL	carmichael
KARN	karn
KARN	karn
KARNLYAN	carnelian
KARNR	karner
KARNRY	karner
KARNYA	karenina
KARNY	karn
KARNY	karn
KARNZ	karn
KARP	karp
KARPLAS	karplus
KARPNTR	carpenter
KARPNTYR	carpenter
KARSTNSN	carstensen
KARSTNZ	kerstin
KARSVN	karlsson
KARSVN	karlsson
KART	karty
KARTNR	karner
KARTRAYT	kortright
KARTR	karty
KARTVYZ	quartzite
KARTY	karty
KARTYK	kartik
KARTYR	karty
KARTYS	kmarts
KARVLYN	karvinen
KARVR	karner
KARVSV	karis
KARVSV	karis
KARVYN	karwin
KARYAGA	kirinyaga
KARY	kari
KARY	kari
KARYDA	karida
KARYDYAN	karridian
KARYH	karish
KARYJR	kariger
KARY	kari
KARYLV	karol
KARYRA	karras
KARYS	karis
KASAK	kalisiak
KASAMA	kasama
KASAM	kasama
KASANVVA	casanova
KASARA	kasahara
KASAT	kasat
KASGRVH	kasterchem
KASL	kislo
KASLMN	kalman
KASM	qasim
KASMN	kasun
KASMYCY	kosmicki
KASNR	kastner
KASNYR	kastner
KASPRZAK	kasprzak
KASRTYNV	casertino
KASRYL	karol
KASTA	kosta
KASTANV	kastein
KASTLV	kaitlin
KASTLV	kaitlin
KASTNR	kastner
KASTNR	kastner
KASTRCM	kasterchem
KASTRGYN	castergine
KASTR	kasturi
KASTRV	kasturi
KASTRYKAM	kasterchem
KASTRYKVM	kasterchem
KASTRYVM	kasterchem
KASTVL	kastein
KASTVRY	kasturi
KASTY	kasaty
KASTYLV	kastein
KASTYN	kastein
KASVF	kasouf
KASVN	kasun
KASY	kasey
KASYNG	kaohsiung
KASYNLY	kasun
KASYNSKY	kosinski
KASYV	kasey
KATA	katta
KATALANV	catalano
KATAN	kattan
KATARYN	katharine
KATB	kateb
KATBRT	kateri
KATCY	katowice
KATKART	katiyar
KATL	kathol
KATL	kathol
KATLMN	katleman
KATLR	kateri
KATLYR	katiyar
KATN	katen
KATR	kateri
KATRNTJ	katryntje
KATRYJ	katryntje
KATRYJN	katrin
KATRY	kateri
KATRYNA	katrina
KATRYNA	katrina
KATRYN	katrin
KATRYN	katrin
KATRYN	katrin
KATRYN	katrin
KATRYN	katrin
KATRYNTH	katryntje
KATRYNTJH	katryntje
KATRYNTJ	katryntje
KATRYNTY	katryntje
KATVALA	katwala
KATVPYS	katopis
KATY	katy
KATYNG	keating
KATZ	katz
KAVASYN	cavasin
KAVAYY	kauai
KAV	kave
KAV	kave
KAVDLYNG	quodling
KAVDYL	kardel
KAVH	kaveh
KAVH	kaveh
KAV	kave
KAVLY	quayle
KAVLY	quayle
KAVLYNG	aveling
KAVN	keaven
KAVRZ	kakure
KAVS	kaos
KAVSTN	kastein
KAVYTA	kavita
KAYA	kaya
KAYAK	kayak
KAY	kay
KAYK	kauk
KAYLAS	kaylas
KAYL	quayle
KAYN	kain
KAYN	kain
KAYNY	kain
KAYPR	kapoor
KAYRAS	karas
KAYRD	kamerud
KAYRVF	kairoff
KAYSR	kayser
KAYT	kuwayt
KAYT	kuwayt
KAZDAN	kazdan
KAZGRYF	kairoff
KAZMAYR	kazmaier
KAZVHYRV	kazuhiro
KAZVNVZY	kazunori
KAZY	kazi
KAZYR	kazuhiro
KAZYRR	kazuhiro
KBAKYAN	kabakian
KBAKYBV	kabakibo
KBANYS	kianos
KBRG	ekberg
KBR	keber
KBYR	keber
KBYR	keber
KCNG	kecheng
KDAVR	kedar
KD	kid
KDL	kiddle
KDL	kiddle
KDR	kedar
KDYM	keim
KDYN	kaden
KDYRA	qadira
KDYR	kinder
KDYSYA	qadisiyah
KDYSYH	qadisiyah
KFART	fiarito
KHV	kehoe
KK	kok
KLABVRN	claborn
KLAF	olaf
KLAG	klug
KLAG	klug
KLAGSTVN	langston
KLAK	kalpak
KLAMN	oklahoman
KLAMR	klammer
KLANFYLD	clanfield
KLANSY	klans
KLANTVN	quainton
KLARJH	klaartje
KLARK	kovarski
KLARK	kovarski
KLAR	kelkar
KLARTAY	klaartje
KLARTH	klaartje
KLARTJH	klaartje
KLARTJ	klaartje
KLARTJY	klaartje
KLART	klaartje
KLARTY	klaartje
KLARYJ	klaartje
KLASA	kolasa
KLASJ	klaus
KLASJH	kulesh
KLASMYR	klausmeier
KLASN	klassen
KLASNR	klausner
KLAT	klatt
KLATZ	klotz
KLAVDYA	kilauea
KLAVDY	vlado
KLAVSY	klaus
KLAVYTR	klawiter
KLAYN	klan
KLAYN	klan
KLAYR	klawiter
KLAYSJ	klaus
KLAYSVN	klassen
KLAYSVN	klassen
KLAYTVN	keaton
KLAZ	klazura
KLAZVRA	klazura
KLAZYNG	keating
KLBAY	kilbane
KLB	kalb
KLBRN	wilburn
KLBVRN	wilburn
KLBVRN	wilburn
KLBY	kilby
KL	keil
KLDNY	kolodny
KLDVL	kuldell
KLDVY	kolodney
KLFLT	colfelt
KLKAR	kelkar
KL	keil
KL	keil
KLMANZ	kalman
KLMBV	colombo
KLMN	kalman
KLMP	klemp
KLNFYLD	linfield
KLN	klein
KLN	klein
KLNR	kellner
KLRTAY	komorita
KLRTY	kilroy
KLRVS	kilroys
KLT	klute
KLTN	keltner
KLTNR	keltner
KLVB	kaleb
KLVBK	kloubek
KLVKYNAS	kloukinas
KLVLY	kelly
KLVMPNR	clumpner
KLVNFRV	clonfero
KLVSN	kelvin
KLVTH	keith
KLVYNN	kelvinen
KLYBR	klyber
KLYBRN	klyber
KLY	kiely
KLY	kiely
KLYF	eklof
KLYFRD	elford
KLYFT	kalafut
KLYFTVN	clifton
KLYK	kloubek
KLY	kiely
KLY	kiely
KLYLA	kalila
KLYMR	klemmer
KLYMVF	kelimoff
KLYNGRVT	klingler
KLYNK	klinck
KLYN	klein
KLYN	klein
KLYNSVRG	kleinsorge
KLYNZ	kline
KLYR	keeler
KLYR	keeler
KLYR	keeler
KLYR	keeler
KLYRTYH	keerthi
KLYS	equuleus
KLYSH	kulesh
KLYTVN	skelton
KLYVY	klee
KMA	koma
KMAL	kamal
KMAL	kamal
KMBRY	kimberey
KMBS	kimes
KMBZ	kimberey
KMDR	kamdar
KMFVYS	koufaxs
KMFYLD	wakefield
KM	kim
KMKR	kemker
KMLLV	kelli
KMPASTR	kempster
KMPBL	keeble
KMP	kemp
KMP	kemp
KMPR	kemper
KMPSTR	kempster
KMPVS	kempis
KMPY	kempe
KMR	kumoro
KMR	kumoro
KMR	kumoro
KMRVN	kemerovo
KMSPTR	kempster
KMSTR	kempster
KMYLAH	kamilah
KMYLA	kamilah
KMYLH	kamilah
KMYR	kumoro
KNAMVRY	kanamori
KNAVAY	kennaway
KNDAL	kendal
KNDL	kendal
KNDRYK	kendrick
KNDV	kendi
KNDVLF	kandolf
KNDY	kendi
KNDYG	kendig
KNDY	kendi
KNG	keng
KNG	keng
KN	ken
KN	ken
KN	ken
KNNYNG	kenning
KNPVL	knispel
KNRAD	konrad
KNRAD	konrad
KNRAD	konrad
KNRADVS	konrads
KNRAT	kiribati
KNRDYNG	konerding
KNR	kenner
KNSYNGTV	kensingto
KNTA	kenta
KNTARV	kentaro
KNVB	knob
KNVFYNKH	knufinke
KNVL	knievel
KNY	keny
KNY	keny
KNYKRBKR	knickerbocker
KNYNGTVN	kennington
KNYN	kenyon
KNYSKY	kensiski
KNYVN	kenyon
KNYVN	kenyon
KNZ	kenz
KPJH	kapje
KPL	kepler
KPLY	kepley
KPR	koper
KPRT	kiepert
KPTAN	kapetan
KPYSTRAN	kusterman
KRAB	krab
KRA	kiera
KRACLY	oracle
KRACLY	oracle
KRACN	ukraine
KRACR	kramer
KRAKART	krakatoa
KRAKFRD	crawford
KRAKFVRD	crawford
KRAK	krakow
KRAK	krakow
KRAKT	krakatoa
KRAMARY	kramer
KRAMHVRN	crumhorn
KRAMR	kramer
KRANDLMYR	crandlemire
KRANSVYK	cranswick
KRANSVYYK	cranswick
KRANZVYK	yanzek
KRAP	kraig
KRAPR	kramer
KRAQTVN	keaton
KRARAS	karas
KRASBY	krasnow
KRAS	kieras
KRASN	krasen
KRASYK	krasnow
KRATR	kratzer
KRATRZ	kratzer
KRATYGR	krattiger
KRATZR	kratzer
KRAVFVRD	crawford
KRAVL	karayel
KRAVLY	karayel
KRAVN	ukraine
KRAVN	ukraine
KRAVSVN	krasen
KRAY	kraig
KRAYDR	krasnodar
KRAYG	kraig
KRAYG	kraig
KRAYJ	kraaij
KRAYJ	kraaij
KRAY	kraig
KRAYSVL	karayel
KRAZN	ukraine
KRAZYR	kratzer
KRBLA	karbala
KRBL	kerbel
KRBSR	krebser
KRBTRY	kebire
KRBVNYL	kerbel
KRBYT	kiribati
KRC	kroc
KRDAL	kardal
KRDLA	kerila
KRDL	kardel
KRDRY	cordrey
KRFT	kraft
KRFTVN	kresten
KRG	krug
KRG	krug
KRGR	kerger
KRGR	kerger
KRHANG	kerhong
KRH	krech
KR	kr
KRK	kirk
KRKRAFT	kraft
KRKRAFT	kraft
KRLY	kirlew
KRLYVS	krelius
KRMR	kromer
KRMYK	krok
KRMYT	kermit
KRNAY	karina
KRNFRD	kingsford
KRN	kern
KRN	kern
KRN	kern
KRNL	kornele
KRNLYS	kringles
KRNLYVS	krelius
KRNS	kerns
KRNSVYK	kerensky
KRNVL	kornele
KRNYZ	krenz
KRNZ	krenz
KRPS	kips
KRRAY	kerrie
KRS	krs
KRS	krs
KRS	krs
KRSKYNTYH	erskine
KRSLYK	kerslake
KRSN	kursun
KRSNR	krasner
KRSNR	krasner
KRSNV	krasnow
KRSPV	kropik
KRST	kristi
KRSTN	kerstin
KRSTS	kristis
KRT	kert
KRTLND	cortland
KRTR	kretzer
KRTYN	kerstin
KRTZR	kretzer
KRVASH	kresh
KRVASZ	koreas
KRVB	krob
KRVCFVRD	rockford
KRV	kirov
KRVD	kerwood
KRVG	krug
KRVKFVRD	rockford
KRVK	krok
KRVKN	kerien
KRVL	kurile
KRVM	kroum
KRVM	kroum
KRVMH	nkrumah
KRVM	kroum
KRVM	kroum
KRVMN	kriman
KRVMR	kromer
KRVMY	kromer
KRVMYTS	keromitis
KRVNHYM	cronheim
KRVNY	keren
KRVNZ	krenz
KRVPYK	kropik
KRVSBY	kristie
KRVSCN	kruschen
KRVS	kris
KRVSH	kresh
KRVSN	kresna
KRVSN	kresna
KRVTYV	kristie
KRVVD	kerwood
KRVYL	krezel
KRVYN	kerien
KRVYR	kreuer
KRVZ	krenz
KRVZYR	kretzer
KRY	kory
KRYCFYLD	critchfield
KRY	kory
KRYDA	karida
KRYDR	kreuer
KRYGAN	kerrigan
KRYG	krug
KRYG	krug
KRYGR	kriger
KRYGR	kriger
KRY	kory
KRYK	krok
KRY	kory
KRY	kory
KRYLA	kerila
KRYLAS	karlas
KRYL	kurile
KRYLYZ	krelius
KRYM	kroum
KRYMN	kriman
KRYN	keren
KRYN	keren
KRYN	keren
KRYNZ	krenz
KRYPYV	kropik
KRYQR	kreuer
KRYR	kreuer
KRYSAN	krishan
KRYSAYNTAY	kurosawa
KRYS	korys
KRYSC	krasic
KRYS	korys
KRYS	korys
KRYSH	kresh
KRYSJH	krisje
KRYS	korys
KRYS	korys
KRYSP	korys
KRYSPN	kresten
KRYSPYJN	krisoijn
KRYSPYN	krisoijn
KRYSSAYNTYH	kissane
KRYSTA	krista
KRYSTA	krista
KRYSTAL	krystal
KRYSTAL	krystal
KRYSTAL	krystal
KRYST	kristi
KRYSTLR	kristler
KRYSTMN	kresten
KRYSTMN	kresten
KRYSTN	kresten
KRYSTR	krister
KRYSTV	kristi
KRYSTVF	kristie
KRYSTVFR	krister
KRYSTVFRSVN	kesterson
KRYSTVN	kresten
KRYSTVN	kresten
KRYSTYANA	kristian
KRYSTYAN	kristian
KRYSTYAN	kristian
KRYSTYANSN	christiansen
KRYSTY	kristy
KRYSTY	kristy
KRYSTYJNTH	kristijntje
KRYSTYJNTJH	kristijntje
KRYSTYJNTJ	kristijntje
KRYSTYNA	kristina
KRYSTYN	kresten
KRYSTYNH	kristine
KRYSTYN	kresten
KRYSTYN	kresten
KRYSTYN	kresten
KRYSTYNTY	kristijntje
KRYSVAYJN	krisoijn
KRYSVJYN	krisoijn
KRYSVYJN	krisoijn
KRYSVYN	krisoijn
KRYSVZN	krisoijn
KRYSY	krissy
KRYSY	krissy
KRYSY	krissy
KRYSZ	korys
KRYTR	kretzer
KRYVAS	koreas
KRYVASZ	koreas
KRYVN	kerien
KRYVSN	kresna
KRYVVNVZ	krenz
KRYYK	krok
KRZNA	karina
KSAVAN	kesavan
KSAV	keshav
KSAY	kushay
KS	ks
KSK	kesek
KSKYN	keskin
KSL	kislo
KSL	kislo
KSLN	quisling
KSLR	kessler
KST	quist
KSTLAK	kostelak
KSTL	kristol
KSTLVT	koestler
KSTNR	kastner
KSTRAP	kastrup
KSTR	kester
KSTRCM	kasterchem
KSTRSVN	kesterson
KSVAN	kesavan
KSVN	kasun
KSYDY	quasimodo
KSYM	qasim
KSYM	qasim
KTAN	ketan
KTARA	kotara
KTB	kateb
KTCAM	ketcham
KT	ket
KT	ket
KTLAR	kevlar
KTL	ketil
KTL	ketil
KTLT	kolte
KTLY	ketley
KTNZRV	kutuzov
KTSYMATYDS	catsimatides
KTVLA	ketola
KTVYN	kevyn
KTY	quito
KTY	quito
KTYL	ketil
KTZ	kutz
KVAAYNTN	quainton
KVAKNBAS	quackenboss
KVAKNBVS	quackenboss
KVA	kwa
KVAL	kowal
KVALSYK	kowalski
KVANBAY	kania
KVANG	kwang
KVANG	kwang
KVANG	kwang
KVAN	kean
KVANLAN	quinlan
KVANRAD	koenraad
KVANRAD	koenraad
KVANRADT	coenraedt
KVANRADVS	konrads
KVANRDT	earnhardt
KVANRYD	kamerud
KVANTVN	quainton
KVARSKY	kovarski
KVARTZYTH	quartzite
KVASMAN	klansman
KVAST	kwast
KVASYM	quasim
KVATRYN	katrin
KVAVRYNG	weaverling
KVAYLYSY	quayles
KVAYMAN	kaufman
KVAYNTANA	quintana
KVAYNTVN	quainton
KVAYT	kuwayt
KVBA	kouba
KVB	kibo
KVB	kibo
KVBLA	kubla
KVBN	kobben
KVBSA	kobsa
KVBV	kibo
KVBV	kibo
KVBYB	kobb
KVBYLAH	qubilah
KVBYLA	kubla
KVCAR	kuchar
KVC	koci
KVCRAN	keiran
KVCY	koci
KVCYH	koch
KVDAMAH	qudamah
KVDAMA	qudamah
KVDVGNV	codogno
KVDY	kidby
KVGANDA	konganda
KVGLAN	keelan
KVGLYN	keulen
KVGVMA	kogoma
KVHAN	khan
KVHN	kuhn
KVJH	keijo
KVJYAS	kiowas
KVKAL	kokal
KVKALYK	koukalik
KV	kiev
KVKBRN	cockburn
KVK	kok
KVKFYLD	wakefield
KVK	kok
KVKNBAS	kloukinas
KVKNJ	kokenge
KV	kiev
KVK	kok
KVKRYL	kurile
KVKSVN	cookson
KVKTAVAY	koktavy
KVKVNN	kokkonen
KVKVRK	keokuk
KVKYA	kikuma
KVLASA	kolasa
KVL	keil
KVL	keil
KVLKA	kelkar
KVLMN	kellman
KVLN	kolen
KVLN	kolen
KVLN	kolen
KVLNV	kline
KVLR	keeler
KVLSAR	kolesar
KVLS	equuleus
KVLSVN	wilson
KVLT	kolte
KVLTY	kelty
KVLVL	kelli
KVLYCALA	kolichala
KVLY	kiely
KVLY	kiely
KVLYHA	koliha
KVLYN	kolen
KVLYNG	kipling
KVLYNGVVD	livengood
KVLYNS	kleins
KVLYNZ	kline
KVLYR	keeler
KVLYS	equuleus
KVMAR	kumar
KVMARV	kumar
KVMBR	kimberey
KVMPTVN	compton
KVMR	kumoro
KVMR	kumoro
KVMVRV	kemerovo
KVMVRYTA	komorita
KVN	keven
KVNG	keng
KVNG	keng
KVNKA	kinkade
KVN	keven
KVN	keven
KVNRAD	konrad
KVNRAD	konrad
KVNRADVS	konrads
KVNRAT	konrad
KVNRAT	konrad
KVNRAYT	coenraedt
KVNRYAT	kiribati
KVNT	kent
KVNV	kini
KVNVPKA	konopka
KVNVR	kenner
KVNVVR	kohinoor
KVNYNG	koning
KVPJANZ	kanze
KVPJ	skopje
KVP	kip
KVPLN	kipling
KVPLND	kipling
KVPLS	keplers
KVPNZ	kenz
KVPR	koper
KVPR	koper
KVPS	kips
KVRADYNY	ukraine
KVRAM	kram
KVRAN	kevran
KVRAN	kevran
KVRAPATY	koorapaty
KVRBT	kiribati
KVRBYN	kerien
KVR	kor
KVRDAS	kordas
KVRDS	kordes
KVRDYK	kordes
KVRDZ	kordes
KVRKAM	kevorkian
KVRKVL	kurke
KVRL	kirlew
KVRLY	kirlew
KVRN	kern
KVRNLH	kornele
KVRNLVS	kringles
KVRNLYS	kringles
KVRNLYVS	krelius
KVRNLYVSN	corneliusen
KVRNLYZ	kornele
KVRNVAL	quirinal
KVRNYVL	kornele
KVRNZ	krenz
KVRP	korp
KVRSL	kerslake
KVRSLV	kerslake
KVRSN	kursun
KVRSTN	kerstin
KVRT	kert
KVRTH	keerthi
KVRTL	korte
KVRTLND	cortland
KVRTLNT	courtlandt
KVRTRAYT	kortright
KVRTZ	korte
KVRVNLA	kerila
KVRVYN	kerien
KVRYA	korea
KVRY	kory
KVRY	kory
KVRYDVR	kreuer
KVRYGAN	kerrigan
KVRY	kory
KVRY	kory
KVRYLA	kerila
KVRYL	kurile
KVRZAYN	korean
KVSADA	quesada
KVSAK	kusack
KVSAY	kushay
KVSH	kish
KVSJH	koosje
KVSJ	koosje
KVSKY	kousky
KVSKYMAKY	koskimaki
KVSLV	kislev
KVSMANS	coesmans
KVSMANZ	kinsman
KVSMAS	cosmas
KVSMNS	kosinski
KVSNKV	kosenko
KVSTA	kosta
KVSTA	kosta
KVSTANZA	costanza
KVST	quist
KVSTN	kosten
KVSTRMN	kusterman
KVSTYLV	kristol
KVSTYS	kostis
KVSVGH	kosuge
KVSYN	kosygin
KVSYRA	kiera
KVSZ	keesee
KVTA	kavita
KVTCAY	ketcham
KVT	ket
KVTCY	kentucky
KVTJANZ	ketan
KVTLA	kotla
KVTMAYR	kottmeier
KVTNY	keltner
KVTRVNYV	cotroneo
KVTY	quito
KVTZ	kutz
KVVAR	kovar
KVV	kiev
KVVS	kievs
KVYALSKY	kowalski
KVYALYK	kowalik
KVY	key
KVYCY	quincy
KVYK	kook
KVYKNBAS	kloukinas
KVYKNBVS	quackenboss
KVYL	keil
KVYL	keil
KVYL	keil
KVYLYN	keulen
KVYMN	kimon
KVYN	kevyn
KVYN	kevyn
KVYN	kevyn
KVYN	kevyn
KVYN	kevyn
KVYN	kevyn
KVYN	kevyn
KVYNRAD	koenraad
KVYNRAD	koenraad
KVYNRAD	koenraad
KVYNRAT	koenraad
KVYNRAYT	coenraedt
KVYNRDVS	konrads
KVYNRYDVS	konrads
KVYNRYT	weinert
KVYNTANA	quintana
KVYNTN	quentin
KVYNT	quint
KVYNTVN	quentin
KVYPR	kuyper
KVYRYN	keiron
KVYSMAN	kinsman
KVYST	quist
KVYT	keet
KVYT	keet
KVYYKL	quickle
KVYYLYN	keulen
KVYYMAN	keyuan
KVYYMN	kimon
KVYYNLN	quinlan
KVYYNTANAR	quintanar
KVYYNTVN	quentin
KVYY	kiev
KVYYST	quist
KVYYT	quixote
KVYYTZ	kewitz
KVYZMN	koizumi
KVZN	quezon
KVZV	kozo
KVZY	kozo
KVZY	kozo
KVZYN	quezon
KYALASA	kailasa
KYASVN	kasun
KYAT	keat
KYB	kibo
KYBH	kibo
KYBL	keeble
KYBL	keeble
KYBLR	kibler
KYBLR	kibler
KYBV	kibo
KYCN	kocian
KYCRV	kocourek
KYCYN	kocian
KYD	kid
KYD	kid
KYDL	kiddle
KYDRA	keidra
KYF	kief
KYF	kief
KYFR	keifer
KYFR	keifer
KYGAN	keegan
KYGYNZ	kosygin
KYHL	kohl
KYHV	kehoe
KYJV	keijo
KYKBRD	kebire
KYKBRYD	cakebread
KY	key
KY	key
KY	key
KY	key
KYK	kok
KYKVMA	kikuma
KYLAN	keelan
KYLBAY	kilbane
KYLBRV	killebrew
KYLBY	kilby
KYLBYN	kilbane
KYLG	kilg
KYLGVR	kilgore
KYLH	koliha
KYLHVRN	kielhorn
KYL	kyle
KYL	kyle
KYL	kyle
KYLPK	kilpe
KYLR	keeler
KYLR	keeler
KYLR	keeler
KYLRMT	killermet
KYLT	kolte
KYLY	kyle
KYLYVN	kowloon
KYLZ	kilzer
KYMBAL	kimball
KYMBRLY	kimberly
KYMBRY	kimberey
KYM	kim
KYM	kim
KYMPA	kimppa
KYMV	kemerovo
KYMVN	kimon
KYMVRA	kimura
KYMZ	akemi
KYNA	kina
KYNAN	keenan
KYNANN	keinanen
KYNARD	kinard
KYN	keyne
KYNCN	kinchen
KYNGASTVN	kingston
KYNGFAY	kingfai
KYNGRY	kingery
KYNGSFVRD	kingsford
KYNGSTVN	kingston
KYNGZTN	kingston
KYNH	keyne
KYN	keyne
KYN	keyne
KYN	keyne
KYN	keyne
KYN	keyne
KYN	keyne
KYN	keyne
KYN	keyne
KYNKNN	keinknen
KYNKYD	kinkade
KYNMN	kinman
KYNMN	kinman
KYNRSLY	kinnersley
KYNSLA	kinsella
KYNSL	kinsell
KYNSMN	kinsman
KYNSVN	kinson
KYNT	kent
KYNT	kent
KYNTL	kintel
KYNY	keny
KYNY	keny
KYNYNY	kenny
KYNYVN	kenyon
KYNZ	kenz
KYNZMAN	kinman
KYNZY	kenz
KYP	kip
KYP	kip
KYP	kip
KYPLYNG	kipling
KYPYNG	keeping
KYRA	kiera
KYRAN	koran
KYRAS	kieras
KYRBAY	kiribati
KYRBY	kirby
KYR	kor
KYRK	kirk
KYRTA	komorita
KYRTY	korte
KYRVN	keren
KYRYL	kurile
KYRYSY	korys
KYSA	kobsa
KYS	keyes
KYS	keyes
KYS	keyes
KYS	keyes
KYSLV	kislev
KYSNRVS	kishinevs
KYSR	keyser
KYSR	keyser
KYSTVFR	kester
KYSVN	keskin
KYSY	keesee
KYSYDY	quasimodo
KYSY	keesee
KYSYNJR	kushnir
KYSYN	kosygin
KYTAGVCY	kitaguchi
KYTAMVRA	kitamura
KYTC	kitch
KYTCN	kitchen
KYT	kyte
KYT	kyte
KYT	kyte
KYT	kyte
KYT	kyte
KYTL	ketil
KYTLY	ketley
KYTS	kyotos
KYTY	kyte
KYTYNG	keating
KYV	kiev
KYVCY	quincy
KYV	kiev
KYVK	kook
KYVKYVLYS	kukulies
KYVMR	kumoro
KYVNG	keong
KYVNG	keong
KYVNG	keong
KYVS	keyes
KYVSMATV	kusumoto
KYVYVALY	kivivalli
KYVZVN	quezon
KYZR	kizer
KZMNZ	kenz
'LAALDYN	alaaldin
LABAT	labatt
LABDN	labdon
LABDVN	labdon
LABKYN	lubkin
LABLA	labella
LABL	labelle
LAB	lamb
LABRAD	labroad
LABRYVLA	labriola
LABSR	labore
LABYN	labdon
LACLN	lachlan
LACNS	laocoons
LACYNY	laocoon
LADASKY	ladasky
LADR	lauder
LADRVT	laderoute
LADVN	labdon
LADVVYKA	hlavenka
LADVVYKVS	vladivostoks
LADVYG	ladwig
LADYK	ladak
'LADYN	aladdin
LADYVYL	ladeuil
LAFAM	layamon
LAFAVNTYN	lafountaine
LAFGRYN	lofgren
LAFVRKAD	lafourcade
LAFY	laffey
LAGRLYNG	lagerling
LAGRSTRVM	lagerstrom
LAGVMVRVF	lagomorph
LAGVN	lagoon
LAHLMA	lahelma
LAHYJ	lahij
LAJ	lahij
LAJRBRG	lagerberg
LAKAY	leakey
LAKH	laiho
LAKLH	lakesha
LAK	leake
LAK	leake
LAK	leake
LAK	leake
LAKR	lauri
LAKS	laakso
LAKSV	laakso
LAKSYN	lausin
'LAKVABAH	alaqabah
LAKVTVRH	lacouture
LAKVVD	lakewood
LAKY	laky
LAKY	laky
LAKYSA	lakesha
LALKYN	lulkin
LAL	lal
LALS	laurels
LALY	laly
LALYT	lalit
LAMARK	lamark
LAMASTVS	lamastus
LAMBARD	lombard
LAMBARDV	lombardi
LAMBDA	lambda
LAMBLY	lamboley
LAMBRN	lamborn
LAMBRT	lambert
LAMBRVS	lambros
LAMBVLY	lamboley
LAMBVRN	lamborn
LAMBVRN	lamborn
LAM	lam
LAM	lam
LAMPLAYT	lamplight
LAMPN	lampen
LAMPY	lampi
LAMPYT	lampitt
LAMRS	lamers
LAMVRS	lamers
LAMYKYN	lamykin
LANA	lana
LANDAGR	landauer
LANDASTRVM	lundstrom
LANDAYR	landauer
LANDBRG	lindberg
LANDGRN	lindgren
LANDGRYN	lindgren
LANDKVYYST	lundquist
LAND	land
LANDL	landahl
LAND	land
LANDMN	landman
LANDN	landen
LANDR	lander
LANDRS	landers
LANDRVM	landrum
LANDRY	landry
LANDRZ	laundrie
LANDYN	landen
LANDYN	landen
LANDYS	landis
LANGDVN	langdon
LANG	lang
LANG	lang
LANG	lang
LANGLY	langley
LANGNZ	langnes
LANGSA	langs
LANGSAV	longshaw
LANGSTVN	langston
LANGSV	langs
LANGV	lange
LANGYR	langmuir
LANJ	lane
LANKA	lanka
LANKART	lonkart
LANKSTAF	longstaff
LANKTVN	lankton
LAN	lan
LAN	lan
LAN	lan
LAN	lan
LANR	elanor
LANR	elanor
LANSDYL	lonsdale
LANSFRD	lunsford
LANS	lanes
LANSTZ	lantz
LANSYNG	lansing
LANTA	lanetta
LANT	lantz
LANTLVSAMAD	lantlosamade
LANTRMAN	lanterman
LANTZ	lantz
LANTZ	lantz
LANVM	lannom
LANVSY	lanes
LANY	lane
LANY	lane
LANZ	lanz
LAPASV	lapaso
LAP	lap
LAPLAYN	laplaine
LAP	lap
LAPVRD	laird
LAPVRS	clapeyrons
LAPVRT	laporta
LAPVTA	laputa
LAPVVRS	clapeyrons
LAPYDARY	lapidary
LAPYSKV	laske
LARA	lara
LARALY	laralee
LARDYNGA	flardinga
LARJA	lauverjat
LARJ	learjet
LARN	lauren
LARNS	laurens
LARNS	laurens
LARSN	larsen
LARSN	larsen
LARSVN	larsen
LARTR	larter
LARVC	alaric
LARVKVYH	larocque
LARV	laro
LARVRL	larurel
LARYF	lareef
LARYSA	larissa
LARYVYR	lariviere
LARZ	laro
LASKALA	lascala
LASKA	laska
LASKARY	lascari
LASK	laske
LASKVS	laskos
LAS	las
LAS	las
LAS	las
LASNYK	lasnik
LAST	last
LASTRA	lastra
LASTR	lastra
LASTRY	lastra
LASTYNG	plastino
LASVN	lausin
LASYNGR	losinger
LATALA	latala
LATA	latta
LATAM	latham
LATBRY	lathbury
LATBVRY	lathbury
LATKYNZ	slatkin
LAT	flat
LATZ	blatz
LAVANDH	lawande
LAVAYN	layamon
LAVD	laud
LAV	olav
LAV	olav
LAVLS	laurels
LAVMN	layamon
LAVNKA	hlavenka
LAVNYVS	lavonius
LAVRAY	laura
LAVRNS	laverns
LAVSTAD	lovstad
LAVTN	lawton
LAVTVN	lawton
LAVYGNH	lavigne
LAVYN	hlavin
LAVYT	louvet
LAVZAK	lauzac
LAYAN	layamon
LAYBS	playboys
LAYBZ	playboy
LAYDVYNA	ladonna
LAYDYA	claudia
'LAYDYN	aladdin
LAYHV	laiho
LAYKZ	leake
LAY	elway
LAYL	layla
LAY	elway
LAYMAK	lamark
LAYMB	lamb
LAYND	land
LAYNG	laing
LAYN	laine
LAYN	laine
LAYRD	laird
LAYTBRN	eastburn
LAYTMN	lawton
LAYTNYNG	lightning
LAYV	laue
LAYV	laue
LAYV	laue
LAYVLY	laly
LAYVRYTSN	lauritsen
LAYVSAY	livesay
LAYVVY	lavey
LAYVY	lavey
'LAYYN	alain
LAZARA	lazara
LAZARD	lazard
LAZARV	lazaro
LBANRD	libannord
LBANVRD	libannord
LBDAN	libyan
LBDVN	labdon
LBN	leben
LBRYNYDYS	labrinidis
LBVN	leben
LBVR	welber
LBVRT	elbert
LCLH	lucile
LCMN	alcmena
LCMR	alcmere
LCNR	lechner
LDFVRD	ledford
LDJ	lodewijk
LDK	lodewijk
LDVAYDJ	olduvai
LDVYK	lodewijk
LF	elf
LFLR	leffler
LFTVS	loftus
LG	leg
LHAN	lehan
LHLH	lehle
LHMAN	lehman
LHMAN	lehman
LHMN	lehman
LHMN	lehman
LHNRR	lehnerer
LHRNTZ	lohrentz
LHRYAN	lehrian
LHYJ	lahij
LHY	leahy
LJ	elsje
LKAMBR	lambert
LKRN	wilkerson
LKRVS	loris
LKS	likes
LKSN	wilkerson
LKVST	elmquist
LKY	elke
LMBRN	lamborn
LMBRN	lamborn
LMBRT	lambert
LMBVRNH	lambourne
LMBVRN	lamborn
LMBVRN	lamborn
LMBVVRN	lambourne
LM	lim
LMP	lamp
LMPYNG	lamping
LMRZ	elmore
LMVN	ilmin
LMYR	elmer
LNDAHL	landahl
LNDAVR	landauer
LND	lind
LNDRY	londre
LNDRZ	londre
LNDVAY	lendvai
LNDY	lindy
LNDYN	linden
LNDYNV	lendino
LNDZ	melendez
LNGLY	lingley
LNGLYNG	lengeling
LNGMYD	langmaid
LNGMYD	langmaid
LNGSS	lingus
LNGSTN	langston
LNGSTVN	langston
LNKY	lenkei
LNLVSAMAD	lantlosamade
LNLVZAMYD	lantlosamade
LNNDN	lennon
LNRT	lehnert
LNS	lens
LNSVN	lanson
LNTLVSAMAD	lantlosamade
LNTLVSAMYD	lantlosamade
LNTYN	lenten
LPARD	lepard
LPART	leppart
LPLA	leppla
LP	ilpo
LPVRS	louvres
LPVRTA	laporta
LPVVRS	louvres
LRAP	lerup
LRBZ	lorenz
LRD	lord
LRMN	lerman
LSARD	lessard
LSLY	lesley
LSR	loser
LSR	loser
LST	list
LSYAK	lesiak
LTBRY	politburo
LTJY	letje
LTRYJ	latrobe
LTV	leto
LVALAY	lavalie
LVATS	loats
LVAYNGH	laing
LVAYNJ	laine
LVAYN	livian
LVBV	lobo
LVBVTYN	louboutin
LVBYN	leben
LVC	loc
LVDMN	lodman
LVDVRF	ludorf
LVDVVYKA	ludovica
LVDVVYKAS	olduvais
LVDVYJK	lodewijk
LVDVYKA	ludovica
LVDVYKAS	lidias
LVDVYK	lodewijk
LVDVYKS	ludovicus
LVDVYKVS	klondikes
LVDVYSVS	levesques
LVFARV	lofaro
LVFASV	lofaso
LVFBARV	lofaro
LVFR	loafer
LVFSTRVM	lofstrom
LVGH	leigh
LVGNDRA	logendra
LVGZ	lego
LVJYK	seljuk
LVKA	lukka
LVKARD	lockard
LVKAS	molokais
LVK	lok
LVK	lok
LVK	lok
LVK	lok
LVK	lok
LVK	lok
LVKN	loken
LVKS	likes
LVKSTVN	liston
LVKV	loke
LV	levi
LV	levi
LV	levi
LVMAS	limas
LVMBARDV	lombardi
LVML	lemuel
LVM	lim
LVMN	lemon
LVNAN	slovenian
LVNAV	lunau
LVNDAN	lindman
LVND	lind
LVNDVN	linden
LVNJ	levine
LVN	elvin
LVN	elvin
LVNLY	lonely
LVNMV	linimon
LVNYG	long
LVNY	loney
LVNY	loney
LVNY	loney
LVNYNGDAL	lonningdal
LVNZ	lunz
LVNZ	lunz
LVPATKYN	lupatkin
LVP	loop
LVPR	luper
LVPRSTY	lopresti
LVPYN	lupien
LVPZ	lopez
LVRA	elvira
LVRA	elvira
LVRC	lyric
LVRD	lord
LVRJYV	leroux
LVRNA	lorna
LVRN	liren
LVRNS	lorenes
LVRNT	laurent
LVRNTZN	lorentzen
LVRNZ	lorenz
LVRNZN	lorenzen
LVRNZV	lorenzi
LVRNZY	lorenzi
LVRTVN	lorton
LVRTY	lorteye
LVRY	lory
LVRY	lory
LVRY	lory
LVRY	lory
LVRY	lory
LVSANTVS	losantos
LVS	luvs
LVS	luvs
LVSMVR	loosmore
LVSRV	leviseur
LVSSKV	levesque
LVST	list
LVSTR	lester
LVSTY	lusty
LVSYH	lesotho
LVSY	levesque
LVSY	levesque
LVSY	levesque
LVSYTV	losito
LVTBG	luttbeg
LVTMPYV	lotempio
LVTR	lester
LVTYNZ	luxton
LVTZ	lutz
LVVRA	elvira
LVVRJAT	lauverjat
LVVT	louvet
'LVY	eloy
'LVY	eloy
LVYD	loyd
LVY	levy
LVY	levy
LVYNDN	lewendon
LVYNG	luinge
LVYN	elwyn
LVYN	elwyn
LVYNSVN	levinson
LVYS	levys
LVYSYLY	loiselle
LVYSYVR	leviseur
LVYYNGH	luinge
LVYYNG	luinge
LVYYSALY	livesay
LVYYZV	loizzo
LVYZ	liz
LVZANV	lozano
LVZYR	lozier
'LYA	alya
'LY	ely
'LYA	alya
'LYA	alya
'LYA	alya
LYA	elya
'LY	ely
'LY	ely
LYAM	liam
LYANG	loyang
LYANZ	lianez
LYAV	liao
LYBANNRD	libannord
LYBANVRD	libannord
LYBCN	liebchen
LYBL	lebel
LYBLYT	liblit
LYBMN	liebman
LYBRCAK	liberchuk
LYBRG	limburg
LYBRN	leybourne
LYBRTY	liberty
LYBRYK	librik
LYBSKAMB	luscombe
LYBSN	liebson
LYBVRN	leybourne
LYBVYTZ	leibowitz
LYBYD	lebed
LYBY	lobo
LYCARSVN	licharson
LYCFYLD	litchfield
LYC	loc
LYCMR	lechmere
LYCTN	lection
LYCVRVYYS	lucretius
LYDAL	lidal
LYDA	lydea
LYD	loyd
LYDMAN	lodman
LYDN	leyden
LYDN	leyden
LYDRAK	aludra
LYDRDRAP	leiderdorp
LYDRDRP	leiderdorp
LYDRDRVP	leiderdorp
LYDRDVRP	leiderdorp
LYDR	lidor
LYDVR	lidor
LYDVYNA	lidwina
LYDYA	lydea
LYDYA	lydea
LYFAYV	lefaive
LYGYV	lego
LYHY	leahy
LYK	lok
LYKYVRY	liquori
LYLA	loyola
LYLA	loyola
LYLA	loyola
LY	ely
LYLBK	lilback
LY	ely
LY	ely
LY	ely
LY	ely
LY	ely
LYLY	lyly
LYLY	lyly
LYLYND	leelynde
LYLYNTAL	lilienthal
'LYMA	alima
'LYM	alim
'LYMA	alima
LYMBAX	colombia
LYMBVRG	limburg
LYM	lyme
LYMN	lymn
LYMR	lemer
LYMYNG	liming
'LYN	alwyn
LYNAN	linehan
LYNARS	linares
LYNDAL	lindal
LYNDAN	lindman
LYNDBK	lindback
LYNDBRG	lindberg
LYNDGARD	lindgard
LYNDGRN	lindgren
LYNDHLM	lindholm
LYND	lind
LYND	lind
LYNDL	lyndel
LYNDL	lyndel
LYNDMN	lindman
LYNDMN	lindman
LYNDN	lyndon
LYNDNMVT	lindenmuth
LYNDR	linder
LYNDRMN	linderman
LYNDRVTS	lindroth
LYNDSY	lindsey
LYNDVN	lyndon
LYNDZ	melendez
LYNDZY	melendez
LYNGAS	lingus
LYNGLY	lingley
LYNHAN	linehan
LYNH	lynch
LYNKH	lenkei
LYNK	link
LYNKLN	lincoln
LYNKVLN	lincoln
LYNKVYS	linkous
LYN	lyn
LYN	lyn
LYN	lyn
LYN	lyn
LYN	lyn
LYN	lyn
LYN	lyn
LYNSTRAT	linstruth
LYNVAL	lindvall
LYNVNN	leinonen
LYNVRA	lenora
LYPARD	lepard
LYPKYN	lipkin
LYPSKAMB	lipscomb
LYPSKMB	lipscomb
LYPSKM	lipscomb
LYPSKVMB	lipscomb
LYPSKVMP	lipscombe
LYPST	lipset
LYPYJ	lupe
LYR	iler
LYR	iler
LYRN	liren
LYRYKAL	lyrical
LYRYK	florek
LYSBTH	lysbethje
LYSBTJH	lysbethje
LYSBTJ	lysbethje
LYSBTJY	lysbethje
LYSKANV	elysian
LYSKMB	luscombe
LYSKN	lisken
LYSKY	liskey
LYS	eloys
LYSN	lison
LYSN	lison
LYSTR	lester
LYSTVN	liston
LYSVN	lison
LYSVN	lison
LYSY	elyse
LYSYN	lison
LYT	lot
LYTL	lytle
LYTLTVN	littleton
LYTLY	lytle
LYTMN	leyton
LYTN	leyton
LYTRL	litel
LYTV	leto
LYTVN	leyton
LYTVN	leyton
LYTVYN	litvin
LYVA	livia
LYVANDN	landen
LYVANDVN	landen
LYVAYN	livian
LYVBVNY	lyubovny
LYVH	leigh
LYV	lye
LYV	lye
LYV	lye
LYV	lye
LYV	lye
LYVNARD	leonard
LYVNARDV	leonardo
LYVNDVN	lewendon
LYVNGVD	livengood
LYVN	lyon
LYVNL	leonel
LYVNSBRY	lounsbery
LYVNVRA	leonora
LYVNZ	lorenz
LYVVH	liviu
LYVV	levi
LYVY	levy
LYVYNGSTVN	livingston
LYVYN	levine
LYVYN	levine
LYVYS	levys
LYVYV	liviu
LYVYVS	livius
LYVYVY	lieuwe
'LYYAH	aliyyah
LYYL	lyell
LYYVVH	lieuwe
LYZA	liza
LYZA	liza
LYZARD	lizard
LYZARDZ	lizard
LYZBTY	lizotte
LYZ	liz
LYZN	luzon
LYZR	lozier
LYZVT	lizotte
MABANAG	mabanag
MABAY	mirabeau
MABY	mawby
MAC	mac
MACTLD	machteld
MADABA	madaba
MADAKS	marduks
MADJ	madej
MADLYN	madelyn
MADLYN	madelyn
MADLYN	madelyn
MADN	madon
MADRVN	madrone
MADSN	madsen
MADVN	madon
MADVRAY	madurai
MADYGAN	madigan
MADY	mady
MADYS	madis
MADYSVN	madison
MADYV	madeo
MAFRY	mafraq
MAFYN	maxine
MAGAGNA	magagna
MAGARD	maggard
MAGDALYNTH	magdaleentje
MAGD	magda
MAGLYRV	magliaro
MAGR	mager
MAGRVDR	magruder
MAGS	magoos
MAGVAYR	magyar
MAGVYR	maguire
MAGYL	magill
MAHADVAN	mahadevan
MAHAJAN	mahajan
MAHALT	mahault
MAHALY	mahaly
MAHA	maha
MAHAVLT	mahault
MAHTV	mahto
MAHVLT	mahault
MAHVT	mahwit
MAJV	majee
MAJY	majee
MAJYV	majee
MAKARAYG	macaraeg
MAKAYVLY	mikael
MAKK	markku
MAKLAQLYN	maclaughlin
MAK	mak
MAK	mak
MAK	mak
MAKRYJ	marytje
MAKSVL	makil
MAKSY	maqsood
MAKSYM	maoism
MAKSYMYLYAN	maximilian
MAKV	maki
MAKVMBR	macomber
MAKVNVCY	mackinac
MAKVSY	markus
MAKY	maki
MAKYNVN	mackinnon
MAKYRAS	mackerras
MAKYSAK	marquesas
MAKZYM	mackenzie
MALAMVD	malamud
MALAN	malan
MALBRG	malberg
MALD	malde
MALDN	malde
MALKVK	waikiki
MALKVM	malemud
MALN	malini
MALNR	malnar
MALRVNY	mulroney
MALTYN	maltin
MALVN	malini
MALVNY	maloney
MALYGAN	malian
MALYK	mameluke
MAMA	mama
MAMFVRD	mumford
MAMN	maimone
MAMRT	mamet
MAMY	mame
MANAMA	manama
MANA	mana
MANA	mana
MANBR	manber
MANC	manca
MANDAL	mandal
MANDA	manda
MANDAR	mandar
MANDAVYL	mandaville
MANDL	mandl
MANDR	mandar
MANDY	mandy
MANGAN	mangan
MANGLANY	manglani
MANGR	manager
MANGYN	mangin
MANJYT	manjit
MANJYT	manjit
MANKA	maniskas
MANK	zemanek
MANKRT	munkert
MANKS	manxs
MANKVS	moniques
MANKY	meaney
MANLY	manley
MANMA	manama
MAN	man
MANRV	manoury
MANSN	manson
MANSTR	mansur
MANSYL	manuel
MANSYNGR	munsinger
MANTA	manetta
MANTL	mantle
MANTNZ	umanetz
MANTRAS	diamantaras
MANTVR	mantor
MANTYKS	mantles
MANTY	mantey
MANVLY	manoli
MANVLY	manoli
MANV	mane
MANV	mane
MANV	mane
MANV	mane
MANVRY	manoury
MANX	manx
MANYJA	manija
MANYKS	maniskas
MANY	many
MANY	many
MANYNG	manning
MANYSKAS	maniskas
MANYS	meanys
MANYT	manet
MANYV	meaney
MANZ	umanetz
MAPARTYDA	malpartida
MAPLZ	maple
MARALY	amaral
MARANY	marani
MARAT	marat
MARAZAS	marazas
MARBAC	marbach
MARBL	marble
MARC	marc
MARCYNDV	maricondo
MARDR	marder
MARDVC	amardeo
MARFY	marie
MARGALTA	margarita
MARGALYTY	margarietie
MARGANTH	marregante
MARGANT	marregante
MARGARTA	margarita
MARGARYTA	margarita
MARGARYTAY	margarita
MARGARYTJH	margarietje
MARGARYTJ	margarietje
MARGARYTJ	margarietje
MARGARYTJY	margarietje
MARGARYT	margaret
MARGARYT	margaret
MARGARYT	margaret
MARGARYTY	margarito
MARGLYN	margolin
MARGRTA	margarita
MARGRYJH	margrietje
MARGRYTA	margarita
MARGRYTH	margrethe
MARGRYTH	margrethe
MARGRYTJ	margrietje
MARGRYTJY	margrietje
MARGRYT	margret
MARGRYTYH	margrethe
MARGVLYN	margolin
MARGVLYS	margolis
MARGVLYVKS	margolis
MARJNT	maronite
MARKHAM	markham
MARKLY	markley
MARK	mark
MARK	mark
MARKS	marks
MARKSN	marksteiner
MARKSTYNR	marksteiner
MARKV	markov
MARKV	markov
MARKVM	markov
MARKVPVLY	marcopoli
MARKVS	markus
MARKVS	markus
MARKVS	markus
MARKVYT	markowitz
MARKVYZA	marqueza
MARKVZ	marquez
MARKYL	markiel
MARKY	markey
MARKYNGTVN	tarkington
MARKYYVS	marques
MARLA	marla
MARLAT	marlatt
MARL	marlowe
MARLY	marley
MARLYN	marilyn
MAR	mar
MARN	marin
MARPL	marple
MARRL	marylou
MARSAL	marsala
MARSLA	marsala
MARSL	marisol
MARSLV	marisol
MARSLYNV	marilyn
MARS	mars
MARS	mars
MARSTVN	marston
MARSY	mars
MARTL	martel
MARTLND	martland
MARTN	marten
MARTNTJY	martyntje
MARTYJN	martijn
MARTYJN	martijn
MARTYJNTJH	martijntje
MARTYJNTJY	martijntje
MARTY	marty
MARTY	marty
MARTYNH	martino
MARTYNJ	martyntje
MARTYNJ	martyntje
MARTYN	martyn
MARTYN	martyn
MARTYNSN	martinsen
MARTYNTH	martyntje
MARTYNTH	martyntje
MARTYNTJH	martyntje
MARTYNTJ	martyntje
MARTYNT	martyntje
MARTYNT	martyntje
MARTYNV	martino
MARTYNVS	martiniques
MARTYNZ	martinez
MARTYNZ	martinez
MARTYNZ	martinez
MARTYZN	martyn
MARTYZNTJ	martyntje
MARTZ	martz
MARVAHA	marwaha
MARVCY	maurice
MARV	marv
MARVN	marvin
MARVN	marvin
MARVNY	maroney
MARVYN	marvin
MARVYN	marvin
MARVYT	marvit
MARXAM	miriam
MARYA	maria
MARYANA	mariana
MARYAN	mauryan
MARYGANTH	marregante
MARYGANT	marregante
MARYH	marwah
MARYJH	marytje
MARYJH	marytje
MARYJKN	marijken
MARYJ	marytje
MARYJNT	martijntje
MARYKANDV	samarkand
MARYKN	marijken
MARYLYN	marilyn
MARY	mary
MARY	mary
MARYN	marin
MARYNV	marine
MARYSH	marsh
MARYS	marys
MARYSVN	marston
MARYTH	marathi
MARYTH	marathi
MARYTJ	marytje
MARYTJ	marytje
MARYTJY	marytje
MARYTJY	marytje
MARYT	marvit
MARYT	marvit
MARYV	marie
MARYVS	maries
MARYYANY	mariani
MARYZ	marquez
MARZK	marek
MARZ	marz
MASAHYRV	masahiro
MASARA	masaru
MASATAKA	masataka
MASATV	masato
MASAYV	masai
MASBRG	mossburg
MASKARY	masaru
MASKL	maskell
MASK	masek
MASKYAS	maniskas
MASLD	masefield
MASLLY	masselli
MASNA	masna
MASNA	masna
MASRMN	masserman
MASTN	masten
MASTYR	masters
MASVN	masin
MASYK	masek
MASY	mase
MASYMV	massimo
MASYN	masin
MATAKV	matako
MATA	mata
MATANA	matana
MATAR	matar
MATAY	mata
MATJKA	matejka
MATLV	mantle
MAT	mat
MATSVDA	matsuda
MATSVMVTV	matsumoto
MATSVN	matson
MATVLA	matula
MATV	amati
MATVR	mantor
MATVS	mathis
MATYNV	mautino
MATYS	martys
MATYS	martys
MATYV	mateen
MATYVS	matheis
MAVBAY	mirabeau
MAVBY	mawby
MAV	mae
MAV	mae
MAV	mae
MAVN	main
MAVPYN	maupin
MAVR	mair
MAVRS	mavers
MAVSR	mauser
MAX	max
MAYFYLD	mayfield
MAYKLYS	milwaukees
MAYKLZN	mikulin
MAYK	mawk
MAYKN	mayeen
MAYKVHN	mayeen
MAYKVK	waikiki
MAYLN	madeline
MAY	may
MAY	may
MAYMVN	maimone
MAYNDRT	meindert
MAYN	mayne
MAYN	mayne
MAYNR	masoner
MAYR	mayr
MAYR	mayr
MAYR	mayr
MAYR	mayr
MAYR	mayr
MAYRN	maureen
MAYRS	maoris
MAYRYK	marek
MAYRZ	marz
MAYSAL	marsala
MAYSA	maysan
MAYSL	marisol
MAYSTYK	mayston
MAYTAG	maytag
MAYTHAM	mathai
MAYT	mamet
MAYT	mamet
MAYTY	makoto
MAYVHAY	maohai
MAYV	mayo
MAYZ	maze
MAZRA	mazera
MBARK	mubarak
MCLD	euclid
MCTLD	machteld
MDABA	madaba
MDAVR	medawar
MDBA	madaba
MDH	madah
MDLYN	medlin
MDNYK	mednick
MDNYT	minot
MDRK	medrek
MDRR	maderer
MDS	mds
MDSN	madsen
MDSVN	madsen
MDVNA	medina
MDYNA	medina
MDYNH	madinah
MDYNH	madinah
MDYN	madon
MDYNNY	maddineni
MDYNT	madinat
MDYSVN	madison
MDYSVN	madison
MFRG	merginio
MFRK	merk
MFRVK	mafraq
MGDALNT	magdaleentje
MGDALYNTJ	magdaleentje
MGDALYYNTJH	magdaleentje
MGDA	magda
MGDAYNTJ	magdaleentje
MGLAGLYN	maclaughlin
MGLAT	aoglat
MGNAN	magnan
MGNASN	magnuson
MGNH	imogene
MGNY	imogene
MGR	meger
MGY	megyesi
MGY	megyesi
MGY	megyesi
MGYNL	maginel
MGYS	megyesi
MGYSY	megyesi
MGYV	megyesi
MHADVAN	mahadevan
MHAMA	muhamma
MHARAK	muharraq
MHL	mehl
MH	muh
MHMA	muhamma
MHRAH	mahrah
MHRA	mithra
MHRG	gehrig
MHRH	mahrah
MHRK	merk
MHRM	miriam
MHVYT	mahwit
MJDL	majdal
MJ	meiji
MJYA	mejia
MJYD	majid
MJYKAL	mikael
MJYK	meek
MKAH	mekkah
MKALYR	malur
MKA	mika
MKARDL	kardel
MKDALN	medan
MKDRMVT	kermit
MKDVLND	midland
MKDVNALD	mcdonald
MKDVNALD	mcdonald
MKDVYL	mendel
MKFARLND	mcfarland
MKFARLYN	marilyn
MKFRLYN	merlin
MKGAVYN	mcgavin
MKGRAT	mcgrath
MKGVVAN	mikoyan
MKGVYRK	mcguirk
MKGVYR	meger
MKGYRY	mignerey
MKH	muh
MKH	muh
MKHNRY	mchenry
MKKAH	mekkah
MKKAN	mikoyan
MKKARTY	moriarty
MKKARTY	moriarty
MKKAVN	mikoyan
MKKNA	mickna
MKKNY	dokkene
MKKNZY	mckenzie
MKKRKN	morken
MKLAGLYN	maclaughlin
MKLAQLYN	mellin
MKLARN	mclaren
MKLAVLYN	mellin
MKLAVLYN	mellin
MKLAVVGYNG	goolagong
MKLYN	mikulin
MKLYN	mikulin
MK	mok
MK	mok
MKMAHAN	mcmahan
MKMAHVN	mcmahon
MKMAHVN	mcmahon
MK	mok
MKMANYS	mikoyans
MKMVLN	mikulin
MKMYLAN	maximilian
MKNAT	minamoto
MKNYL	knel
MKNYL	knel
MKRA	mira
MKRAYH	mirach
MKRAY	moray
MKRDY	mockridge
MKRVN	mervin
MKRYS	emerys
MKSFYLD	masefield
MKSN	mickelson
MKSYMV	moiseyev
MKTAVYS	marquitas
MKVC	mikolic
MKVTV	makoto
MKVY	mickey
MKVY	mickey
MKYL	mkel
MKY	mike
'ML	emel
MLA	emilia
MLANDR	melander
MLANY	melanie
MLAYYR	molaire
MLBAY	melba
MLCR	melcher
MLCYR	melcher
MLKA	melka
MLKVLM	micklem
MLKVM	milko
MLMN	melman
MLN	emlen
MLR	moliere
MLTH	monolith
MLV	melo
MLVN	melvin
MLVR	moliere
MLYBV	malibu
MLYDY	melody
MLY	emily
MLYNGR	mellinger
MLYN	emlen
MLYNY	emeline
M'MA	mama
MMH	muh
MMTA	mamta
MNAMA	manama
MNAMH	minamo
MNARD	menard
MNDL	mendel
MNDL	mendel
MNDL	mendel
MNDR	mondor
MNDVZA	mendoza
MNDYBL	mandible
MNDYK	mendyke
MNDY	mindy
MNDZ	mendez
MNFVL	manfull
MNGAN	mangan
MNGH	menge
MNG	meng
MNGS	mingus
MNHART	menhardt
MNH	menth
MNJYVN	menuhin
MNK	monk
MNKVSV	moniques
MNKYVS	moniques
MNMA	manama
MNNYNG	manning
MNRV	munro
MNSA	mensa
MNSN	manson
MNSTRYNA	menestrina
MNSVR	mansur
MNSVR	mansur
MNSVR	mansur
MNSVRY	mansuri
MNTL	mantle
MNT	mont
MNTQH	menth
MNTSR	montessori
MNTSYNN	mantsinen
MNTY	monty
MNTZR	mentzer
MNYJR	meijer
MNYKS	moniques
MNY	money
MNY	money
MNYNG	morning
MNYN	amnon
MNZR	mounzer
MNZS	munozs
MNZYZ	menzies
MPL	empleo
MPL	empleo
MQBRH	moorish
MQRBY	moreby
MQSVD	maqsood
MRANDA	meranda
MRDYS	mercedes
MRDYT	meredith
MRHAVS	moorhouse
MRJYNYV	moroney
MRKL	merkel
MRKLY	merkle
MRKNT	menkent
MRKR	miranker
MRNDA	meranda
MRNY	moroney
M'RQ	mari
MRSR	mersereau
MRSRYA	mersereau
MRSRYV	mersereau
MRTN	merton
MRTNZ	martinez
'MR	amir
MRVAH	marwah
MRVAN	moravan
MRYGAN	merrigan
MRYJ	marytje
MRYK	marek
MRYKS	meraks
MRYMAN	merriman
MRY	mury
MRY	mury
MRYMN	mormon
MRYNLY	moroney
MRYS	emerys
MRYT	mirut
MRZ	merz
MSALXY	musial
MSA	mesa
MSANDR	mesander
MSBARN	mashburn
MSKS	omsks
MSKYN	miskin
MSLYN	maslin
MSMAN	mossman
MSR	meuser
MSS	miss
MSTAN	mastan
MST	mest
MST	mest
MSTRZ	mistry
MS'VD	moosavi
MSYF	massif
MSYNA	messina
MSYNGR	messinger
MSYN	masin
MSYVS	moiseyevs
MTANA	matana
MTLYN	matlin
MT	mt
MT	mt
MTNA	etna
MTNA	etna
MTRNC	metternich
MTRNYC	metternich
MTRV	mitrovic
MTRYNC	mitrovic
MTSGR	metzger
MTSVMVTV	matsumoto
MTSVN	matson
MTVR	motor
MTYN	motown
MTYN	motown
MTYV	molotov
MTYV	molotov
MTYV	molotov
MTYVS	molotovs
MTYVS	molotovs
MTYVSVN	mathewson
MTYVZ	mitzi
MTZGR	metzger
MTZYNG	metzing
MVALR	malur
MVANZR	mounzer
MVBAY	mumbai
MVBLY	mobley
MVDGYL	moudgill
MVD	med
MVDY	moody
MVDY	moody
MVFAD	mead
MVGANTY	moganti
MVHAMA	muhamma
MVHAN	mohan
MVHR	mohar
MVKASA	mukasa
MVK	mok
MVKRYJ	verweij
MVLANDR	melander
MVLDN	moulden
MVLK	milko
MVL	mel
MVLN	melen
MVLR	moliere
MVLR	moliere
MVLVY	emilie
MVLYGAN	milligan
MVLY	emily
MVLYNARY	molinari
MVMFVRD	mumford
MV	mo
MVNAGAN	monagan
MVNAK	monack
MVNAKV	monack
MVNAZ	muniz
MVNDFRANS	mondfrans
MVNDVR	mondor
MVNKAR	menkar
MVNK	monk
MVNKS	monks
MVNKZ	menke
MVN	min
MVN	min
MVNRV	munro
MVNS	mins
MVNTAG	montag
MVNTAGV	montagu
MVNTALBANV	montalbano
MVNTA	monta
MVNTANARV	montanaro
MVNTANV	montano
MVNTGMRY	montgomery
MVNTGVMRY	montgomery
MVNT	mont
MVNTRAL	montreal
MVNTRV	montero
MVNTVYA	montoya
MVNTYJV	montijo
MVNVLYT	monolith
MVNYZ	muniz
MVNZLR	muenzler
MVRABYTV	morabito
MVRAD	murad
MVRAL	murali
MVRALS	morales
MVRALT	muralt
MVRA	mira
MVRANDV	morando
MVRAN	moran
MVRANV	morano
MVRAS	miras
MVRAVAN	moravan
MVRAY	moray
MVRAYNS	moraines
MVRC	merck
MVRDAC	mauriac
MVRDAK	merak
MVRFY	morey
MVRHAVS	moorhouse
MVRHAVS	moorhouse
MVRKL	merkel
MVRKN	morken
MVRLAN	morlan
MVRL	merle
MVRL	merle
MVRL	merle
MVRLYJ	morley
MVRLY	morley
MVRMAN	moorman
MVR	mir
MVRNYNG	morning
MVRS	mirs
MVRS	mirs
MVRS	mirs
MVRSTAD	maurstad
MVRTAN	martian
MVRTN	merton
MVRTVN	merton
MVRTYMR	mortimer
MVRTYMR	mortimer
MVRTY	mirti
MVRTYMVR	mortimer
MVRV	omerov
MVRVNY	moroney
MVRVYL	muriel
MVRYL	morel
MVRY	mury
MVRY	mury
MVRYN	morin
MVRYSN	morison
MVRYSVN	morison
MVRYSVN	morison
MVRYTA	morita
MVSAL	musial
MVSANA	messina
MVSFYS	mosleys
MVSLA	musella
MVSMN	mossman
MVS	mos
MVSVN	maison
MVSVY	muscovy
MVSYG	muessig
MVSY	muse
MVSYR	meuser
MVSYVN	miskin
MVSZ	mesozoic
MVTA	mehta
MVTANA	montana
MVT	emit
MVTVR	motor
MVTVRZ	montero
MVTYSV	mutiso
MVVR	meir
MVYL	moile
MVY	moye
MVYNYHAN	moynihan
MVYNZ	mounzer
MVYR	meyer
MVYSAN	moisan
MVYS	moes
MVYSS	meuses
MVYSVN	muysson
MVYZ	muniz
MVYZVN	mozina
MVZYNA	mozina
MVZZ	mize
MYAV	miao
MYAYNDRT	meindert
MYCALYS	michaelis
MYCA	mycenae
MYCAN	mexican
MYCAYLYS	michaelis
MYCL	michel
MYCLTJN	micheltjen
MYCLTN	moulton
MYCLTYN	moulton
MYCLYS	micheles
MYCN	miocene
MYDLBRV	middlebro
MYDLTN	middleton
MYDLTVN	middleton
MYD	med
MYDR	medrek
MYDY	moody
MYGN	imogene
MYGNRAN	migneron
MYGNRY	mignerey
MYGR	meger
MYGR	meger
MYGVYL	miguel
MYHALYK	mihalick
MYHAN	mohan
MYJR	meijer
MYJRY	meijer
MYKAK	mika
MYKALK	koukalik
MYKA	mika
MYKAS	mukasa
MYKAYL	mikael
MYKAYYL	mikael
MYKAYYLYZ	mikael
MYKAYYLZ	mikael
MYKK	mikki
MYKLACLN	maclachlan
MYKLJN	mikulin
MYKLM	micklem
MYKLSN	mickelson
MYKLSVN	mickelson
MYK	mok
MYKNA	mickna
MYKR	meaker
MYKS	meeks
MYKS	meeks
MYKS	meeks
MYKT	miket
MYKVK	mikki
MYKVLYK	menelik
MYKV	mike
MYKYNG	mekong
MYKYNZ	mckenzie
MYKZ	mike
MYLAD	milad
MYLAM	milam
MYLAM	milam
MYLAN	milan
MYLARA	melara
MYLARD	milward
MYLAR	mylar
MYLASYS	melanesias
MYLBRT	milbert
MYLDRD	mildred
MYLGRAM	milgram
MYLKS	milks
MYLKV	milko
MYLKY	milky
MYLMAN	melman
MYLMAN	melman
MYLMV	milmoe
MYLN	melen
MYLNR	milner
MYLNVR	milner
MYLNYVM	millennium
MYLR	moliere
MYLSTVN	milestone
MYLT	milt
MYLT	milt
MYLTN	melton
MYLVARD	milward
MYLV	melo
MYLVS	myles
MYLVT	milut
MYLYANZ	melanie
MYLYGAN	milligan
MYLYKN	milken
MYLY	emily
MYLY	emily
MYLY	emily
MYLYND	milind
MY	moye
MYMAS	mimas
MY	moye
MY	moye
MYMY	mime
MYNA	mina
MYNA	mina
MYNAMV	minamo
MYNARD	menard
MYNARD	menard
MYNARYK	minarik
MYNDRT	meindert
MYNGV	menge
MYNKY	monkey
MYN	min
MYN	min
MYN	min
MYN	min
MYN	min
MYNRAL	mineral
MYNR	miner
MYNRVA	minerva
MYNRZ	muniz
MYNSR	monster
MYNSTRL	minstrel
MYNSY	minsky
MYNTAKAH	mintaqah
MYNTAKVA	mintaka
MYNTKA	mintaka
MYNT	mont
MYNTR	minter
MYNTVN	minton
MYNTZ	mintz
MYNVARYNG	mainwaring
MYNYARD	minyard
MYNY	money
MYNZ	muniz
MYNZ	muniz
MYPL	empleo
MYRA	myra
MYRA	myra
MYRANKR	miranker
MYRFLD	mayerfeld
MYR	emyr
MYRMAK	mirmak
MYR	emyr
MYR	emyr
MYR	emyr
MYRS	myers
MYRSY	morse
MYRTY	mirti
MYRVA	mierwa
MYRVL	morel
MYRVT	mirut
MYRYDYT	meredith
MYRZ	merz
MYRZ	merz
MYRZ	merz
MYSA	mesa
MYSA	mesa
MYSAN	moisan
MYSAT	measat
MYSLAV	mislove
MYSL	mosul
MYSL	mosul
MYSM	maoism
MYSN	muysson
MYSRA	misra
MYSTRY	mistry
MYSTYK	mistick
MYSVNR	masoner
MYSYK	misik
MYTAL	mithal
MYTAVA	amitava
MYTCL	mitchel
MYTCM	mitchem
MYTNYK	mitnick
MYTRVVYK	mitrovic
MYTSL	mutiso
MYTV	mito
MYTV	mito
MYTVN	motown
MYTVNN	miettunen
MYV	moye
MYVS	moes
MYVSN	moisan
MYVVZ	muniz
MYVZ	muniz
MYVZR	mounzer
MYYH	miehe
MYYR	myer
MYYRS	myers
MYZ	mize
MYZ	mize
MYZVN	mozina
MYZYRA	mizera
MZDH	mazdeh
MZYK	muzak
MZYVN	mozina
NAB	nabil
NABL	nabil
NABYL	nabil
NADAN	nevadan
NADANSVN	nathanson
NADVLNY	nadolny
NADYG	nadig
NAF	knaff
NAF	knaff
NAF	knaff
NAFZA	nafeeza
NAGASAKY	nagasaki
NAGASYVA	nagasiva
NAGNT	nugent
NAGY	nagy
NAHAM	nahum
NAJR	nair
NAJYAH	najiyah
NAJYA	najya
NAKAGAKY	nakagaki
NAKAMVRA	nakamura
NAKASVRA	nakasora
NAKASYMA	nakashima
NAK	nakao
NAKSVN	naquin
NAKVYYN	naquin
NAL	neal
NALYK	nallick
NAM	nam
NANDVANY	nandwani
NANLY	nunley
NAN	nan
NANS	nans
NANSY	nans
NANTVN	naunton
NAP	napier
NAP	napier
NAPTVN	napton
NAPVLYTANV	napolitano
NARAD	narad
NARDN	nardone
NARDV	nardi
NARDY	nardi
NARLA	narla
NARSAVAG	narsavage
NARV	naro
NASAV	nassau
NAS	nas
NAS	nas
NATAN	nathan
NAT	nat
NATSN	nation
NAVAR	nawar
NAVARV	navarre
NAVAS	navas
NAV	nave
NAV	nave
NAVYA	navia
NAVYLV	naylor
NAYA	navia
NAYDV	naidoo
NAYFH	nayfeh
NAYFLR	naylor
NAYKRBYKR	knickerbocker
NAYKS	nanooks
NAYKS	nanooks
NAYKVLAS	niekolaas
NAYLR	naylor
NAYLZ	naylor
NAYMAH	naimah
NAYRMN	naquin
NAYT	nat
NAYT	nat
NAZAHA	nazahah
NAZARYTYAN	nazaretian
NAZARYV	nazario
NBATAY	nabatiye
NBATYH	nabatiye
NBATY	nabatiye
NBL	nebel
'NBR	anbar
NBRS	nebres
NDA	nida
NDKARNY	nadkarni
NDN	neden
NDVD	nedved
NDYN	neden
NFAN	enfant
NFDV	nefedow
NFJAN	neefjan
NFL	knefel
NFYSA	nicosia
NFYZA	nafeeza
NFZA	nafeeza
NGTYV	negative
NGY	engi
NHAVS	neuhaus
NHNH	nahnah
NJAF	najaf
NJF	najaf
NJVA	najwa
NJYAH	najiyah
NJYA	najya
NJYH	najiyah
NKLAS	niklas
NKLS	winkels
NKNZ	niknaz
NKV	nike
NKV	nike
NL	neil
NLKYN	nelkin
NLS	nils
NLSN	nelsen
NLT	weinelt
NMAZY	namazi
NPAN	ionian
NP	np
NPL	nepal
NPR	napier
NPTVN	neptune
NPVRA	napora
NRAD	nirad
NRDNFLT	nordenfelt
NRS	norse
NRTRVP	northrop
NRVP	norup
NRY	nery
NRY	nery
NSLY	nesley
NSNAL	snail
NSVA	nicosia
NSVM	nossum
NSYDA	nashida
NSYHA	nasiha
NSYH	nash
NSYRA	nasira
NTAKR	nethacker
NTRTVN	netherton
NTYFA	nathifa
NTYHA	anthea
NVALA	nukala
NVAR	invar
NVAYL	neal
NVAZ	nawaz
NVBL	nebel
NVBL	nebel
NVDA	nida
NVDYNG	nuding
NVF	enif
NVGNT	nugent
NVJANS	nevejans
NVJANZ	nevejans
NVJNANS	nevejans
NVJNS	nevejans
NVJNT	anujit
NVKS	nikes
NVKV	nike
NVLAN	nolan
NVLD	nolde
NVLF	nolf
NVL	nevel
NVL	nevel
NVNYS	ninoys
NVP	knip
NVRA	nora
NVRBAY	norway
NVRDA	neruda
NVRDBAY	nordby
NVRDBVRG	nordborg
NVRDDRAP	noorddorp
NVRDNSTVRM	nordenstrom
NVRDRAP	noorddorp
NVRDRVPH	noorddorp
NVRDT	nordt
NVRDVRP	noorddorp
NVRDVRP	noorddorp
NVRHA	norha
NVRKAT	norquist
NVRN	noren
NVRSRAP	mersereau
NVRSVRP	noorddorp
NVRTKAT	northeast
NVRTVRPH	northorpe
NVRTVRP	northorpe
NVRVVD	nereid
NVRY	nery
NVSAK	nosack
NVSL	novosel
NVT	newt
NVTZN	knutzen
NVTZ	notz
NVVALA	nukala
NVVRDDRP	noorddorp
NVVSL	novosel
NVVYK	novik
NVYA	noya
NVYFL	knoefel
NVYJANZ	nevejans
NVYK	novik
NVYL	nevel
NVYL	nevel
NVYLS	noyles
NVYNGTVN	newington
NVYS	noyes
NVZ	inez
NYBY	newby
NYCVLAS	nicolas
NYCVLS	nicoles
NYDAL	nidal
NYDA	nida
NYDH	sindhi
NYDLZ	needles
NYD	ned
NYFJAN	neefjan
NYFYN	kniffin
NYGLY	niggli
NYG	enying
NYGRA	nigra
NYGT	night
NYHALANY	nihalani
NYKALAS	unukalhais
NYKLAS	niklas
NYKLAS	niklas
NYKLAS	niklas
NYKLAS	niklas
NYKL	anukul
NYKL	anukul
NYKL	anukul
NYKL	anukul
NYKLS	niklas
NYKLS	niklas
NYKLS	niklas
NYKLS	niklas
NYKLSN	nickelsen
NYKLSN	nickelsen
NYKLSVN	nickelsen
NYKLV	nikolai
NYKLZ	nikolai
NYKLZ	nikolai
NYK	nik
NYK	nik
NYK	nik
NYKRBAKR	knickerbacker
NYKRBKR	knickerbocker
NYKRBYKR	knickerbocker
NYKRSVN	nickerson
NYKS	nyikos
NYKSVN	enoksson
NYKVLA	nikolai
NYKVLAS	nikolais
NYKVLAS	nikolais
NYKVLAS	nikolais
NYKVLAS	nikolais
NYKVL	anukul
NYKVLSAN	nickelsen
NYKVLS	nikolais
NYKVLS	nikolais
NYKVLS	nikolais
NYKVLSVN	nickelsen
NYKVLYK	nikolayev
NYKVLY	nikolay
NYKVLY	nikolay
NYKVLZ	nikolai
NYKVLZ	nikolai
NYKV	nike
NYKY	nike
NYKY	nike
NYKY	nike
NYKY	nike
NYLBRY	newbery
NYLJH	nilesh
NYLMG	neelmegh
NYLND	niland
NYL	neil
NYL	neil
NYLS	noyles
NYLS	noyles
NYLS	noyles
NYLS	noyles
NYLTH	monolith
NYLTJH	neeltje
NYLTJ	neeltje
NYLTJY	neeltje
NYLZ	nile
NYMAH	naimah
NYMA	noumea
N'YMH	naimah
NYMH	naimah
NYMRAD	nimrod
NYMTZ	nimtz
NYMY	nome
NYNDK	ninedek
NYNJA	ninja
NYN	nin
NYN	nin
NYNS	noyens
NYNSTAR	ninstar
NYNV	nino
NYNVYS	ninoys
NYPAN	nepali
NYPNBRG	knippenberg
NYPTVN	neptune
NYR	neri
NYR	neri
NYS	noyes
NYS	noyes
NYSN	neisen
NYSPL	knispel
NYSYLDA	gnishilda
NYTYN	nitin
NYVAN	donovan
NYVARK	newark
NYVAYNGTN	newington
NYVAYNGTVN	newington
NYVBAY	nubia
NYVBRY	newbery
NYVBRY	newbery
NYVKVLAS	niekolaas
NYVKVYST	newquist
NYVLND	newland
NYVMAN	neuman
NYVMAN	neuman
NYVMN	neuman
NYVMYR	newmeyer
NYVSAM	newsham
NYVTN	newton
NYVVYNGTVN	newington
NYVYSVN	nevison
NYVYYNGTVN	newington
NYYVKAMB	kamb
NYYVTN	newton
'NYZH	voronezh
NZAHAH	nazahah
NZAHA	nazahah
NZAHH	nazahah
NZYRAH	nazirah
NZYRA	nazirah
NZYRH	nazirah
PABLT	pablo
PABLV	pablo
PACVLKH	pacholke
PACYANV	pachiano
PADVA	padua
PADVLA	padula
PADYAL	padial
PADYLA	padula
PAGLAYS	paglias
PAGLYA	paglia
PAGLYS	paglias
PAGLYYARV	pagliaro
PAGT	piaget
PAJT	paquet
PAKALA	pakala
PAKARD	packard
PAKNAS	pakenas
PAKS	paks
PAKS	paks
PAKT	paquet
PAKVAT	paquet
PALAGY	palagyi
PALAK	palau
PALFVRD	pulford
PALMRT	palmert
PAL	pal
PAL	pal
PALRMV	palermo
PALSKY	polsky
PALSN	paulsen
PALSYFR	pulsifer
PALTJH	paultje
PALTJ	paultje
PALTJY	paultje
PALVMBV	palumbo
PALYDV	pulido
PALY	paley
PALY	paley
PALY	paley
PALYS	pablos
PAMFRY	pumfrey
PAM	pam
PANAGS	panagos
PANAS	panas
PANC	panici
PANDA	panda
PANDR	pandora
PANDVLFYNV	pandolfino
PANDYAN	pandian
PANDYT	pandit
PANDZ	pandit
PANFYL	panfil
PANGBVRN	pangborn
PANJABY	punjabi
PANKRAS	pandoras
PANKRS	pankhurst
PANN	panon
PAN	pan
PANT	pant
PANVALKR	panvalkar
PANVN	panon
PANYKV	pranke
PANYSY	pansy
PAPALARDV	pappalardo
PAPAY	papay
PAPLASKAS	paplaskas
PAPLTVN	poppleton
PAPLY	pauli
PAPN	pape
PAP	pape
PAP	pape
PAPVYK	popeye
PAQ	pai
PARA	parra
PARAT	parratt
PARAYL	parayil
PARDN	pardon
PARDYNGTN	pardington
PARDYNGTVN	pardington
PARDY	pardi
PARDZ	pardi
PARHAM	parham
PARK	park
PARKYN	parkyn
PARKZ	park
PARMAR	parmar
PARNS	parsons
PARSANZ	parisian
PARSL	parsloe
PARSN	parson
PARSVNS	parsons
PARSVNZ	parson
PARTVN	parton
PARTVS	partos
PARTY	pareto
PARYNGTVN	pardington
PARY	peary
PARYS	paris
PASKAL	pasquale
PASKV	pasko
PASKV	pasko
PAS	pas
PASTRNAK	pasternak
PASTVR	pasteur
PASYFYK	pasko
PASYR	passier
PATN	patna
PATR	patric
PATRSVN	paterson
PATRSVN	paterson
PATRVKLVS	patroclus
PATRYK	patrik
PATRYK	patrik
PATRYK	patrik
PATRYS	patrices
PATRYSYA	patricia
PATRYZYV	patrizio
PATS	pates
PATTA	patetta
PATVCY	patrice
PATVKSNT	patuxent
PATYL	patel
PAVL	pavol
PAVLSN	paulsen
PAVLS	pauls
PAVLTH	paleolithic
PAVLT	paultje
PAVLYK	pavlik
PAV	pai
PAVV	pavlov
PAYJ	paultje
PAYK	paik
PAYNH	payne
PAYN	payne
PAYNTVN	paynton
PAYNY	payne
PAY	pai
PAYPR	pieper
PAYRAMYD	pyramid
PAYTH	plath
PAYTJ	paultje
PAYTR	paynter
PAYTR	paynter
PAYTVN	payton
PAYVLSVN	paulsen
PAYVLTJ	paultje
PAYVTH	payette
PD	pd
PDRAM	pedram
PDRSN	pedersen
PDRSVN	pedersen
PDY	preedy
PG	peg
PGRAM	pegram
PGT	puget
PK	pike
PKR	packer
PKYNGZ	peking
PLAK	plack
PLAMN	plamen
PLAMR	plamen
PLANK	planck
PLAN	plaine
PLANT	plante
PLASTYNV	plastino
PLATFVRM	platform
PLAT	plat
PLAT	plat
PLATYV	plate
PLAYR	pillar
PLC	ziploc
PLHAM	pelham
PLKCYA	felecia
PLKY	pelkie
PLNKNR	plencner
PLNTH	elnath
PLTAYR	voltaire
PLTCR	pletcher
PLTFRM	platform
PLTKVS	platkus
PLTNN	peltonen
PLT	pelt
PLT	pelt
PLTYV	pluto
PLTYYR	pelletier
PLVHN	ploehn
PLVMR	plummer
PLYGRYNY	pelligrini
PLYNSKYN	plinskin
PLYSKYN	pliskin
PLYT	pluto
PLYV	pelee
PNBAKR	pennebaker
PNDLTN	pendleton
PNDLTVN	pendleton
PNDYA	pandya
PNGADV	pengadu
PNG	peng
PNKRAS	pandoras
PNL	pingel
PN	pino
PNS	pins
PNTVN	pinton
PNYMAN	penniman
PNYNSVLA	peninsula
PNYNZVLA	peninsula
PNY	pino
PPH	poh
PPLR	doppler
PPYN	pepin
PRABST	probst
PRACT	paraclete
PRADV	prado
PRAGV	prague
PRAHL	prahl
PRAKTYKVM	praktikum
PRAL	prael
PRALT	perrault
PRAM	pram
PRAMVD	pramod
PRANAV	pranav
PRANGS	prongs
PRANK	pranke
PRAPYS	propes
PRASAD	prasad
PRASANA	prasana
PRASANT	prashant
PRASN	prasen
PRAS	piraeus
PRATP	pratap
PRAT	pratt
PRATS	prates
PRATVL	pratul
PRATYK	prateek
PRATYKS	pratiksh
PRATYKV	prateek
PRAVL	pravil
PRAVYN	praveen
PRAYB	prague
PRAYL	prael
PRAYM	pram
PRAYVN	praveen
PRAYVYT	pirawat
PRBN	preben
PRC	porco
PRDYKARV	perdicaro
PRDYKYS	perdikis
PRDYS	purdues
PRKAS	pereckas
PRKS	parks
PRKYNS	perkins
PRKYNZ	parkyn
PRLMAN	perlman
PRLMN	perlman
PRL	perl
PRLR	perler
PRLY	perley
PRMAL	premal
PRNT	parent
PRNTYS	prentiss
PRPK	perpk
PRSATTAM	purshottam
PRSKAT	private
PRSL	parsloe
PRSLT	presley
PRSTN	preston
PRSTRVD	prestrud
PRSTRV	prestero
PRSTVN	preston
PRSVN	pierson
PRSYNV	pierson
PRSYVAL	parsifal
PRVAMR	priam
PRVAN	provan
PRVGTV	progetto
PRVJT	projet
PRVMVNTVRY	promontory
PRVN	priven
PRVPS	propes
PRVS	purvis
PRVTRV	prestero
PRVTVS	protus
PRVV	provo
PRVVST	prevost
PRVYN	priven
PRVY	pruy
PRVYS	purvis
PRYA	priya
PRYAVLT	perreault
PRYBL	preble
PRYCARD	pritchard
PRYDY	preedy
PRYKLY	prickly
PRYKN	parkin
PRYKT	preeti
PRYLV	preble
PRYMRV	primero
PRYMV	prime
PRYMYVS	primus
PRYNG	prong
PRYN	peron
PRYNS	procyons
PRYNSS	prensas
PRYNT	parent
PRYNY	perini
PRY	pery
PRYSKAT	private
PRYSLR	preisler
PRYSTLY	priestly
PRYSTLY	priestly
PRYST	priest
PRYSTVN	preston
PRYSYLA	priscilla
PRYSYNG	pershing
PRYTCARD	pritchard
PRYTY	preeti
PRYTY	preeti
PRYTZ	pritz
PRYVR	pryor
PRYVS	preis
PRYVST	prevost
PRYYVTY	preeti
PRZ	perez
PSKYN	peskin
PSNKV	psyko
PS	ps
PSTMA	postma
PST	post
PTCR	petcher
PTKR	patkar
PTLA	patella
PTRN	petren
PTR	peter
PTRSN	petersen
PTRSN	petersen
PTRSVN	petersen
PTRSVN	petersen
PTRVF	petrow
PTRVNLA	petronella
PTRV	petrov
PTRVV	petrov
PTRVYC	petrovich
PTRYC	patric
PTRYK	patrik
PTRY	petry
PTRZ	patrizio
PTSY	patsy
PTV	pete
PTYBN	pettibone
PTYBVN	pettibone
PTYL	patel
PTYNS	putins
PTY	pete
PTY	pete
PTY	pete
PTYTJYN	petitjean
PTZVLD	petzold
PVALMA	pearlman
PVA	apia
PVGA	puga
PVGLYS	pugliese
PVG	peg
PVGVSYAN	pogosyan
PVHAN	puhan
PVHAR	pohar
PVHL	pohl
PVH	poh
PVKVRNY	pokorny
PVLAKVS	poulakos
PVLGAR	pulgar
PVLK	polk
PVLMYTYS	polemitis
PVLND	poland
PVLN	polen
PVLN	polen
PVLNT	polant
PVL	pil
PVL	pil
PVLSN	polson
PVLS	opels
PVLS	opels
PVLTR	poulter
PVLV	pilvio
PVLVVYN	polowin
PVLYNG	poling
PVLYPALY	polepalli
PVLY	pele
PVLYS	peles
PVLYT	pelt
PVLYYAM	pulliam
PVLZ	pele
PVMA	puma
PVMFRY	pumfrey
PVNA	pena
PVNT	pinto
PVNVZ	spinoza
PVPAT	popat
PV	po
PVP	pepe
PVP	pepe
PVRAHV	purahoo
PVRANYK	puranik
PVRJZ	perez
PVRKV	pirkko
PVR	peru
PVRTNVY	portnoy
PVRTRFYLD	porterfield
PVRVS	purvis
PVRYNTVN	purinton
PVRYR	poirier
PVSALA	poosala
PVSARY	pissaro
PVSN	posen
PVS	pos
PVSTYL	postill
PVSV	poso
PVSY	pusey
PVTKVNN	putkonen
PVT	peet
PVTRY	petry
PVTYT	petit
PVTYT	petit
PVTZ	putz
PVVLZ	poole
PVV	pei
PVYNT	point
PVYNTYNG	poynting
PVYRYR	poirier
PVYSL	poisl
PVYV	pouw
PVZYVS	puzos
PYAK	peak
PYATJY	pietje
PYATK	piatek
PYBADY	peabody
PYDH	pooh
PYD	peed
PYD	peed
PYJH	pooh
PYJT	projet
PYKAP	pickap
PYKARD	pickard
PYKASV	topekas
PYKL	pickel
PYK	pike
PYK	pike
PYK	pike
PYK	pike
PYKRL	pickrell
PYKS	pikes
PYKVLBNY	pikelner
PYKZ	pike
PYLAR	pillar
PYLARZ	polaris
PYLATV	pilate
PYLAZV	palaio
PYL	pyle
PYL	pyle
PYLVSKY	pilewski
PYLVYV	pilvio
PYLY	pyle
PYLYSNRY	elsinore
PYNAKL	spinak
PYNA	pena
PYNCAZ	phoenicia
PYNCRA	pinchera
PYNDAR	pindar
PYNDV	pinedo
PYNGNVT	pingenot
PYNG	peng
PYNKVVYTZ	pinkowitz
PYNKY	pinky
PYN	pino
PYN	pino
PYN	pino
PYNSN	pinson
PYNSVN	pinson
PYNTH	pinto
PYNTN	pinton
PYNTR	pinter
PYNTR	pinter
PYNTR	pinter
PYNTVN	pinton
PYNTVN	pinton
PYNV	pino
PYNV	pino
PYNXAM	putnam
PYNYAN	pinyan
PYNY	pino
PYNZ	pino
PYPGRAS	pipgras
PYP	pype
PYP	pype
PYPR	piper
PYPVNY	piponi
PYRAMYD	pyramid
PYRAN	piran
PYRANY	pirani
PYRARD	pirard
PYRAVAT	pirawat
PYRKV	pirkko
PYRLMAN	perlman
PYRL	perl
PYRMN	permian
PYR	pyrex
PYRSN	pierson
PYRSN	pierson
PYRSN	pierson
PYRS	pyers
PYRS	pyers
PYRSVN	pierson
PYRT	port
PYRV	pyrex
PYRVZ	perez
PYRY	pery
PYRYR	poirier
PYRYZ	perez
PYRZ	perez
PYSAH	peasah
PYSAN	pusan
PYSH	piyush
PYSLY	paisley
PYSNS	pusans
PYS	pos
PYS	pos
PYS	pos
PYSTVN	pistun
PYTAN	pitman
PYTA	petra
PYTH	python
PYTJ	pietje
PYTKV	pitkow
PYTMN	pitman
PYT	peet
PYT	peet
PYT	peet
PYT	peet
PYTR	pyotr
PYTR	pyotr
PYTR	pyotr
PYTRSVN	petersen
PYTRV	petrov
PYTRZ	petro
PYTS	petes
PYTYBVN	pettibone
PYVMLY	piomelli
PYVN	pion
PYVNYK	pivnick
PYV	pei
PYVRYNTN	purinton
PYVTR	pyotr
PYYK	pieck
PYYRY	pieri
PYYV	pouw
PYZA	pizza
PYZLY	piziali
PYZS	puzos
PYZVLYTV	pizolato
PYZYALY	piziali
PYZYNY	pizzini
PYZY	puzo
PYZYR	pyziur
PZARAYS	pezaris
QADSYH	qadisiyah
QALYA	alya
QASAN	asian
QASM	qasim
QAYD	ubaid
QAYS	ayse
QBYLH	qubilah
QDAMH	qudamah
QDYLA	delia
QDYL	doyle
QDYM	odom
QDYRA	qadira
QDYR	oder
QDYSH	swedish
QDYSYHA	dishaw
QLYA	elya
QLYBA	elba
QLYB	golub
QLYLA	olivola
QML	emel
QMR	emre
QNTVN	quentin
QRBYA	serbia
QRYBYH	ereby
QSAN	hisan
QSN	osen
QSYM	isom
QSYM	isom
QTRAN	tran
QVASYM	quasim
QVBYLH	qubilah
'QYLA	aqila
'QYLA	aqila
'QYL	aqil
'QYL	aqil
QYT	wet
QYVN	quin
RABKYN	rabkin
RABLD	rabold
RABL	rabel
RABNAV	rabenau
RABN	raben
RABN	raben
RAB	arab
RABRT	robert
RABRTSN	robertson
RABRTSVN	robertson
RAB	arab
RABTM	morabito
RABVYL	raboel
RABYDYAKS	robideaux
RABY'H	rabiah
RABYJN	robijn
RABYN	raben
RABYN	raben
RABYNSN	robinson
RABYNSVN	robinson
RABY	raby
RABY	raby
RABYV	raby
RACL	oracle
RAC	dirac
RADAK	radek
RADBRG	rodberg
RADBVD	radboud
RADBVN	radbone
RADHA	radha
RADHYKA	radhika
RADKLYF	radcliff
RADK	radek
RADMN	rawdon
RADNBRC	radenburch
RADNBRGARBRVK	radenburgerabroek
RADNBRGRABRK	radenburgerabroek
RADNBRGRABRVK	radenburgerabroek
RADNBRGRBRVK	radenburgerabroek
RADNYK	radek
RAD	rad
RADRAMVNY	rudramuni
RADRFRD	vanderford
RADR	rader
RADR	rader
RADT	brandt
RADVA	radwa
RADVF	radev
RADVLFS	rodolfos
RADVLFVS	rodolfos
RADV	radev
RADVYG	radig
RADYAH	radeyah
RADYH	radeyah
RADYNG	druding
RADY	radu
RAFALKV	rafalko
RAFAL	rafal
RAFALSKY	rafalski
RAFA	rafa
RAFAYL	rafael
RAFAYLY	rafaeli
RAFNR	rainer
RAF	rafi
RAFRTY	rafferty
RAFYKYV	rafique
RAFYL	rafael
RAFYN	raffin
RAFY	rafi
RAGATZ	ragatz
RAGLND	ragland
RAGL	ragle
RAGNAR	ragnar
RAGNARSVN	ragnarsson
RAGNRD	fragonard
RAGNVALD	ragnvald
RAGRV	prager
RAGSDYL	ragsdale
RAHARJV	rahardjo
RAHBK	rohbeck
RAHRR	rohrer
RAHRYG	roehrig
RAHVL	rahul
RAHY	rahi
RAJCR	rajcher
RAJNDR	rajender
RAJN	radjen
RAJ	raj
RAJR	raju
RAJRZ	ramirez
RAJS	rajas
RAJV	rajeev
RAJYV	rajeev
RAKAH	raqqah
RAKL	raquel
RAKL	raquel
RAK	iraq
RAKVN	rabkin
RAKV	iraqi
RAKYKVT	rakita
RALF	ralf
RALF	ralf
RALF	ralf
RAMA	rama
RAMBL	rambo
RAMBV	rambo
RAMPLZ	rampling
RAM	ram
RAM	ram
RAMR	ramer
RAMS	ramos
RAMSY	ramsey
RAMSYR	ramseier
RAMTAN	ramthun
RAMVLVS	romulus
RAMVS	ramos
RAMY	reamy
RAMYRV	ramiro
RAMZ	ramez
RANA	rana
RANDL	randal
RANDR	rander
RANGL	wrangell
RANKYN	rankin
RANN	erann
RAN	eran
RAN	eran
RAN	eran
RANR	rainer
RANTGN	rontgen
RANY	rainey
RANY	rainey
RANY	rainey
RANYV	rainey
RAPBRYK	ropebrake
RAP	rae
RAPR	draper
RARK	browarek
RASA	eurasia
RASCN	krasen
RASDAL	ragsdale
RASD	rashed
RASFVRD	crawford
RASKH	raskin
RASK	raskin
RASKYN	raskin
RASL	rasul
RASL	rasul
RASMN	rasmussen
RASNDAL	rosendale
RASNDYL	brandel
RASNMAN	rosenman
RASPYNY	ruspini
RAS	ras
RAS	ras
RAS	ras
RAS	ras
RASTN	rastin
RASTRAM	tristram
RAST	raisty
RASTYN	rastin
RASTY	raisty
RASVM	qasim
RASV	raso
RASV	raso
RASV	raso
RASYD	rashed
RATCSVN	ratcheson
RATGRT	rutgert
RATJRT	rutgert
RATKS	rutks
RATMN	dratman
RATRA	rattray
RAT	rat
RATRFVRD	waterford
RAT	rat
RATSTRVM	ruthstrom
RAVBATM	rabat
RAVDAH	raidah
RAVDA	pravda
RAVDA	pravda
RAVLND	rawalpindi
RAVLT	raoult
RAVNR	rainer
RAV	ravi
RAV	ravi
RAV	ravi
RAVRDY	raverdy
RAV	ravi
RAVRT	ararat
RAVS	reavis
RAVT	raith
RAVYAH	rawiyah
RAVYH	rawiyah
RAVYNDRAN	ravindran
RAVYRAJ	raviraj
RAVY	ravey
RAVY	ravey
RAYBLT	raoult
RAYDAH	raidah
RAYDJ	radjen
RAYDL	raoul
RAYDN	rawdon
RAYFL	rafal
RAYLH	rayleigh
RAYLY	rayle
RAYMVND	raymond
RAYNR	rayner
RAYP	iraqi
RAY	ray
RAYSL	rasul
RAYS	raes
RAYSTLYN	raistlin
RAYT	raith
RAYTZ	reetz
RAYVARD	rivard
RAYVLYNGZ	rawlings
RAYV	raivo
RAYVTYALA	rautiala
RAYZL	raizel
RAZDAN	razdan
RAZN	rain
RAZVRBK	razorback
RBHVLZ	rebholz
RBRTSVN	robertson
RBVK	rubik
RBVSV	reboso
RBYAH	rabiah
RBYH	rabiah
'RBYL	arbil
RBYS	rubys
RDAH	raidah
RDA	reda
RDBVN	radbone
RDFYLD	redfield
RDLFVS	rodolfos
RDLVS	redlus
RDMN	redman
RDMYL	redmill
RDRYK	fredrik
RDVA	radwa
RDVLF	rudolf
RDVNDV	redondo
RDYDH	riyadh
RDYH	radeyah
RDY	rudy
RFA	rafa
RFSNS	refsnes
RFSVN	refson
RF'T	rafat
RGD	brigid
RGV	rego
RHLYNG	rehling
RHNY	rheni
RHYMAH	rahimah
RHYMH	rahimah
RHYM	rahim
RJAS	rojas
RJAT	rajat
RJ	raj
RKAH	rebekah
RKDAL	reckdahl
RKKAH	raqqah
RKSTN	reksten
RKVG	reckeweg
RLF	rolfe
RLYVS	rolexs
RLYVZ	berlioz
RMD	remde
RMFR	rempfer
RMLYNGR	remlinger
RMNCYK	romanchik
RMN	eremin
RMNS	riemens
RMPLYNG	rampling
RMVNY	rimoni
RMY	remy
RNALDZ	reinaldo
RNALT	renault
R'NA	rana
RNA	erna
RNAVD	renaud
RNBART	rennebarth
RNDHL	randhol
RNDR	rander
RNDY	ronde
RNJ	orne
RNVYS	rooneys
RN	rn
RNY	rony
RNZLND	renzland
RNZ	renze
RPLAGL	replogle
RPRT	rupert
RPTVN	repton
RQAH	uriah
RQA	roa
RQD	red
'RRYFA	arrifa
RSA	rosa
RSL	risel
RSL	risel
RSNYK	resnick
RST	rest
RSVL	risel
RSVLVYRT	resolveert
RSVNAT	resonate
RSVNDL	rosendale
RSYDA	rashida
RSYDH	riyadh
RSYD	ersheid
RSYNH	rosenheim
RSYNJH	resyntje
RSYNTH	rosenthal
RSYNTJ	resyntje
RSYVYN	wershoven
RTKLYF	eklof
RT	rte
RVAN	rowan
RVATR	creator
RVAY	ray
RVAYZ	ramez
RVAZNR	rainer
RVBRJ	ribeiro
RVBR	reuber
RVBRTA	roberta
RVBRT	robert
RVBRTSVN	robertson
RVBRTV	roberto
RVBVZ	roboz
RVBYN	robyn
RVBYNSVN	robinson
RVBYNZ	robyn
RVBY	roby
RVBY	roby
RVC	eric
RVC	eric
RVDA	reda
RVDH	riyadh
RVDLV	rudloe
RVDNBRG	roodenburg
RVD	red
RVD	red
RVDRYGV	rodrigo
RVDRYGZ	rodriguez
RVDVLFAS	rodolfos
RVDVLF	rudolf
RVDVLFVS	rodolfos
RVGALSKY	rogalsky
RVGVZA	rogoza
RVHAN	rehan
RVHL	riehle
RVHM	rohm
RVHN	rohn
RVHRR	rohrer
RVHR	ruhr
RVJAS	rojas
RVKAN	rukan
RVKA	erika
RVKN	rukan
RVKRY	rookery
RVKSAN	roxsan
RVKSAN	roxsan
RVKV	roku
RVKYKY	rokicki
RVKZ	enriquez
RVLAND	roland
RVLDAN	roldan
RVLFH	rolfe
RVLF	rolfe
RVLF	rolfe
RVLND	roland
RVLS	riels
RVLV	revelo
RVLY	riley
RVMFVRT	roumfort
RVMRV	romero
RVMYG	romig
RVMYV	romeo
RVNALD	ronald
RVNDA	ronda
RVNDH	ronde
RVNDL	rundle
RVNDYN	brendon
RVNGV	ringo
RVNTRY	rountree
RVNY	rony
RVNY	rony
RVNYT	ronit
RVPKH	roepke
RVPRT	rupert
RVP	rep
RVRKH	rourke
RV	rev
RV	rev
RVR	river
RV	rev
RVRY	rory
RVRYS	rorys
RVSALYN	rosalyn
RVSAM	rosham
RVSAM	rosham
RVSANA	rosana
RVSA	rosa
RVSKV	rusk
RVSL	risel
RVSLYN	roslyn
RVSLYN	roslyn
RVSNAL	rosendale
RVSNBLAT	rosenblatt
RVSNDAL	rosendale
RVSNDL	rosendale
RVSNFLD	rosenfeld
RVSN	rosen
RVSNR	reisner
RVS	roves
RVS	roves
RVS	roves
RVSR	reiser
RVSTAD	rostad
RVSTND	rostand
RVSVLT	roosevelt
RVSVN	rosen
RVSV	rose
RVSV	rose
RVSYALA	rosalie
RVSYTR	rossiter
RVTABAGA	rutabaga
RVTGR	rutgers
RVTGRT	rutgert
RVTJ	truitje
RVTJY	truitje
RVTRFRD	rutherford
RVT	root
RVT	root
RVT	root
RVT	root
RVT	root
RVT	root
RVT	root
RVTS	roots
RVTZ	ritz
RVVLVRY	revuluri
RVVTH	routh
RVVT	root
RVVT	root
RVYAH	riyadh
RVYAL	royal
RVYAPA	royappa
RVYBL	ruebel
RVYDN	reyden
RVYH	reich
RVYL	royle
RVYLY	royle
RVYMATA	roimata
RVYN	irvin
RVYN	irvin
RVYPK	roepke
RVY	rey
RVYS	roys
RVYS	roys
RVYS	roys
RVYTNBRG	roytenberg
RVYYZ	ruiz
RVYZ	ruiz
RVZMARY	rosemary
RVZMARY	rosemary
RVZNDAL	rosendale
RVZNFLDR	rosenfelder
RVZNJK	rosenjack
RVZN	verizon
RVZ	erez
RVZ	erez
RVZ	erez
RVZVLT	roosevelt
RVZY	roze
RVZYR	rozier
RVZYR	rozier
RVZYTA	rosita
RYAD	riyad
RYBAK	reback
RYBAR	ribar
RYBK	rubik
RYB	rob
RYBRN	rayburn
RYCARD	ricardo
RYCARDSN	richardson
RYCARDSVN	richardson
RYCAR	richar
RYCAV	richau
RYCMN	richmond
RYCMYR	richmeyer
RYC	royce
RYCR	raicer
RYCY	royce
RYCY	royce
RYDA	reda
RYDA	reda
RYDA	reda
RYDH	riyadh
RYDH	riyadh
RYDJ	ride
RYDKVYST	rydquist
RYDL	riedel
RYDNBRC	radenburch
RYDNBRGYRBRAK	radenburgerabroek
RYDN	ryden
RYD	red
RYDR	ryder
RYDYG	rudewig
RYDY	rudy
RYFKAYND	rifkind
RYGAN	oregan
RYGARD	regard
RYGLR	rigler
RYG	reg
RYGV	rego
RYGYNZ	reginae
RYHANA	rihana
RYHANH	rehan
RYHL	riehle
RYJKARD	rijkaard
RYJ	brij
RYJSVYJK	rijswijk
RYJSVYK	rijswijk
RYJYNZ	renze
RYKARD	rickard
RYKARD	rickard
RYKR	ricker
RYKRT	rickert
RYKSVN	eriksen
RYKTZ	reetz
RYKVLSVN	truelsen
RYKY	ryukyu
RYLND	roland
RYL	royle
RYLSBK	railsback
RYLY	riley
RYMANT	reymont
RYMND	raymond
RYMNZ	rimoni
RYM	rim
RYMRS	riemers
RYMVND	raymond
RYMVND	raymond
RYMVND	raymond
RYMVN	rymon
RYMYL	rymill
RYMY	remy
RYNAH	arunah
RYNALDA	reenalda
RYNALD	reynaldo
RYNALDS	reynaldos
RYNALDZ	reynaldo
RYNDNR	rindner
RYNDRT	reindert
RYNDRZ	rynders
RYNG	ring
RYNGST	ringuest
RYNGVVD	ringwood
RYNH	trinh
RYNKR	rinker
RYNLDA	reinolda
RYN	rooyen
RYN	rooyen
RYNR	renoir
RYNR	renoir
RYNRT	reinert
RYNTVL	rintoul
RYNVD	reinoud
RYNVLDA	reinolda
RYNVLD	reinold
RYNVLD	reinold
RYNVLDS	reynolds
RYNVLDSVN	reynoldson
RYNVLDZ	reinold
RYNVVD	reinoud
RYPL	ripley
RY	rey
RYRDAN	oriordan
RYRDAN	oriordan
RYRDN	riordon
RY	rey
RYRSVN	reierson
RYRZ	ruiz
RYSAH	rishah
RYSALVYRT	resolveert
RYSAR	rosaire
RYSAVY	rysavy
RYSJY	krisje
RYSKAR	rosaire
RYSLVRT	resolveert
RYSLYNG	rysling
RYSLY	risley
RYSNR	reisner
RYSNR	reisner
RYSNYK	resnick
RYSRC	research
RYS	roys
RYS	roys
RYS	roys
RYS	roys
RYS	roys
RYSR	reiser
RYSR	reiser
RYSTV	rostov
RYSTYNTJY	kristijntje
RYSTY	rusty
RYSVLVRT	resolveert
RYSVLVVRT	resolveert
RYSVR	reiser
RYSVYK	grosek
RYSY	royse
RYTAKV	rothko
RYTA	rita
RYTCY	ritchie
RYT	root
RYTSGRT	ritsgert
RYTVGR	rittweger
RYTYSGRT	ritsgert
RYTZGRT	rutgert
RYTZ	ritz
RYTZR	retzer
RYVARD	rivard
RYVBR	reuber
RYVDT	ruudt
RYVMLR	ruemmler
RYVNSVN	robinson
RYVNVLD	reinold
RYVPKA	riopka
RYVR	river
RYV	ryu
RYVRZ	revere
RYVV	rove
RYVYRH	roworth
RYVYS	roxys
RYYAD	riyad
RYYD	reed
RYYNKS	rienks
RYYR	river
RYZ	erez
RYZR	rozier
RYZVLVRT	resolveert
RYZV	rizvi
RYZVY	rizvi
RZBRY	ribeiro
RZNBAVM	rosenbaum
RZNFLD	rosenfeld
RZNKRANS	arizonians
RZNLF	rosenlof
RZNMN	eronen
RZNTJY	tryntje
RZVLVRT	resolveert
RZYNT	orient
SAARTJ	saartje
SABGLASYAL	subglacial
SABHANY	subhani
SABLT	sabot
SABRAMANYAM	subramaniam
SABRAMANYAN	subramanian
SAB	saab
SABTNS	sabines
SABT	sabot
SABVRYN	sabourin
SABVS	sabiks
SABYN	sabin
SABYNY	sabine
SACAT	shachat
SACK	isacq
SACR	isacq
SADGRV	sadgrove
SADHA	shadha
SADLR	sadler
SADRBLAM	soderblom
SADYAH	shadiyah
SADYH	shadiyah
SADYK	saddique
SADYKV	saddique
SADYKVYH	saddique
SADYKYV	saddique
SADYVP	sadie
SAFR	sawford
SAF	salfi
SAFT	safoutin
SAFTVR	sauter
SAFTYN	safoutin
SAGARS	sugars
SAGA	sagan
SAGAYY	sagady
SAGN	saigon
SAGRV	sadgrove
SAGRV	sadgrove
SAHASY	sahasi
SAH	isiah
SAHVLM	swahili
SAJN	saxon
SAJRV	sayre
SAKAMVTV	sakamoto
SAKARY	sakari
SAKAYV	sakaue
SAKLAD	saklad
SAKLA	saklad
SAKSNA	sakinah
SAKSNM	isakson
SAKS	saks
SAKS	saks
SAKSVN	isakson
SAKSYM	isakson
SAKTN	sackton
SAKT	saki
SAKYA	shakya
SAKY	saki
SALGA	salwa
SALGVRV	salgueiro
SALKRAS	valerias
SALK	salk
SALMVND	salmond
SALMY	salmi
SALTZMN	saltzman
SALTZ	savetz
SALVMN	salome
SALVM	salem
SALVMVN	salmond
SALYAN	salian
SALYGRAM	shaligram
SALYN	salween
SALY	saley
SALYT	salyut
SALYVAN	salian
SALZBRG	salzberg
SALZNBRG	salzenberg
SAMADAR	samaddar
SAMAH	samah
SAMAKR	samar
SAMAN	samoan
SAMANTA	samantha
SAMANTA	samantha
SAMAR	samar
SAMAS	samoas
SAMBAT	shambat
SAMBVLYK	sambolec
SAMGYN	saigon
SAMH	sameh
SAMK	samosky
SAML	samel
SAMN	samoan
SAMRAL	sumrall
SAMR	samir
SAMR	samir
SAMRZ	samir
SAM	sam
SAMS	sams
SAMTYNG	something
SAMVLS	samuels
SAMVN	samoan
SAMVSKY	samosky
SAMVYL	samuel
SAMYR	samir
SAMYT	samoset
SAMYT	samoset
SAMZ	semiz
SANAHAN	shanahan
SANANDV	sunando
SANA	sana
SANBRN	sansburn
SANCTY	sancheti
SANDAR	sundar
SANDHV	sandhu
SANDLYN	sandlin
SANDMAN	sandman
SANDRAM	sandra
SANDRM	sandra
SANDRNZ	sanderson
SANDRS	sanders
SANDRSVN	sanderson
SANDRZ	sandra
SANDRZ	sandra
SAND	sand
SANDYP	sandie
SANDY	sandy
SANGLD	sungold
SANG	sang
SANG	sang
SANGV	sang
SANJAY	sanjay
SANJH	santje
SANJSTR	sangster
SANKAR	sankara
SANKN	sunken
SANKR	shanker
SANKR	shanker
SANK	swank
SANK	swank
SANLA	scanlan
SANLY	stanley
SANNAR	sanner
SANRANG	sunrong
SANRAYZ	sandra
SANRJH	sannertje
SANRTH	sannertje
SANRTJY	sannertje
SANRT	sanskrit
SANSAYN	sawsan
SANSBRN	sansburn
SAN	san
SAN	san
SANSS	swanseas
SANST	sangster
SANSVN	swanson
SANTANA	santana
SANTA	santa
SANTH	sumanth
SANTJ	santje
SANTJY	santje
SANTRTJ	sannertje
SANT	saint
SANTSBRN	sansburn
SANTV	santo
SANTVS	santos
SANTVSY	santos
SANTYK	santee
SANTY	santo
SANVNDV	sunondo
SANVN	santini
SANV	sanov
SANYL	estanol
SANY	swany
SANY	swany
SANYT	saint
SANZBVRN	sansburn
SANZ	sanz
SAPRV	sapporo
SAP	saiph
SARANN	saranen
SARA	sara
SARATY	sarwate
SARDGNA	sardegna
SARDLV	shardlow
SARDV	sardo
SARJH	sarajevo
SARKNAS	sharknas
SARLVT	arlet
SARLY	searle
SARMA	sarma
SARNA	sarna
SAR	sare
SAR	sare
SARTAKSV	sarawaks
SARTH	earth
SARTJ	saartje
SARTJY	saartje
SART	sarto
SART	sarto
SARTZR	shartzer
SARVATH	sarathy
SARVK	sarawak
SARY	sare
SARYVL	sauriol
SASAKY	samosky
SASAN	sawsan
SASKA	suska
SASLAV	saslav
SASMN	salsman
SASNHYM	sassenheim
SASN	samson
SASTK	sustik
SASTYK	sustik
SASZH	sasze
SASZ	sasze
SASZY	sasze
SATFN	salton
SATFYN	saturn
SATJ	santje
SATKAS	osakas
SATN	satan
SATR	satur
SATR	satur
SAT	sat
SAT	sat
SATVN	salton
SATVN	salton
SATVR	satur
SATV	saito
SAVAN	sawan
SAVARAM	savaram
SAVARS	savarese
SAVCVK	sawchuk
SAVDY	sawdey
SAVFRD	sawford
SAVL	savel
SAVL	savel
SAVL	savel
SAVLZ	savetz
SAVNDRZ	saundra
SAVSAN	sawsan
SAV	soave
SAVTR	sauter
SAVTR	sauter
SAVTZ	savetz
SAVVY	savoy
SAVYN	savin
SAVYR	sawyer
SAYBRMYJ	sabre
SAYBRT	siebert
SAYDA	suwayda
SAYKS	sabiks
SAYKV	saki
SAYLR	sayer
SAYMKV	samosky
SAYM	salem
SAYMVN	samoan
SAYMVNS	samoans
SAYP	saiph
SAYRY	sayre
SAYTJ	saito
SAYT	saito
SAYTV	saito
SAYTZ	savetz
SAYVRYNGLNT	siuuirdingelant
SAYVYRDYNGLANT	siuuirdingelant
SAYVYR	savior
SAZH	swazi
SBASTYN	sebastian
SBASTYN	sebastian
SBAYN	sobhan
SBHAN	sobhan
SBRA	siberia
SBRT	osbert
SBRYANY	sebrianne
SBRY	sebree
SBS	sbs
SBYRAH	sabirah
SBYRA	siberia
SBYRH	sabirah
SBYSTN	sabiston
SBYT	sabot
SDAH	sadah
SDAH	sadah
SDA	seda
SDAY	sedai
SDGRV	sadgrove
SDHA	shadha
SDH	sindhi
SDLR	sidler
SDRHLM	cederholm
SDRVV	isidro
SD	sed
SDS	seds
SDVAL	sedvall
SDVR	seder
SDV	swede
SDYA	seda
SDYH	swedish
SDYK	sudoku
SDYRA	sadira
SFARD	seward
SFRD	sawford
SF	sufi
SFYLD	seinfeld
SGAL	segal
SGVRA	segura
SHA	shaw
SHRAB	sohrab
SHR	sehr
SH	seh
SHYB	shub
SKANL	skean
SKARP	skari
SKAR	sekar
SKLANY	saklani
SKMAN	ekman
SKRNTN	scranton
SKSNM	skene
SKSPYR	shakespeare
SKSTN	sistine
SKSTVN	sistine
SKT	eskite
SKVYRA	sequeira
SKYVRYTY	security
SLAMKY	slumkey
SLAMN	solomon
SLAR	solar
SLARYR	shearer
SLAT	slate
SLAY	slav
SLAYZ	slave
SLBRG	selberg
SLBRG	selberg
SLDN	sheldon
SLDVN	sheldon
SLF	salfi
SLFY	salfi
SLJ	seljuk
SLJ	seljuk
SLK	silk
SLMA	selma
SLMA	selma
SLMYDY	shelmidi
SLMY	slumkey
SLNY	slone
SLR	esler
SL	sol
SL	sol
SLT	slut
SLTH	seth
SLTJH	eeltje
SLTVN	salton
SLVA	silva
SLVD	selwood
SLVDVF	solodov
SLVN	slone
SLVN	slone
SLVVD	selwood
SLYJ	seelye
SLYMANYH	sulaymaniyah
SLYMA	sloma
SLYMH	salome
SLYM	slim
SLYM	slim
SLYNA	selena
SLYPRY	slippery
SLY	sly
SLYTR	silvester
SLYV	seelye
SMAH	samah
SMAL	ismael
SMALYAH	shamaliyah
SMALYH	shamaliyah
'SMAN	isman
SMAR	samar
SMAR	samar
SMA	soma
SMA	soma
SMAT	smart
SMBHV	shambhu
SMBLNKS	cymbelines
SMH	sameh
SMKVVN	smakovane
SMLY	somlyo
SMMA	samma
SMMR	simmer
SMPL	sample
SMPT	sept
SMRN	someren
SMR	semir
SMR	semir
SM	sm
SMSC	samec
SMSL	samsel
SMVTYVK	semotiuk
SMYAH	samiyah
SMYH	smythe
SMYLH	smyley
SMYM	simoom
SMYRAH	samirah
SMYRA	sumeria
SMYRA	sumeria
SMYRH	samirah
SMYR	semir
SMYR	semir
SMYR	semir
SMYS	smokeys
SMYTLY	smitley
SMYZ	semiz
SNAN	sinan
SNA	sena
SNA	sena
SNA	sena
SNDBRG	sandberg
SNDFVRD	sandford
SNDHYL	sendhil
SNDLYN	sundelin
SNDMN	sandman
SNDRS	sniders
SNDRZ	sindre
SND	sneed
SNDS	sands
SNDVYK	sandvik
SNDY	sandy
SNDZ	mendez
SNFNG	shenfeng
SNFTLYBN	senftleben
SNGAL	senegal
SNGLVGLV	cengeloglu
SNG	seng
SNG	seng
SNG	seng
SNGVPTA	sengupta
SNGVTA	sengupta
SNHAL	snehal
SNJH	santje
SNKYAT	shenkiat
SNNRTJ	sannertje
SNNY	sonny
SNQAN	sinan
SNR	eisner
SNSBRN	sansburn
SN	sn
SNTJ	santje
SNT	suneet
SNTYAGV	santiago
SNVRY	snorri
SNVTV	snotoa
SNYRJH	sannertje
SPARD	shepard
SPARNDAM	spaarndam
SPASTYN	sebastian
SPHR	sepehr
SPRD	shepard
SPRYNGR	springer
SP	sup
SPYNVAL	sepinwall
SPY	sepoy
SRAB	sorab
SRAFYN	serafin
SRASVL	rasul
SRATVZA	serratosa
SRAYNH	sorani
SRCAK	serchuk
SRDAR	sardar
SRHYR	serhir
SRJH	screech
SRKAMB	suriname
SRKAN	iroquoian
SRK	shrek
SRKS	shreks
SRKYAH	sharqiyah
SRKYH	sharqiyah
SRLD	sold
SRL	serel
SRLYNG	serling
SRLY	shirley
SRMAN	sherman
SRMN	sherman
SRPNT	serpent
SRQYH	screech
SRR	serre
SRR	serre
SR	sr
SR	sr
SR	sr
SRSTA	sarasota
'SRT	eisert
SRTRYD	shortreed
SRVADY	servadei
SRVARY	secretary
SRVMBC	sircombe
SRVVD	servideo
SRVYC	screech
SRVYDYV	servideo
SRVYS	servis
SRVY	survey
SRYA	surya
SRYF	sharif
SRYF	sharif
SRYNGTVN	sherrington
SRY	sore
SRY	sore
SRY	sore
SRYT	sprite
SRYVR	shriver
SSADRY	seshadri
SSANY	kissane
SSDRY	isidro
SSYL	wessel
STARLVZN	sturluson
STFANVS	stefanies
STHVRAJAN	sethurajan
STLAYN	stian
STLND	eastland
STLR	stoler
STL	steel
STMF	stampf
STNT	student
STRATVN	straton
STRYTR	streeter
ST	st
STVFL	stoffel
STVRAMAN	sethuraman
STV	steve
STYVNSVN	stevenson
SVAFVRD	swafford
SVAGATV	swagato
SVAMY	swamy
SVAMY	swamy
SVANK	swank
SVAN	sivan
SVAN	sivan
SVANYK	sevanick
SVANY	swany
SVARMN	swearman
SVART	swart
SVARYNGYN	swearingin
SVAS	sivas
SVA	siva
SVAYDA	suwayda
SVBHANDV	subhendu
SVBVTKA	sobotka
SVCAN	sercan
SVDAN	sudan
SVDAN	sudan
SVDARMV	sudarmo
SVDARSAN	sudarshan
SVDR	seder
SVDYP	sudip
SVDYPTV	sudipto
SVDYR	seder
SVDZ	suez
SVFN	sven
SVFR	suffer
SVFYH	sufi
SVFYLD	seinfeld
SVFY	sufi
SVGN	sogen
SVGRLF	sugarloaf
SVG	sega
SVHA	soha
SVHAS	suhas
SVHA	soha
SVHM	sohm
SVKK	sikkim
SVKLA	shukla
SVKVL	sokol
SVKVMAR	sukumar
SVLAR	solar
SVLAYMNYAH	sulaymaniyah
SVLDR	shoulder
SVLD	sold
SVLFVR	solovier
SVLK	silk
SVL	sol
SVL	sol
SVLTAN	sultan
SVLT	iselt
SVLTZ	shultz
SVLVMVN	solomon
SVLV	silvo
SVLVVY	silvey
SVLVYR	silver
SVLVY	silvey
SVLY	seely
SVLYS	solis
SVLYTAS	silvias
SVMA	soma
SVMASYKAR	somashekar
SVMJY	somjee
SVMN	simen
SVMR	semir
SVMRVYL	somerville
SVMVY	somvay
SVMYKR	seymour
SVNAR	sundar
SVNA	sena
SVNDARAM	sundaram
SVNDRZ	sindre
SVNGKRN	songkran
SVNGR	singer
SVNGRVALA	songerwala
SVNG	seng
SVNJA	sonja
SVN	sven
SVN	sven
SVN	sven
SVNSN	swensen
SVN	sven
SVNY	sony
SVNY	sony
SVPN	sopan
SVPRATYK	supratic
SVPRYV	supriyo
SVP	sup
SVRAB	sorab
SVRAB	sorab
SVRAJ	suraj
SVRANA	surana
SVRK	shrek
SVRL	serel
SVRNSN	sorensen
SVRN	severn
SVR	sevier
SVR	sevier
SVRS	severus
SVRSVN	severson
SVRTL	serel
SVRTN	shorten
SVRVALY	sorvali
SVRYNDR	surinder
SVRYN	severin
SVSAL	susalis
SVSA	sosa
SV	se
SVSH	swash
SV	se
SVSN	severson
SV	se
SV	se
SV	se
SVSYA	sisira
SVSYL	sushil
SVTAN	stan
SVTFN	seton
SVTN	seton
SVTR	suter
SVTR	suter
SVTS	sets
SVTV	seto
SVYAK	soyack
SVYDA	suwayda
SVYDH	swedish
SVYFT	swift
SVYLR	shuyler
SVYLR	shuyler
SVYNGLR	swingler
SVYNRTVN	swinnerton
SVYN	sven
SVYN	sven
SVYR	sevier
SVYTNKY	switenky
SVYTV	seytie
SVYYNK	soyinka
SVZALYS	seales
SVZANA	suzanne
SVZANH	suzanne
SVZA	souza
SVZ	sozo
SVZV	sozo
SVZY	suzy
SYANDRA	sandra
SYANG	siang
SYANG	siang
SYANV	siano
SYBACR	seebacher
SYBL	sybil
SYBL	sybil
SYBLT	sebolt
SYBLY	sibley
SYBRT	siebert
SYDA	seda
S'YDH	swedish
SYDLR	sidler
SYDLR	sidler
SYDMN	seedman
SYDNY	sydney
SYDR	seder
S'YD	said
SYD	sed
SYD	sed
SYDVR	seder
S'YDY	sawdey
SYFARD	seward
SYGL	siegl
SYGL	siegl
SYGLTVN	singleton
SYGMN	sigmon
SYGMN	sigmon
SYGMN	sigmon
SYGMVND	sigmund
SYG	synge
SYGS	segas
SYHAN	shan
SYHN	shen
SYHSVBHVN	sihsobhon
SYHY	soho
SYJH	sytje
SYJKV	siejko
SYJMN	sijmen
SYKAGV	sinkiang
SYKAR	sekar
SYKARV	sekar
SYKR	sieker
SYK	seki
SYKVLV	sokol
SYKVRA	sekora
SYKY	seki
SYLA	sela
SYLBRMAN	silberman
SYLBRMN	silberman
SYLDN	sheldon
SYLDZ	isolde
SYLK	silk
SYL	sol
SYLVAN	sylvan
SYLVA	sylvia
SYLVD	selwood
SYLVNN	silvonen
SYLVRBRG	silverberg
SYLVRMN	silverman
SYLVR	silver
SYLVRTVRN	silverthorne
SYLVRVD	silverwood
SYLV	sylvie
SYLVVD	selwood
SYLVYA	sylvia
SYLVYA	sylvia
SYLVY	silvey
SYLVYV	sylvie
SYLYG	seelig
SYLYMAN	suleiman
SYLYMN	solomon
SYLY	seely
SYLY	seely
SYLYT	slut
SYLZMN	solomon
SYLZ	soyuz
SYLZ	soyuz
SYMAL	somali
SYMARD	simard
SYMAYH	shimayah
SYMBAB	siembab
SYMLR	simler
SYMNDS	simonds
SYMN	simen
SYMN	simen
SYMN	simen
SYMN	simen
SYMN	simen
SYMNZ	semiz
SYMPLYSYTY	simplicity
SYMR	seymour
SYMR	seymour
SYMS	sims
SYMS	sims
SYMSYK	semotiuk
SYMVDYNZ	simodynes
SYMVNA	simona
SYMVNDS	simonds
SYMVNH	simone
SYMVNH	simone
SYMVN	simen
SYMVN	simen
SYMVNSN	simonson
SYMVNS	simons
SYMVNZ	simone
SYMVNZ	simone
SYMYNG	siming
SYMYNGTVN	symington
SYMYN	simen
SYMYN	simen
SYMZ	semiz
SYMZ	semiz
SYNA	sena
SYNAN	sinan
SYNA	sena
SYNAYN	seanain
SYNDLMN	sindelman
SYNDRH	sindre
SYNGLTVN	singleton
SYNG	synge
SYNK	sunk
SYNKLARY	sinclair
SYNKLAYR	sinclair
SYNKLR	sunker
SYNK	sunk
SYNR	senior
SYN	sen
SYN	sen
SYN	sen
SYN	sen
SYN	sen
SYN	sen
SYN	sen
SYNTYA	snotoa
SYNV	sune
SYNVY	seeney
SYNYBALDY	sinibaldi
SYNYG	synge
SYNY	sony
SYPL	seipel
SYPLVAYDN	schipluiden
SYPLVYDN	schipluiden
SYPLZ	seipel
SYPMN	shipman
SYPN	sopan
SYPRYANV	sipriano
SYP	sup
SYRAFYN	serafin
SYRAN	syrian
SYRANT	sierant
SYRA	syria
SYRAY	sporay
SYRCNT	searchnet
SYR	sir
SYRKVYS	sarkies
SYRL	serel
SYRLY	shirley
SYRR	serre
SYR	sir
SYR	sir
SYR	sir
SYRS	sires
SYRS	sires
SYRVKA	sirucka
SYRVN	soren
SYRVS	servis
SYRVYZ	suarez
SYRYF	smurf
SYRYL	serel
SYRYLV	serel
SYRYNG	siering
SYSABA	susana
SY	seiyu
SY	seiyu
SY	seiyu
SY	seiyu
SYSK	sisk
SYSLVNZ	mussolini
SYSLV	sislo
SYS	ses
SYSTMZ	systems
SYSZ	soyuz
SYTARAM	sitaram
SYTA	sita
SYTAY	sitao
SYTH	seth
SYTH	seth
SYTJ	sytje
SYTJY	sytje
SYTLAYV	sotilas
SYTLR	shetler
SYTRAH	sitrah
SYTRA	sitrah
SYTRH	sitrah
SYT	seytie
SYT	seytie
SYTS	sets
SYTV	seytie
SYTYA	scotia
SYTYH	seth
SYTY	seytie
SYTYZN	seton
SYTZ	seitz
SYTZ	seitz
SYVALD	seewald
SYVALV	sorvali
SYVA	siva
SYVAYRDYNGLNT	siuuirdingelant
SYVLA	sela
SYVL	esquivel
SYVMN	siemon
SYVNG	synge
SYVNKA	soyinka
SYVN	seven
SYVNYS	sweeneys
SYVRDYNGLNT	siuuirdingelant
SYVR	sevier
SYV	seiyu
SYV	seiyu
SYVSMNZ	sigismund
SYVVD	servideo
SYVYRDYNGLANT	siuuirdingelant
SYVY	seiyu
SYVY	seiyu
SYYVAYRDYNGLNT	siuuirdingelant
SYYVNYL	seminole
SYZNHYM	sondheim
SZARV	sare
TABVK	tabuk
TABYT	talbot
TAC	taco
TADR	qadir
TAD	tad
TAFT	taft
TAFTZ	taft
TAFVN	taffone
TAGLV	tagle
TAHARA	tahara
TAHRYHA	tahirah
TAHVN	tahoun
TAJH	taejon
TAKA	taka
TAKMN	tokman
TAKR	tasker
TAKSBRY	tatsuro
TAKV	taki
TAKY	taki
TALAN	italian
TALBRG	thalberg
TALBVYZ	talboys
TALKVT	talbot
TALMAYR	thallmayer
TALMN	talman
TALMY	talmy
TALN	stalin
TALNV	taine
TALS	italys
TALVANN	tolvanen
TALYBAH	talibah
TALYS	italys
TAMANA	tammana
TAMARA	tamara
TAMAS	tamas
TAMATYVS	tomatius
TAMAY	tamai
TAMBRVS	tombros
TAMB	tame
TAMPAS	tampas
TAMPKYNZ	tompkins
TAMSN	stimson
TAMSVN	stimson
TAM	tam
TAM	tam
TAM	tam
TAMYNZ	tammuz
TAMY	tame
TAMZ	tammuz
TANAK	tanak
TANA	tania
TANG	tang
TANG	tang
TANJS	tianjins
TANKN	tanneken
TANN	tanner
TANTVN	tanton
TANYS	tanis
TAPA	tampa
TAPLYN	taplin
TAPR	stamper
TAPSYN	tupshin
TAPTANY	taitano
TAPYK	tapio
TAPYN	taplin
TAPYV	tapio
TARA	tara
TARDL	tardell
TARKL	terkel
TARK	tariq
TARML	turmoil
TARN	stearn
TARQ	tariq
TARS	taurus
TARSVN	stewartson
TAR	tewari
TARVB	tarub
TARYK	tariq
TASDYLR	tasdeler
TASKR	tasker
TATAM	tattam
TATARY	tatari
TATBAY	tatby
TATH	strath
TATJ	taatje
TATL	tate
TATL	tate
TATRVY	taterway
TATSVRV	tatsuro
TAT	tat
TAT	tat
TAT	tat
TATYH	strath
TATYH	strath
TATYL	atul
TATZ	startz
TAVARS	tavares
TAVRNYNY	tavernini
TAVR	tafur
TAV	tai
TAYBVT	talbot
TAYJMN	taejon
TAYLBRY	taylor
TAYLMANS	tielemans
TAYLMNZ	talman
TAYLR	taylor
TAYLV	taylor
TAYMN	taiyuan
TAYNVR	traynor
TAYRAY	taterway
TAYR	taylor
TAYRVN	tavernini
TAYRY	tagore
TAYSN	taliesin
TAYSVN	taliesin
TAY	tay
TAYT	tat
TAY	tay
TAYTY	tahiti
TAYV	tay
TBT	tibet
TBVK	tabuk
TBYB	toby
TBYT	tibet
TDL	trudel
TFYLAH	tafilah
TFYLA	tafilah
T'FYLH	tafilah
TGLBRG	tegelberg
TGL	tuglu
THSYN	tahsin
TH	th
THYRAH	tahirah
THYRA	thoreau
THYRH	tahirah
TJAJH	tjaatje
TJATJ	tjaatje
TKS	rutks
TK	tooke
TK	tooke
TK	tooke
TKYAH	takiyah
TKYH	takiyah
TLANDR	thelander
TLBRT	talbert
TLBVYS	talboys
TLBVYZ	tilbury
TLFR	telfer
TLKVM	telecom
TLLV	tello
TLNT	tlingit
TLR	tyler
TL	tl
TLYBAH	talibah
TLYBA	talibah
TLYBH	talibah
TLYB	talib
TMBRY	tombros
TMPLMN	tempelman
TMPLR	templar
TMPLTVN	templeton
TMPST	tempest
TM	tm
TMYR	timor
TNANT	tennant
TNAYA	tenaya
TNBRVK	tenbrook
TNBV	tennebo
TNDYRY	tandiary
TNKN	tunen
TNPV	tenpo
TNTS	tontos
TNT	tent
TNVR	tener
TNVRYV	tenorio
TNYKN	tanneken
TNYSAN	tunisian
TNY	tiny
TPV	tupi
TQYH	teeth
TRADA	estrada
TRAFTVN	trafton
TRAFVRD	trafford
TRAH	torah
TRAJKTNSYS	traiectensis
TRAKV	iraqi
TRAN	tran
TRANYTSA	turnitsa
TRAP	trapp
TRAPYN	terrapin
TRASH	trash
TRASTR	traster
TRA	tra
TRAVAJLYA	travaglia
TRAVN	tran
TRAVZY	trauzzi
TRAYKTNSYS	traiectensis
TRAYNTH	strath
TRAYNTZ	tarantino
TRAYNVR	traynor
TRAYSTNSYS	traiectensis
TRAYSTNYS	eratosthenes
TRAYSY	travis
TRAZ	taraz
TRBRY	waterbury
TRD	torda
TRFVRD	waterford
TRLD	thurlede
TRLDY	thurlede
TRL	teruel
TRLV	triolo
TRMVYL	turmoil
TRMYNAL	terminal
TRNR	turner
TRNSH	trisha
TRNS	ternes
TRN	tern
TRNTN	trenton
TRNT	trent
TRNYK	ternyck
TRSA	teresa
TRS	teris
TRSTVN	threston
TRTJY	truitje
TRTJY	truitje
TRTNH	trinh
TRTVAN	trethowan
TRTVN	triton
TRVB	tarub
TRVBY	trubey
TRVDL	trudel
TRVDSVN	troedson
TRVF	turoff
TRVGTVN	troughton
TRVHYKV	teruhiko
TRVKS	turks
TRVL	teruel
TRVL	teruel
TRVLYNGR	trollinger
TRVMBV	trumbo
TRVMYTR	trometer
TRVN	trevino
TRVP	trump
TRVRAYS	terras
TRVR	trevor
TRVRYK	terrie
TRVRYS	trevors
TRV	tri
TRVTR	trotter
TRV	tri
TRVT	trout
TRVYLYGR	terwilliger
TRVYRYK	orourke
TRVYSDYL	truesdale
TRVYTH	truth
TRVYTJ	truitje
TRVYT	trout
TRVYYJH	truitje
TRYBL	tribble
TRYBL	tribble
TRYDVY	trudy
TRYGS	triggs
TRYJV	truitje
TRYK	tariq
TRYKTNSYS	traiectensis
TRYKT	trout
TRYMSTAR	trometer
TRYM	trim
TRYNDAD	trindade
TRYND	treindl
TRYNHAM	trainham
TRYNJH	tryntje
TRYNKL	trinkle
TRYNTH	toronto
TRYNTJ	tryntje
TRYNT	trent
TRYNVR	traynor
TRYPS	tripps
TRYQ	trio
TRYS	torys
TRYSTNSYS	traiectensis
TRYSTRM	tristram
TRYSY	torys
TRYSY	torys
TRY	tory
TRY	tory
TRY	tory
TRY	tory
TRYTL	tritle
TRYTL	tritle
TRYTVRY	territory
TRYVLV	triolo
TRYVRAYS	terras
TRYVR	trevor
TRYVYTZ	horowitz
TRZH	trinh
TSKR	tasker
TSLA	tesla
TSLR	tesler
TSNR	tessner
TSTA	testa
TS	ts
TSTR	tester
TSYMA	teshima
TSYNK	tesink
TTJY	toontje
TTRAD	tetrad
TTR	otter
TTRV	tetro
TTRVYN	tetervin
TVAMA	tuama
TVARY	tewari
TVAYCL	texaco
TVB	tobe
TVBVTYS	tubutis
TVBYAS	tobias
TVBYN	tobin
TVDAR	tudor
TVD	ted
TVFRY	tofferi
TVFTH	teeth
TVHLA	tuohela
TVKR	stoker
TVK	tooke
TVKYV	tokyo
TVLANY	tolani
TVLA	tula
TVLAY	tolani
TVLDV	toledo
TVLMN	tolman
TVL	tuli
TVLYN	toleno
TVLY	tooley
TVLY	tooley
TVLY	tooley
TVLYVR	tolliver
TVLYV	tulio
TVMANY	tomany
TVMAS	tomas
TVMAS	tomas
TVMATYVS	tomatius
TVMBLY	twombly
TVMS	tims
TVM	tim
TVMY	tomi
TVMY	tomi
TVMY	tomi
TVMYTYVS	tomatius
TVMZ	tomi
TVNAR	tonar
TVNGA	tonga
TVNG	ting
TVNG	ting
TVNG	ting
TVNJS	tonjes
TVNR	tener
TVNS	tonis
TVN	tin
TVNYS	tonis
TVNYS	tonis
TVNYS	tonis
TVNY	tiny
TVRAD	tetrad
TVRAMBR	turambar
TVRAYA	thurayya
TVRBR	thurber
TVRDA	torda
TVRKAT	turkey
TVRKV	turkey
TVRLDH	thurlede
TVRMALA	tormala
TVRMN	thurman
TVRNBRG	tornberg
TVRNLY	thornley
TVRNR	turner
TVRN	tern
TVRN	tern
TVRNTVN	thornton
TVRP	euterpe
TVRTL	turtle
TVRTN	turton
TVRTVN	turton
TVRVF	turoff
TVRVP	thorup
TVRYA	teresa
TVRYN	toren
TVRYSN	thoresen
TVRY	tory
TVRZ	tirza
TVSAR	tushar
TVSKANV	toscano
TVS	tis
TVSV	tuso
TVSYNG	tusing
TVSYNK	tesink
TV	ti
TV	ti
TVTY	tito
TVVYS	teeuwis
TVYDA	toyoda
TVYDY	tiede
TVYH	teeth
TVYN	teun
TVYT	tuyet
TVYT	tuyet
TVYYDYL	tweedale
TVYYG	teig
TVYYN	teun
TYBAT	tibet
TYBL	timbol
TYBVT	tibet
TYCAVR	tichauer
TYD	ted
TYF	toft
TYFVRD	tifford
TYGV	togo
TYHAN	tehan
'TYH	atish
TYJATH	teeth
TYJMN	tijmen
TYLBRY	tilbury
TYLDN	tilden
TYLGNR	tilgner
TYLMANS	tielemans
TYLMNS	tielemans
TYLMNZ	toleno
TYLN	toleno
TYLR	tyler
TYLR	tyler
TYLV	tuli
TYLVTSAN	tillotson
TYLYNG	teeling
TYMBVL	timbol
TYMKV	timko
TYMN	tymen
TYMN	tymen
TYM	tim
TYMVNYN	timonin
TYMVR	timor
TYMYAN	timian
TYMYNZ	tymen
TYMZ	tomi
TYNANT	tennant
TYNA	tina
TYNDAL	tyndale
TYNDAL	tyndale
TYNGLY	tingley
TYNG	tyng
TYNG	tyng
TYNSL	tinsel
TYNSLY	tinsley
TYN	tin
TYN	tin
TYN	tin
TYNY	tiny
TYPAL	tipul
TYPV	tupi
TYRNY	tyrone
TYRVKS	turks
TYRYH	teruhiko
TYRY	tory
TYRZA	tirza
TYSMNZ	tysmans
TYS	tys
TYSYNJR	tysinger
TYSZA	tisza
TY	ty
TYTAY	toyota
TYTH	teeth
TYTMAS	titmus
TYTS	tets
TYT	tuyet
TYT	tuyet
TYTY	tytie
TYVGA	tioga
TYVMYNN	tuominen
TYVNA	tina
TYVNYS	teunis
TYVNYS	teunis
TYV	tye
TYYVLN	teeling
TYZ	titz
VADAPARTY	vadaparty
VADH	riyadh
VADRY	vawdry
VADZN	vanduzen
VAFA	wafa
VAFYAH	wafiyyah
VAFYA	wafa
VAGL	eagle
VAGNR	vagner
VAGNR	vagner
VAGN	vaggen
VAH	wah
VAJDYK	vandyke
VAKFYLD	wakefield
VAKRDAYN	vardan
VAKVRN	vankeuren
VALANS	valerians
VALAS	valaries
VALDMANYVNA	waldmanneuenna
VALDMNNA	waldmanneuenna
VALDMNNYVYNA	waldmanneuenna
VALDMNYVNA	waldmanneuenna
VALDRAM	waldram
VALDV	waldo
VALDZ	valdez
VALH	walsh
VALKA	walka
VALKNAR	valkenaar
VALMN	walkman
VALNTYJN	valentijn
VALNTYN	valentin
VALN	avalon
VALRYN	valerian
VALTMN	waltman
VALTN	walton
VALTR	walter
VALTRZ	walter
VALTVN	walton
VALT	walt
VAL	val
VAL	val
VALVM	valium
VALVRT	walworth
VALVR	valur
VALV	vale
VALVYN	valvoline
VAL	val
VALYHVR	valihora
VALYNGTN	alington
VALYNGTVN	alington
VALYN	alwyn
VALYS	valois
VALYS	valois
VALY	vale
VALY	vale
VALY	vale
VALY	vale
VALYY	valley
VALZ	valdez
VAMBVL	amberle
VANANTVRP	vanantwerp
VANANVRP	vanantwerp
VANATVRP	vanantwerp
VANBRN	vanburen
VANBVRN	vanburen
VANDNBRQ	vandenburgh
VANDN	vanden
VANDRVYR	vanderveer
VANDRVYYR	vanderveer
VANDVSN	vandousen
VANDVZN	vanduzen
VANDYK	vandyke
VANDZN	vanduzen
VANDZVN	vanduzen
VANG	vang
VANK	yank
VANKVRN	vankeuren
VANKVRN	vankeuren
VANSCVNHVN	vanschoonhoven
VANSK	polanski
VANSKVNHVN	vanschoonhoven
VANSY	evans
VAN	van
VANVLK	vanvleck
VANVRANKN	vanvranken
VANVRNKN	vanvranken
VAN	van
VANZANT	vanzandt
VANZNDT	vanzandt
VARBRG	warborough
VARBRTVN	warburton
VARBRVG	warborough
VARBRVQ	warborough
VARBVRVG	warborough
VARBVRV	waterbury
VARDY	vardi
VARGAS	vargas
VARGV	vargo
VARMA	varma
VARNR	warner
VARNR	warner
VARNS	varnes
VARN	warn
VARN	warn
VARNY	varney
VARTVN	wharton
VARTY	varty
VARVL	varvel
VARYANS	aryans
VARYANTS	variants
VARYANTZ	variants
VARYVR	varieur
VASALV	vasallo
VASKY	waskey
VASLV	waslo
VASM	qasim
VASNGTN	washington
VASNGTVN	washington
VAST	east
VAST	east
VASVN	eason
VAS	evas
VAS	evas
VASYK	wasik
VASYM	qasim
VASYNGTVN	washington
VASYT	wasit
VATANAB	watanabe
VATANYB	watanabe
VATKYNZ	watkins
VATRHAVS	waterhouse
VATRMN	waterman
VATRSVN	watterson
VATRZ	beatriz
VATS	oates
VATV	vato
VAT	vato
VAVDRAY	audra
VAVDRY	vawdry
VAYA	vaya
VAYB	yacob
VAYBY	mawby
VAYDMN	caedmon
VAYD	ubaid
VAYGL	eagle
VAYLDR	vangelder
VAYL	vail
VAYMN	eamon
VAYNGRV	waingrow
VAYNTH	leavenworth
VAYN	vaun
VAYPKJ	wiepkje
VAYSMN	yasmine
VAYS	ayse
VAYTHAVS	hiawathas
VAYTHRN	hawthorne
VAYTHVRN	hawthorne
VAYTHVS	athos
VAYTVRS	waters
VAYTYKR	vaitkus
VAYTYKR	vaitkus
VAYZAK	ganzak
VAYZ	vaduz
VBR	ebro
VBSTR	webster
VB	vibe
VCNR	wechner
VDAD	widad
VDBRG	edberg
VDLMVDY	vadlamudi
VDLYN	wedelin
VDMYR	widmer
VD	ved
VFA	ufa
VFYAH	wafiyyah
VFYH	fish
VFYYH	wafiyyah
VGL	vogl
VGL	vogl
VGNR	wegner
VGNR	wegner
VHRA	vohra
VJDAN	wijdan
VJYHA	jehan
VJYHH	wajihah
VJYH	john
VKKYA	ilkka
VKRFAS	koreas
VKRV	kirov
VK	vik
VLADAK	vladack
VLADAN	vladan
VLADV	vlado
VLAM	elam
VLAN	ilan
VLA	vela
VLA	vela
VLDMN	veldman
VLDMNVNA	waldmanneuenna
VLDMN	veldman
VLDN	velden
VLD	veld
VLFSVN	wolfson
VLKMAN	volkman
VLK	volk
VLK	volk
VLMJH	elijah
VLMN	ilmin
VLMTH	duluth
VLMTJ	wellemtje
VLMT	wilmot
VLNTA	walenta
VLNTYJN	valentijn
VLNTYN	valentin
VLR	iler
VLSKY	wolski
VLS	viles
VLSY	wolsey
VLTMR	voltmer
VLTR	welter
VLTRYNG	woltering
VLTRY	velletri
VLTY	welty
VLVDYN	volodin
VLVSV	veloso
VLYDH	walidah
VLYNGTVN	elkington
VLYNK	olenek
VLYS	vilyuis
VLYS	vilyuis
VLZL	welzel
VLZ	volz
VLZ	volz
VNABLS	venables
VNANTVRP	vanantwerp
VNASCVNVN	vanschoonhoven
VNBRN	vanburen
VNBVRN	vanburen
VNCVNHVVN	vanschoonhoven
VNC	vince
VNDAZN	vanduzen
VNDLND	wendland
VNDL	wendel
VNDL	wendel
VNDMN	endymion
VNDRFVRD	vanderford
VNDRVR	vanderveer
VNDRVYR	vanderveer
VNDRY	endre
VNDVSN	vandousen
VNDVVSN	vandousen
VNDVZN	vanduzen
VNDVZN	vanduzen
VND	vinod
VNDYK	vandyke
VNDZL	wendzel
VNG	eng
VNHF	vanhoff
VNKATA	venkata
VNKAT	venkat
VNKRN	vankeuren
VNKRN	vankeuren
VNKVRN	vankeuren
VNKVRN	vankeuren
VNKV	vinko
VNKYVRN	vankeuren
VNKYVRN	vankeuren
VNLK	menelik
VNNTVRP	vanantwerp
VNRNKN	vanvranken
VNR	oner
VNRYPR	vanriper
VNSKVNHVVN	vanschoonhoven
VNSL	wensel
VNS	evens
VNSVNHAVN	vanschoonhoven
VNSVNHVVN	vanschoonhoven
VNTRLY	ventureli
VNTZ	weintz
VN	ven
VNVLK	menelik
VN	ven
VNVRANKN	vanvranken
VN	ven
VN	ven
VN	ven
VNYK	vonk
VNYLK	menelik
VNYNGR	weninger
VNYRNKN	vanvranken
VNZANDT	vanzandt
VNZANT	vanzandt
VNZND	vanzandt
VNZNT	vanzandt
VRBK	verbeck
VRBVRVF	yerbury
VRCYK	erick
VRDAN	vardan
VRHVST	verhulst
VRKMN	workman
VRLV	orly
VRLYND	verlinde
VRLYNG	worling
VRMASRN	vermaseren
VRMAS	ermas
VRMA	verma
VRMVLN	vermeulen
VRMVNT	vermont
VRMYLYYVN	vermillion
VRMYVLN	vermeulen
VRMZ	hormuz
VRNGRYN	wernegreen
VRNN	vernon
VRNR	werner
VRSVVN	iverson
VRVBL	wrobel
VRVJH	vrouwtje
VRVTH	irth
VRVVD	servideo
VRVVTJ	vrouwtje
VRVYJ	verweij
VRYLAV	wroclaw
VRYLV	curylo
VRYTY	verity
VRY	every
VSAL	wisal
VSLYAN	wesleyan
VSLY	wesley
VSLZ	volz
VSM	isom
VSTAL	vestal
VSTFAL	westfall
VSTLY	vestli
VSTLY	vestli
VSTMVRLND	westmoreland
VSTN	weston
VSTRHLM	westerholm
VSTRN	ostrin
VSTRVLDT	westerveldt
VSTRVLT	westerveldt
VSTR	ester
VST	vest
VSTVN	weston
VSTVR	westover
VST	vest
VST	vest
VS	vs
VSYM	isom
VSYT	vest
VSY	esq
VSY	esq
VTMVR	wetmore
VTR	vitor
VTR	vitor
VTS	vitos
VT	vito
VVDARD	woodard
VVDBRN	woodburn
VVDD	wooded
VVDGYT	woodgate
VVDHAVS	wodehouse
VVDN	weedon
VVDRV	widere
VVDVARD	woodward
VVD	ved
VVGLR	vogler
VVGL	vogl
VVG	vigo
VVJAK	vojak
VVK	vivek
VVLARD	woolard
VVLARD	woolard
VVLMN	wolman
VVLTRNYNG	woltering
VVLY	vilyui
VVLZ	volz
VVN	ven
VVN	ven
VVRDN	verdun
VVRYLAV	verlaine
VVRYLV	worrilow
VVS	vos
VVTR	vitor
VYANN	vianen
VYBH	vibe
VYBKH	rebekah
VYBRND	wijbrand
VYBVVV	wibowo
VYB	vibe
VYBY	oxby
VYCARD	picard
VYCVRA	victoria
VYDAD	widad
VYDAL	vidal
VYDAL	vidal
VYDA	veda
VYDD	wooded
VYDFANG	wildfong
VYDMAN	weidman
VYDMN	weidman
VYDMR	widmer
VYDRY	widere
VYDVN	weyden
VYD	ved
VYDYR	widere
VYDY	vidi
VYDYV	video
VYFAL	wifall
VYGAND	weigand
VYGAND	weigand
VYGJYN	vigen
VYGLY	wigley
VYGMVR	wigmore
VYGN	vigen
VYGRT	wegert
VYGSTVN	wigston
VYGTVN	wigton
VYG	vigo
VYGYNZ	eugene
VYJBRAND	wijbrand
VYJBRND	wijbrand
VYJDAN	wijdan
VYJNAND	wijnand
VYJND	wijnand
VYJNND	wijnand
VYJN	ijuin
VYKAMP	weikamp
VYKAS	vikas
VYKAVN	keaven
VYKFYLD	wakefield
VYKHAM	wickham
VYKLVND	wiklund
VYKNZ	kenz
VYKRAM	vikram
VYKRS	vickers
VYKRZ	krenz
VYKS	weeks
VYKS	weeks
VYKTVR	viktor
VYKTVR	viktor
VYKTYM	vitim
VYK	vik
VYK	vik
VYK	vik
VYK	vik
VYLADVT	viladot
VYLARD	woolard
VYLARD	woolard
VYLASKV	pulaski
VYLAS	vilas
VYLATZ	vulgate
VYLA	vela
VYLA	vela
VYLBR	welber
VYLDKAT	wildcat
VYLDRMN	wilderman
VYLDYNG	wilding
VYLFRD	wilford
VYLFRD	wilford
VYLHAYT	wilhite
VYLHLMAS	wilhelminas
VYLHLMVS	wilhelmus
VYLHLM	wilhelm
VYLJV	viljo
VYLKAKS	molokais
VYLKANS	volkswagens
VYLKAS	wilkes
VYLKNS	wilkens
VYLKN	wilken
VYLKRSVN	wilkerson
VYLKYNSN	wilkinson
VYLKYNSVN	wilkinson
VYLKYN	wilken
VYLKYNZ	wilken
VYLLMVS	wilhelmus
VYLMNTJY	willemintje
VYLMR	wilmer
VYLMTJY	wellemtje
VYLMT	wilmot
VYLMVR	wilmer
VYLMVT	wilmot
VYLMYNTH	wilmington
VYLMYNTJH	willemintje
VYLMYNTJ	willemintje
VYLMYNT	belmont
VYLMYNYTH	wyomingite
VYLND	verlinde
VYLND	verlinde
VYLNR	willner
VYLR	euler
VYLR	euler
VYLSVN	wilson
VYLS	eyles
VYL	wylie
VYL	wylie
VYL	wylie
VYLYAM	welam
VYLYAMYNA	williamina
VYLYANY	giuliani
VYLYNGHAM	willingham
VYLYNGZ	aveling
VYLYR	euler
VYLY	vilyui
VYLY	vilyui
VYLY	vilyui
VYLZ	volz
VYLZ	volz
VYMAL	vimal
VYMAN	eyman
VYMAN	eyman
VYMBRLY	wimberley
VYMN	yumn
VYMPH	rumph
VYMPJH	wimpje
VYMPJ	wimpje
VYMPJY	wimpje
VYMP	wimpje
VYMPYJ	wimpje
VYMR	ymir
VYNATA	vinata
VYNBRG	weinberg
VYNCSTR	winchester
VYNDN	hvinden
VYNDRZ	endre
VYNDVM	windom
VYND	vinod
VYNKLMAN	winkelmann
VYNKL	winkle
VYNKLZ	winkle
VYNKV	vinko
VYNLT	weinelt
VYNND	vinod
VYNN	wynn
VYNRT	weinert
VYNR	weiner
VYNSNT	quonset
VYNSN	vinson
VYNSR	winsor
VYNSTD	wainstead
VYNSTRVM	winstrom
VYNSTVK	weinstock
VYNSTVN	winston
VYNSVN	vinson
VYNTH	bouneth
VYNTJH	eyntje
VYNTJ	eyntje
VYNTJY	eyntje
VYNTRFYLD	winterfeld
VYNTRMYVT	wintermute
VYNTRR	winterer
VYNTR	winter
VYNTRZ	ventureli
VYNTVN	winton
VYNT	quint
VYNTZ	weintz
VYN	ven
VYNVKR	winokur
VYN	ven
VYNYBL	venable
VYNYKY	vinko
VYNYNGR	weninger
VYNYNGSTD	winningstad
VYNYZ	inez
VYNZ	winz
VYPKJH	wiepkje
VYPKJ	wiepkje
VYPKJY	wiepkje
VYPK	roepke
VYPYN	vipin
VYRAF	viraf
VYRCVAL	percival
VYRJYL	uriel
VYRJYNYA	virginia
VYRNDRA	virendra
VYRN	vern
VYRSMA	wiersma
VYRTANN	virtanen
VYRT	evert
VYR	eyre
VYR	eyre
VYR	eyre
VYRYANA	wiryana
VYRZ	verizon
VYSAL	wisal
VYSKA	suska
VYSL	eisele
VYSPY	vispi
VYSR	wiser
VYSR	wiser
VYSTFAL	westfall
VYSTVN	weston
VYST	vest
VYS	eyes
VYSVN	vision
VYSVN	vision
VYSY	oise
VYSYVS	vesuvius
VYTAKA	taka
VYTAKR	whitaker
VYTAL	vitale
VYTFYLD	whitfield
VYTKAMB	kamb
VYTKVS	vaitkus
VYTMR	wetmore
VYTMVR	wetmore
VYTNBRG	roytenberg
VYTN	oxton
VYTN	oxton
VYTSH	irtish
VYTSVN	whitson
VYT	vito
VYTVL	beutel
VYTVR	vitor
VYTVRYA	victoria
VYTV	vito
VYT	vito
VYT	vito
VYT	vito
VYTYKR	whiteaker
VYTYK	vitek
VYTYNGTVN	whittington
VYTZ	reetz
VYVA	viva
VY	ivy
VYVKS	weeks
VYVK	vivek
VYVLA	viola
VYVR	iyer
VYVVR	wiewer
VYVYANH	viviane
VYVYAN	vivian
VYVYK	vivek
VY	ivy
VY	ivy
VY	ivy
VYYRS	eeyores
VYZBRAND	wijbrand
VYZNAND	wijnand
VYZNRY	inzhenery
VYZN	vizen
VYZRNR	werner
VYZVN	vizen
VZDA	hvezda
VZYNA	vezina
XALDAH	walidah
XALYDH	walidah
XAN	ian
XAY	way
XLYDA	lydea
XLYDH	walidah
XLYLH	lylah
XRDL	riedel
YAGLA	yagla
YAGR	yager
YAKVB	yaqui
YAKVLTY	bakelite
YAKVTAH	yakootah
YAKVTA	yakootah
YAMAHA	yamaha
YAMAHA	yamaha
YAMHA	yamha
YAMN	eamon
YAMYNAH	yaminah
YAMYNA	yaminah
YANGR	waingrow
YANG	yang
YANGY	yangi
YANSVN	yanson
YANVVYTZ	yanowitz
YAN	yan
YANYV	yaniv
YANZK	yanzek
YAP	yap
YARGR	yerger
YARLA	iarla
YARMAN	yarman
YARVN	yaron
YARVS	yaros
YARYAN	yaryan
YASAR	yasar
YASR	yaser
YASYN	yasin
YASYRAH	yasirah
YASYRH	yasirah
YASY	ieyasu
YATS	yates
YAV	yaw
YAYN	wayne
YKVTAH	yakootah
YLND	eklund
YLYC	quilici
YLYF	elof
YMHA	yamha
YMN	yumn
YMYNH	vietminh
'YN	ayn
YRBRY	yerbury
YRMYS	vermes
YSRA	israt
YSRYH	yasirah
YSYRAH	yasirah
YSYRA	syria
YSYRH	yasirah
YTR	outer
YVBYRA	iberia
YVFYNGTVN	uffington
YVHANS	ohioans
YVKYLV	ukelo
YVK	yok
YVLYN	evelyn
YVMANS	youmans
YVMN	yumn
YVMVRA	uemura
YVNAL	uenal
YVNAS	yonas
YVNGSAP	yongsup
YVN	ion
YVNSVN	evenson
YVN	ion
YVNYZA	venezuela
YVRANYM	uranium
YVRBANYK	urbanik
YVRK	york
YVRMV	yermo
YVRYNA	verona
YVSF	yosef
YVSTN	yousten
YVS	yves
YVSYV	moiseyev
YVSY	youse
YVSY	youse
YVZF	yosef
YVZR	ezor
YYKA	yeka
YYK	yok
YYTZ	reetz
YYTZ	reetz
YZAK	yzaak
YZK	guzek
YZYD	izod
ZABL	zabel
ZABZ	zambezi
ZACARY	zachary
ZAFYNA	zafina
ZAGAR	zagar
ZAHD	zahid
ZAHYD	zahid
ZAKVB	zaki
ZAKVB	zaki
ZAKVMYNTAY	kuomintang
ZAKYVS	wakes
ZAK	zaki
ZAKY	zaki
ZALAN	zalan
ZAMVR	zamore
ZAMYT	zammit
ZANGRL	zangerl
ZAN	zane
ZANKH	zanneke
ZANKY	zanneke
ZANK	zanuck
ZANS	zanes
ZANT	iant
ZAPARA	zapara
ZARA	zara
ZARRYTN	zjarritjen
ZARVS	zaires
ZARYA	zaria
ZARYH	zafirah
ZARYTN	nazaretian
ZARYTZN	nazaretian
ZATRVVD	zoeterwoude
ZAYNAH	zaynah
ZAYNA	zaynah
ZAYRA	zaira
ZAYR	zaire
ZAZA	zaza
ZFRY	fry
ZFYNA	zafina
ZFYNH	finch
ZHRA	zahra
ZHRA	zahra
ZHRA	zahra
ZHYD	zahid
ZHYRAH	zahirah
ZHYRA	zahirah
ZHYRH	zahirah
ZJARYTJN	zjarritjen
ZJARYTN	zjarritjen
ZKH	zeke
ZKYAH	hezekiah
ZKYH	hezekiah
ZKY	zeke
ZK	zeke
ZK	zeke
ZLA	zola
ZLR	zeller
ZLTJ	eeltje
ZLYKAH	zedekiah
ZLYXA	zuleika
ZMANK	zemanek
ZMAN	zeman
ZMYRAN	zimmerman
ZMYT	emit
ZNG	zang
ZNK	zontek
ZNTNR	zentner
ZNYKH	zanneke
ZN	zn
ZPKA	zepka
ZRA	ezra
ZRYA	zaria
ZRYFA	zarifa
ZRYF	zarifa
ZRYH	erich
ZRYNK	zurink
ZRY	zr
ZVHANS	szechuans
ZVHANSN	johansen
ZVKA	zepka
ZVLD	zold
ZVL	zulu
ZVLMR	zolmer
ZVLY	zulu
ZVLYKA	zuleika
ZVNTK	zontek
ZVRYNK	zurink
ZVRYSYKA	szymborska
ZVTRVD	zoeterwoude
ZVTRVVD	zoeterwoude
ZVVAYTA	zuvieta
ZVVYTA	zuvieta
ZVYTA	zuvieta
ZVYTRVVD	zoeterwoude
ZVZF	izzo
ZYGMVNT	zygmunt
ZYLT	zoloft
ZYL	zyl
ZYMRAN	zimraan
ZYNAH	zaynah
ZYNA	ozuna
ZYNB	zainab
ZYNH	zaynah
ZYNSR	zinser
ZYRA	zaira
ZYRYLY	zirilli
ZYR	zeyer
ZYTV	zito
ZYVRYNK	zoerink
ZYVTRVD	zoeterwoude
ZYZY	izzo
ZZA	zaza
ZZ	izzo
