aactay	tay
aaltj	aaltje
aamyna	aamina
aarvn	aaron
aba	aba
abad	abad
abada	aba
abadhby	abad
abaja	aba
abar	aabar
abcr	abcher
abdja	a
abdlrhman	abdalrahman
abdvn	a
abh	a
abhay	abhay
abhy	abhay
abla	a
abl	abel
abl	abel
ablh	able
ablhyd	abad
ablj	able
ablt	able
abltj	able
ably	abley
ablysn	able
abnd	abend
abnr	abner
'abr	br
abr	ar
abraham	abraham
abrahym	abraham
abrahym	abraham
abram	abram
abramsvn	abrams
abrapt	abrupt
abrayt	abram
abrbac	ac
abrg	aberg
abrg	aberg
abrkrvmby	abby
abrl	abel
abrly	abby
abrmsky	sky
abrt	art
abrt	art
abrvtr	ar
abry	abery
abry	abery
abryn	bryn
abryny	abery
abstgartn	obstgarten
abst	pabst
abstrkt	abstract
abt	at
abtyn	ayn
abv	av
abvba	aba
abvdby	abby
abvdhaby	abby
abvhbyb	abiab
abvlyn	allyn
abvrymh	a
abvt	at
abvt	at
abvtsmyt	at
abya	a
abyab	abiab
aby	abby
aby	abby
abyad	abad
abyan	abyan
abyd	abad
aby	abby
abyl	abby
abylak	amlak
abyna	a
abyngm	abby
abyngn	abyan
acdl	ac
ac	ac
acr	ac
acrnar	achernar
acty	ac
actyh	ac
acy	ac
acyls	acs
acysvn	ac
acyt	ac
adab	adab
adam	adam
adamv	adam
adana	adana
adan	adan
adanl	adan
adara	ada
adb	adab
adbrg	ag
adgrynglnd	and
adgrynglnt	adit
adgyngtvn	ayn
adh	a
adkak	aka
adkk	adik
adkryk	adik
adkvk	adik
adkynz	a
adkyrk	ark
adla	a
'adl	fadl
adl	adel
adlardv	adar
adlayd	abad
adlayd	abad
adlhyd	abad
adlma	adalma
adl	adel
adlr	adler
adlsvn	adan
adly	addy
admvnd	and
admvnds	nds
admvndz	a
admvnz	a
admyraln	admiral
admyralz	admiral
admystvn	adan
adnams	adnams
adnamz	adnams
adnbrag	ag
adnbrg	ag
adnbrv	av
adnbrvg	ag
adnbvrg	ag
adry	badry
adry	badry
adryana	adana
adryan	aryan
adryans	aryans
adryn	ayn
adrynklnt	adit
adryns	adans
adryny	badry
adryny	badry
adrys	adas
adsal	al
adst	adit
adsvn	adan
adt	adit
advard	edvard
advard	edvard
advardsn	arden
advart	art
advlf	adolf
advlfsvn	adan
advlf	adolf
advncr	adar
advnl	advil
advnys	adas
advsvmaly	adalma
advvart	art
ady	addy
ady	addy
ady	addy
ady	addy
ady	addy
adyh	addy
adyk	addy
adyks	adas
'adyl	l
adyl	addy
adylrd	abad
adyna	dyna
adyngtvn	ayn
adyngtvn	ayn
adys	andys
adysak	adisak
adysvn	adan
adyt	addy
afa	afa
afaf	afaf
afra	afra
afrdyt	afaf
afrvdyt	afaf
aftab	aftab
afv	afaf
afvryl	afaf
afycart	art
afyf	afaf
afygtn	afaf
afyngtn	ayn
afys	afaf
afysr	afaf
afyvn	afaf
afzal	afzal
afzl	afzal
agaly	agali
agas	agass
agaty	agate
agbrn	ag
agbvrn	ag
ag	ag
aglstvn	ag
agmn	ag
agmvz	ag
agndy	andy
agnv	ag
agnvyk	ag
agpyan	abyan
agr	ag
agravala	agra
agrn	agren
agrtn	agren
agrtvn	agren
agrynglant	anant
agrynglnd	and
agvlv	ag
agvr	ag
agvstv	ag
agvstyn	ayn
agvstynly	ag
agvstyny	ag
agvyrv	ag
agvyv	ag
agyla	a
agyl	ag
agylsvn	ag
agynst	against
ahay	abhay
ahland	anand
ahman	ahmad
ahmn	mn
ahrn	ahern
ahy	a
ahyh	ayah
aj	a
ajast	ajax
ajay	ajay
ajda	a
ajlvs	avs
ajnt	aint
ajraynglnd	and
ajyngtvn	ayn
ajyntvn	ayn
aka	aka
ak	a
akadmy	aka
akadmyk	aka
akaks	aka
akapady	addy
akbrg	ag
akbvrn	akin
akdag	akdag
ak	a
akgan	akgun
akl	akl
akland	anand
aklnd	akl
aklvf	akl
akly	akl
akly	akl
akm	am
akman	akman
akmandnsys	akman
akmandsys	akman
akman	akman
akmna	amna
akmn	akman
akmr	akar
akmvndnsys	andys
akmy	amy
akn	akin
ak	a
akr	akar
akrm	arm
akrman	akman
akrmn	akron
akrsand	anand
akrslatv	at
akrslytv	av
akrstv	av
akrt	art
akrvyd	a
akryl	akl
aks	aksu
aksayl	akl
aksdlm	alm
aksfrd	aird
aksfvrd	aird
aksfvrd	aird
akskrytya	arya
akslsvn	akin
aksly	sly
akss	aksu
akstrnd	and
akstyn	ayn
aksv	aksu
aksyl	akl
akts	ats
aktvn	akin
aktvn	akin
akty	ty
aktyv	av
akval	al
akvayla	layla
akvayl	akl
akvdv	av
akvks	aksu
akvna	a
akvnr	akar
akvsta	a
aky	laky
aky	laky
akyf	a
akyhykv	av
akyla	a
akyla	a
akylah	akilah
akyl	akl
akyl	akl
akylh	a
akyls	als
akym	am
akyn	ayn
akytvmv	av
al'adyn	allyn
alahaydykya	ayala
alahdvd	ala
alaldyn	alaaldin
al	al
alam	am
alamz	ala
alana	alana
alangkv	alan
alapaty	alapati
alaqbh	ala
alard	allard
alasr	alar
alasvrs	alars
alavay	ala
alavy	ala
alayn	ayn
alaysdyr	alar
alays	ayalas
albahah	albahah
albha	alba
albhah	albahah
albljh	al
albr	alber
albrayt	al
albrt	albert
albrtyny	albany
albry	allbery
albryj	al
albvn	al
albvz	al
albyngr	alber
aldhayd	al
aldlhld	al
aldn	aldan
aldn	aldan
ald	al
aldr	alder
aldrd	aird
aldryc	ac
aldrydj	al
aldryg	ag
aldryg	ag
aldryj	al
aldryj	al
aldryj	al
aldryjh	aldrich
aldyn	aldan
aldz	al
alfa	a
alf	alf
alfansv	alans
alfarv	alfaro
alf	alf
alfrd	alford
alfrdv	alf
alfrs	alfors
alfryng	alf
alfvrd	alford
alfvrd	alford
algadv	algal
algard	algal
algayn	algal
algrv	algal
algsan	alan
algy	algal
algyngtvn	algal
alhdad	ada
alhdvd	al
alj	al
aljh	al
alkan	kalkan
alkbah	albahah
alkbr	al
alkbyr	al
alkk	al
alkmr	al
alkmrh	al
alkmry	al
alkr	al
alkrtn	al
alkrtvn	al
alks	als
alksandr	andr
alksandrvz	andr
alksndr	andr
alksy	al
alksyv	al
alkvab	abiab
alkvk	al
alkvr	al
alkyngtn	allyn
alkyngtvn	allyn
alkyntn	allyn
alladhkyah	allah
alladhykyah	allah
allahygyah	allah
alldhykyah	allah
alldykyah	allah
allhyqyh	all
alm	alm
almar	alar
almas	almas
almatvn	allman
almgrn	almgren
almkvast	alm
almkvyst	alm
almn	alm
almntaj	alm
almr	alm
almrs	alars
almrvt	alm
almvd	alm
almvdyvar	alar
almv	alm
almvman	allman
almvr	alm
almynakah	nahnah
almyntagah	almintaqah
almyntakah	almintaqah
almyntakva	alma
almyntkh	alm
almyral	al
aln	al
aln	al
alnd	and
alndr	andr
aln	al
alnvr	al
alny	al
alpn	alpen
alprt	alpert
alpvrt	alpert
al'qbh	al
alrbk	al
alrd	aird
alrtn	al
alrtvn	al
alrvy	al
alry	al
alrygh	al
alryj	al
alsandry	andr
alsan	alan
alsan	alan
alsap	als
alsap	als
alsap	als
alsndrv	als
alsn	als
alsn	als
alsnr	als
alsp	als
alsp	als
alspd	als
alsr	als
alstrvm	alm
alsvn	als
alsvn	als
alsvn	als
alsvp	als
alsvp	als
alsvrs	als
alsvrt	als
alsvz	als
alsy	als
alt	al
altanyn	alan
alt	al
altayr	alta
altman	altman
altmn	altman
altmn	altman
altrvayd	al
altrvd	al
altrvyd	al
altrvyyd	al
altsvn	alton
altv	al
altyr	al
altz	al
alva	alva
alvan	alan
alvarv	alva
alvarvs	alvaros
alvarz	alvarez
alvay	alva
alvf	alf
alvkal	al
alvk	al
alvld	al
alvrs	alars
alvsa	alva
alvvd	al
alvvd	al
alvy	al
alvy	al
alvyn	allyn
alvyn	allyn
alvyn	allyn
alvyn	allyn
alvyn	allyn
alvys	als
alvz	al
alxzna	a
'alya	alya
alya	alya
'aly	daly
a'ly	lyly
aly	al
alya	alya
alya	alya
a'lyah	ayah
alyah	alya
aly	al
aly	al
aly	al
alyan	alan
alyas	alya
alyasvn	alya
alyby	abby
aly	al
aly	al
alyfas	as
'alyh	h
alyj	al
alyks	als
alylyvnas	alanas
alyma	alma
al'yn	allyn
alyn	allyn
alyn	allyn
alyn	allyn
alyn	allyn
alyngr	allyn
alyngtvn	allyn
alyngtvn	allyn
alyn	allyn
alynyk	allyn
aly	al
alysa	alyssa
alys	als
alys	als
alys	als
alysn	alyson
alystvn	alyson
alystyr	al
alysvn	alyson
alysvn	alyson
alysvn	alyson
alysvn	alyson
alysya	alya
alyva	alva
alyvrya	alya
alyvt	al
alyvt	al
alyvy	al
alyya	alya
alyza	alya
alyzabt	allyz
alyz	allyz
alyzr	allyz
alz	al
alzna	alzena
alzn	al
alzvrs	alars
ama	ama
amadvr	amador
amagyv	ama
a'mal	al
amal	amal
amand	amand
amanval	amal
amanv	ama
amanvl	amal
amanvyl	amal
amany	many
amanyvl	amal
amara	amara
amaral	amaral
amardyv	ama
amarnt	amarit
amaryt	amarit
ambar	ar
ambasy	amy
amblr	ambler
ambrly	amy
ambrly	amy
ambrlyng	ag
ambrvss	ams
ambrvsvs	ams
ambrvsyv	am
ambrvsyvs	ams
ambvs	ams
ambyj	am
amdyv	am
amfn	am
amlak	amlak
aml	al
amlk	amlak
amln	am
amlya	alya
amna	amna
amn	amnon
amnvn	amnon
ampn	ampon
amprvr	apr
ampsvn	ampon
ampt	ampte
ampth	ampte
ampy	amy
amrald	amran
amr	am
amrjyng	ag
amrman	amerman
amrvsyv	am
amry	amery
amry	amery
amry	amery
amryka	a
amrykn	amran
amrykn	amran
amryta	a
ams	ams
amstat	amstadt
amstd	ams
amstr	amster
amsy	ams
amt	am
amtysta	a
amvna	amna
amvndsyz	am
amvrvsv	am
amvry	amery
amvs	ams
amy	amy
amy	amy
amyh	amy
amyhay	amy
amykvs	amys
amyly	amy
amyly	amy
amylyyv	amy
amyna	amna
amyna	amna
amynh	amy
amyra	myra
amyr	amy
amyr	amy
amyt	amy
amytava	amitava
amyt	amy
amyt	amy
amyvt	amy
amyvt	amy
amyzvta	a
anagram	anagram
anakyn	anakin
analvg	analog
ananda	ananda
anand	anand
an	ann
anansa	ana
anant	anant
anas	anas
anastasya	astana
anatvly	anatoly
anaty	anay
anay	anay
anaylyn	ayn
anayza	ana
anaz	ana
anaza	azana
anbar	anbar
anbr	anbar
anbv	anbu
ancy	dancy
andamz	andaman
and	anand
and	anand
andns	anshans
andra	andra
andr	andr
andr	andr
andrbrg	andr
andrbvrg	andr
andrby	andr
andr	andr
andr	andr
andrr	andr
andrs	andr
andrs	andr
andrsn	andean
andrsn	andean
andrsvn	andean
andrvs	andr
andrvz	andr
andrya	andra
andry	andr
andry	andr
andryas	andras
andrys	andys
andrys	andys
andrys	andys
andrysn	andean
andrysn	andean
andryvz	andr
andryya	andra
andryz	andr
andsvrs	anand
andsvrt	anand
andsvvrt	anand
andvlsn	andean
andysl	andys
andyyvrans	andys
anfant	anant
anfyld	anand
angbrtsn	angolan
angh	anghe
angland	langland
anglandr	andr
anglasma	asma
anglhard	alphard
anglhlm	alm
anglhvrn	anglican
anglnd	anand
angls	angels
angls	angels
anglsma	anglia
anglsvn	anglican
anglth	angle
angltj	angle
angltjh	angle
anglyna	ana
anglys	angles
anglz	angle
angrsvl	angel
angvlv	av
anh	a
anhld	anhold
anjbrtsvn	ann
anjl	al
anjljy	anay
anjls	als
anjlt	anant
anjltja	a
anjlv	av
anjlyna	ana
anjlys	andys
anjlysya	alya
anjy	anay
anjylyny	lyly
ankny	albany
ankr	anker
ankrly	anay
ankstad	anand
ankvrn	ann
anpyngkv	angkor
anq	a
anqh	a
anrah	ayah
anr	andr
anryk	a
anrykv	av
anrykyv	av
anrykyyvz	a
ansar	arkansans
anskamb	kamb
ansl	anshans
anslm	anselm
anslmv	anshans
ansly	ansley
anslyn	anshan
anspac	anspach
ansr	anshans
anstytv	anshans
ansy	anshans
ansy	anshans
ansyh	anshans
ansykr	anshans
antal	antal
antanaytys	anant
antaramyan	antaramian
ant	anant
anth	anant
antna	ana
antrapy	anant
antrv	anant
antrvsyv	anant
antrykyn	antwan
antstl	anant
antsytl	anant
antvn	antwan
antvn	antwan
antvn	antwan
antvnvglv	anant
antvnvvyc	anant
antvny	antony
antvny	antony
antvny	antony
antvnys	antonys
antvnys	antonys
antvnyv	anant
antvnyvs	antevs
antvs	antevs
anty	anant
antyla	antila
antypds	anant
antystl	anant
antystlh	anant
anv	av
anv	av
anvar	ar
anvcyn	ann
anv	av
anv	av
anvjyt	anant
anvkvl	al
anvn	ann
anvpam	am
anvp	a
anvr	andr
anvr	andr
anvr	andr
anvrs	anvers
anvs	avs
anvs	avs
anvtyyadys	andys
anvvy	anay
anyart	art
anyjma	a
anyl	al
anyl	al
anyl	al
anyma	a
anyng	ag
anysa	a
anys	albanys
anysh	anoosh
anystyn	ann
anyvrsry	albany
anyvs	avs
anyyv	av
anzalvny	albany
anzlvar	anzlovar
anzyngr	andr
apcrc	ac
ap	a
apl	al
apl	al
aplbay	ajay
aplbrg	ag
aplby	appleby
aplby	appleby
aplmn	aplin
aplnds	nds
aplyby	appleby
aplyby	appleby
aplyn	allyn
apndys	andys
aprayt	apr
aprly	apr
aprsvn	aprs
apryl	apr
apstn	a
apstvn	a
apstyn	ayn
apsylvn	sylvan
apvnth	th
apvrva	a
apydal	al
apystyn	ayn
aqbal	al
aram	am
arand	anand
aran	ararat
ararkh	ararat
aras	aras
aras	aras
arasmvs	aras
aray	ararat
arayz	ararat
arbanas	arbanas
arbr	ar
arbvr	ar
arbyd	ar
arby	araby
arbyl	arbil
arby	araby
arcal	al
arcalh	arch
arc	ac
arcard	aird
arcdaly	daly
arcdl	al
arcdyl	al
arcr	ar
arcybald	archibald
ardalyc	alyce
ardmn	arden
ardn	arden
ardrz	ar
ardys	andys
ar	ar
arfanakys	anas
arfvrd	aird
arfyvs	ars
argan	ann
argan	ann
argar	ar
arhard	erhard
arkard	ark
arkdyl	ark
arktyky	ark
arlayj	alar
arl	al
arl	al
arl	al
arlt	arlet
arly	carly
arlyj	ar
arlyndh	ar
arlyng	arling
armand	armand
arm	arm
armastrang	marmaras
armatv	armato
armny	arm
armry	arm
armsrvng	arm
armstrang	armstrong
armvntrvt	arm
armvr	ar
armyn	arm
armytaj	arm
armyt	arm
armytaz	arm
arn	ar
arnat	ararat
arnd	and
arndt	arendt
arnfyld	arnfield
arnh	ar
arnld	arnold
arnst	arnot
arnt	arnot
arnt	arnot
arnt	arnot
arnts	arts
arnvld	arnold
arnvt	arnot
arnvt	arnot
arp	ar
arpyn	arpin
ars	ars
arskat	ararat
arskayn	ayn
arsnalt	alars
arsy	ars
arsyd	ars
arsykr	ar
artl	art
artr	ar
artrs	ars
artrz	art
artvt	art
artys	arts
artyz	art
arval	al
arvma	a
arvn	ar
arvnacalam	arunachalam
arvnah	arunah
arvnd	and
arvnn	ann
arvrkh	ark
arvsn	ar
arvyng	ag
arvyvla	arvola
arya	arya
arya	arya
ary	ar
aryc	ac
aryfa	arya
aryj	ar
aryka	arya
aryka	arya
aryk	ark
aryk	ark
aryksn	aryan
aryksvn	aryan
aryksvn	aryan
aryksvn	aryan
aryn	aryan
aryngtn	aryan
arys	ars
arys	ars
arys	ars
arystvtl	al
aryz	ar
aryz	ar
arzat	ararat
arz	ar
asakvl	akl
asbl	al
asbrn	as
asbrynk	asbrink
asbvrn	as
ascafyld	afaf
ascagn	ag
ascrvvyc	ac
ascvfyld	as
ascvylar	alar
ascyplvdn	as
ascyplvydn	as
ascypn	as
asds	as
asfar	ar
asfyld	as
asgvryan	aryan
askadz	alaskas
askagn	alaskan
askahan	skahan
askajn	alaskan
askalant	alaskan
askal	alaskas
askalyk	alaskas
askaly	alaskas
askanl	askanas
askanyl	askanas
askarp	karp
askars	alaskas
askartsys	arts
askary	alaskas
ask	ask
askatv	alaskas
askatya	alaska
askaty	kasaty
askavn	alaskan
askaya	skaya
askaylr	alaskas
askay	alaskas
askayt	alaskas
askldsvn	ask
askltn	ask
askltvn	ask
asklvyr	ask
asknl	ask
askns	as
askp	ask
askrab	arab
askrantvn	antwan
askrayz	ask
askrntn	ask
askrntvn	ask
askrvyc	ask
askryblyng	ask
askrybnr	ask
askryc	ask
askry	ask
askrys	as
askryv	ask
askvayrl	ask
askvayr	ask
askvfyld	ask
askvgan	alaskan
askvly	ask
askvlyng	ask
askvlyn	allyn
askvly	ask
askvlyz	allyz
askv	ask
askvrr	ask
askv	ask
askvtvny	ask
askvylr	ask
askvyvyl	ask
askyba	a
askyls	as
askynr	ask
askyn	ask
askyn	ask
askypladn	alaskan
askyplvydn	ask
askypn	ask
askyp	ask
askypy	ask
askyrs	as
asky	ask
askytr	ask
aslankard	slankard
aslan	alan
aslan	alan
aslan	alan
aslatkyn	atlas
aslatkyn	atlas
aslatr	atlas
aslatry	atlas
aslatvbr	atlas
aslavk	ask
aslavmyz	as
aslavnbrg	ag
aslavyn	ayn
aslayk	ask
aslbvtnn	ann
asld	as
aslmn	as
aslngzvald	al
aslp	as
aslr	ar
asls	as
aslsyng	ag
asltn	as
asltr	ar
aslvan	ann
aslvkam	am
aslvka	a
aslvmn	as
aslvn	as
aslvn	as
aslvp	as
asly	sly
aslygrz	as
aslyman	ayman
aslyny	sly
aslypr	apr
aslyp	as
aslyty	sly
aslyvpas	as
aslyv	as
asma	asma
asmadj	asma
asmal	al
asmaly	asma
asmart	art
asmayt	asma
asmdly	as
asmln	as
asmvky	as
asmvlyk	ask
asmvlyn	allyn
asmvr	ar
asmvt	as
asmyd	as
asmykla	asma
asmyl	al
asmyly	lyly
asmyrnv	as
asmyt	as
asmytsvn	as
asmytvyk	ask
asmytz	as
asmytz	as
asnag	ag
asnaydr	anas
asndn	as
asnl	al
asnl	al
asnlyng	ag
asnr	ar
asnvdn	as
asnvfyld	as
asnvgrs	as
asnv	as
asnyd	as
asnyl	al
asnysl	al
aspanglr	spangler
aspardam	adam
asparks	sparks
asparndam	spaarndam
aspar	ar
asparv	ar
asparza	esparza
aspatafvra	spatafora
aspat	at
aspatsvvd	ats
aspatz	spatz
aspavldyng	ag
aspaydr	andr
aspaydrz	as
aspayk	ask
aspayks	as
aspaynyng	ayn
aspayrz	as
aspayz	as
asplmn	aspen
asplyd	as
asplyntr	ar
aspnsr	ar
aspns	as
asprag	sprag
aspr	apr
asprvt	as
asprybry	as
aspry	as
aspvlaryc	ac
aspvlaryx	alar
aspvr	ar
aspvry	as
aspvsta	astana
aspvsytv	as
aspvtys	as
aspydn	aspen
aspylmn	aspen
aspynak	ask
aspyndryft	andr
aspyn	aspen
aspyras	aras
aspyr	ar
aspyr	ar
aspyrv	as
aspyrv	as
aspyryng	ag
aspyrz	as
aspyrz	as
aspysak	ask
aspysyk	ask
aspyt	as
aspytzr	ar
aspyvak	ask
aspzytv	as
asrat	ararat
asrayyl	al
asrmn	as
astabrt	art
astabz	astanas
astad	asaad
astad	asaad
astafl	astanas
astafvrd	astanas
astag	ag
astajanv	astanas
astakmn	akman
astakr	astanas
astakslajr	astanas
astaks	astanas
astaky	astanas
astaky	astanas
astalkh	astanas
astampr	apr
astam	am
astangyr	astanas
astanvl	astanas
astaplyc	astanas
astarbak	barbaras
astargs	astanas
astargyl	argyle
astark	ark
astarkyp	ark
astarky	ark
astar	ar
astar	ar
astartld	astarte
astart	art
astartz	startz
astaryngr	ar
astarz	astanas
astas	astanas
astatm	astanas
astatrz	astanas
astatzmn	astanas
astaylz	astanas
astaynls	astanas
astaynmn	ayn
astayn	ayn
astayr	astanas
astbay	ajay
astcnyk	ask
astdlr	aster
astdmn	aston
astdyna	astana
astfans	anshans
astfan	ann
astfan	ann
astfanvs	astanas
astfanv	astanas
astfanz	astanas
astfn	aston
astfnsvn	aston
astgn	aston
astk	ask
astlr	aster
astly	astley
astlyk	ask
astly	astley
astnfrd	aird
astnfvrd	aird
astnfvrt	art
astnkamb	kamb
astnsl	al
astnsrad	asaad
astn	aston
astntjy	as
astpkn	aston
astpk	ask
astrabryj	abram
astradr	aster
astrakmn	astrakhan
astrak	amtrak
astrandr	andr
astrap	trapp
astr	aster
astrasym	atram
astravb	arab
astrlyng	ag
astrmlr	aster
astrn	aston
astrnd	astrid
astrn	aston
astrvk	ask
astrvm	am
astrvs	as
astrvstrap	trapp
astryan	aryan
astrybl	al
astryd	astrid
astrydm	strydom
astrydr	aster
astrym	am
astryn	aston
astryngr	aster
astrynjr	aster
astryn	aston
astryny	as
astryr	aster
astry	as
astryty	as
asts	as
astvard	asgard
astvart	art
astvbryj	as
astvdvla	a
astvfl	al
astvklas	as
astvk	ask
astvk	ask
astvkvl	al
astvky	as
astvlk	ask
astvlr	aster
astvl	al
astvn	aston
astvnbrayj	aras
astvnsn	aston
astvn	aston
astvn	aston
astvr	aster
astvrga	a
astvrlyr	aster
astvrmz	as
astvrr	aster
astvrym	am
astvry	as
astvry	as
astv	as
astvval	al
astvy	as
astyansn	anshan
astybl	al
astybr	aster
astyd	as
astygbrg	ag
astygmn	aston
astygrs	as
astyg	ag
astyjh	as
astyk	ask
astyklmn	aston
astylr	aster
astyl	al
astyl	al
astyl	al
astyly	lyly
astylz	as
astyn	aston
astynbrg	ag
astynsn	aston
astyn	aston
astyn	aston
astynsvn	aston
astynth	as
astyntjh	as
astyntj	as
astynz	as
astyplz	as
astyp	as
astyrn	aston
astyrnz	as
astysy	as
astysy	as
astyt	as
astyvdnt	aint
astyvn	aston
astyvnsvn	aston
astyvs	as
astyvz	as
asvalap	aswalap
asvald	al
asvanay	anay
asvk	ask
asvlt	as
asvrs	as
asvsky	ask
asvysr	ar
asya	a
asy	as
'asyf	f
asyf	as
asymylyt	as
atansyv	anshans
ata	a
ata	a
ataras	ataras
ath	at
atjh	at
atka	atka
atkynsn	ayn
atkynsvn	ayn
atkynz	at
atkynz	at
atl	al
atls	als
atmsfr	ar
atmz	at
at	at
atram	atram
atr	ar
atrtn	at
atry	at
atrysps	ats
atrz	at
attly	at
atv	at
atvatr	ar
atvd	at
atv	at
atvl	al
atvl	al
atv	at
atv	at
atvsan	ann
atvs	ats
atvsy	at
atvvd	at
atvvl	al
atvyl	al
atya	a
aty	almaty
atyg	ag
atylrd	aird
atylrdh	at
atylyv	at
atyngr	ar
atyny	almaty
atynzvn	ayn
atys	almatys
atyvl	al
atyya	a
avaca	ava
avad	ava
avadya	ava
avald	ava
avan	ann
avanz	ava
avasty	avas
avbaja	a
avbrayan	bran
avbrdvrfr	ar
avbrhvlz	av
avbrhym	am
avbr	ar
avbrtas	as
avbry	avery
avbry	avery
avbyd	av
avbyngm	am
avcard	aird
avcar	ar
avclnd	and
avcz	av
avddy	addy
avdkryk	av
avdkyrk	ark
avdl	al
avdly	av
avdra	a
avdrgv	av
avdvak	ava
avdvn	av
avdv	av
avdyvm	am
avfnr	ar
avfyngtvn	ayn
avgar	ar
avgbvrn	av
avglt	at
avgnh	av
avgnyv	av
avgvr	ar
avgvry	avery
avgvst	avs
avgvstv	av
avgvstyn	avs
avgynh	av
avhalvran	alan
avhrmn	av
avjn	av
avklnd	and
avkly	av
avkr	ar
avkrayn	ayn
avkr	ar
avksly	sly
avkstvn	av
avksvl	al
avkt	at
avkts	ats
avktz	av
avkynz	av
avkyts	ats
avlafsvn	afaf
avla	a
avl	al
avlayvvla	a
avld	auld
avldkvrn	av
avldrayt	ararat
avldryj	av
avldz	av
avlmn	av
avl	al
avlsn	av
avlsn	av
avlsvn	av
avlsvn	av
avlvstad	avs
avlyma	a
avlyng	ag
avly	av
avly	av
avlyvyh	av
avlyvyr	ar
avmaky	av
avmbrgr	ar
avmga	a
avmlas	as
avmr	ar
avnat	at
avn	av
avnayza	a
avnayz	anay
avnglysta	avesta
avng	ag
avnsty	av
avnsvn	av
avnvskv	av
avnyl	al
avnyl	al
avnz	av
avqvaq	ava
avraham	avraham
avram	avram
avrayl	avram
avrays	avram
avrayz	avram
avrayz	avram
avrbn	av
avrcard	aird
avrdaln	aldan
avrfyvs	avs
avrgan	ann
avrhan	anshan
avrhan	anshan
avrhart	art
avrhrt	art
avrhv	av
avrklyvn	av
avrkny	av
avrlandv	av
avrl	al
avrlynz	av
avrma	a
avrm	arm
avrmspvrdn	av
avrn	av
avrnvpn	av
avr	ar
avrsbrg	ag
avrslr	ar
avrts	arts
avrtyz	av
avrvm	avram
avrv	av
avrvyl	al
avry	avery
avryga	a
avryk	av
avryl	al
avryl	al
avrynts	ats
avrys	averys
avrys	averys
avrys	averys
avry	avery
avryvly	avery
avryvn	av
avryvrdan	adan
avryz	av
avsal	al
avsbvrn	avs
avsbvrn	avs
avslandr	andr
avslyna	a
avsn	avs
avsn	avs
avsnz	avs
avstbann	ann
avsthamarn	austhamaren
avstlyc	avs
avstndvrp	avs
avstrandr	andr
avstrndr	andr
avstvlyn	allyn
avstvryn	avs
avstyn	avs
avsyvn	avs
avsyz	avs
avtagvrv	av
avta	a
avth	av
avtjh	av
avtj	av
avtlv	av
avtlv	av
avt	at
avt	at
avtry	avery
avtvlyny	av
avtv	av
avtys	avs
avvlyv	av
avvrdal	al
avvrpk	av
avyan	abyan
avyars	ars
avycay	ajay
avyk	av
avynas	anas
avyng	ag
avynz	av
avyrsa	aversa
avys	avs
avysna	a
avyva	ava
avyvn	av
avzbrn	av
avzgvr	ar
avzmn	av
avzvnys	avs
ayala	ayala
aybac	ac
aybar	ar
aybl	al
aybyrvnk	a
aycas	as
aycbvrn	ayn
aycyrv	av
ayda	ayda
ayda	ayda
aydan	adan
aydmn	ayn
aydnbvrg	ag
ayd	ayda
ayds	as
aydvaysvz	ayda
aydvry	ajay
aydyd	ayda
aydy	addy
ay	ajay
ayf	a
ayfjh	ayah
ayfj	a
ayfvfl	al
ayfv	av
aygan	ann
ayglastvn	aston
ayglstvn	ayn
ayglv	av
aygly	ajay
aygrt	art
aygrtvn	ayn
aygv	av
aygvr	ar
ayjh	ayah
ayjlstvn	ayn
ayjvyn	ayn
ayk	a
aykam	am
aykarvs	ars
aykbrn	ayn
aykbvrn	ayn
aykh	ayah
ayklvzan	ann
aykn	ayn
aykvk	a
aylana	alana
aylan	alan
aylka	a
aylmyn	ayn
aylpv	av
aylr	aylor
aylsa	a
aylth	ayah
aylvard	aylward
aylvr	aylor
aylvt	at
aylvt	at
aylvyza	a
aylya	alya
aylydyv	av
aylyn	ayn
aylyn	ayn
aylyn	ayn
aylyng	ayling
aylyn	ayn
aylys	amways
aylys	amways
aylz	a
aym	am
ayman	ayman
ayman	ayman
aymantz	ayman
aymar	ar
'aymn	lymn
aymn	ayman
aymn	ayman
aymry	ajay
aymvn	ayman
aymy	amy
aynac	ac
ayn	ayn
ayna	a
aynana	ana
aynan	ayn
aynarynv	ayn
aynat	at
ayn	ayn
aynayn	ayn
aync	ayn
ayndalys	lyndas
ayndayrsn	ayn
ayndra	andra
ayndrajyt	andra
ayndranyl	andra
ayndrly	ayn
ayndsvrs	ars
ayndvy	ayn
ayngalz	algal
ayng	ayn
ayng	ayn
ayng	ayn
ayngld	ayn
aynglf	alf
ayngl	ayn
ayngls	als
aynglys	ayn
aynglys	ayn
ayngmar	ar
ayngmar	ar
ayngraham	graham
ayngram	am
ayngrm	arm
ayngrsvl	ayn
ayngrya	arya
ayngryd	ayn
ayngrysl	ayn
ayngrysvl	ayn
ayngvar	ar
ayngyjd	ayn
aynhv	ayn
aynjh	ayn
aynjjnry	ayn
aynkh	ayn
aynkvgnyta	a
aynly	ayn
aynmn	ayn
aynr	ayn
ayns	ayn
ayns	ayn
aynsr	ayn
aynt	ayn
ayntayr	ayn
aynt	ayn
aynth	ayn
ayntj	ayn
ayntjh	ayn
ayntlsat	at
ayntrnt	ayn
ayntrnt	ayn
aynvksn	ayn
aynvn	ayn
aynvsnt	ayn
aynysa	a
aynz	ayn
aynzhnry	ayn
aynz	ayn
aynz	ayn
ayprsvn	ayn
ayprt	art
ayr	ar
ayrardy	ararat
ayray	airay
ayrbyd	ayda
ayrd	aird
ayrdv	av
ayr	ar
ayr	ar
ayrlaynz	ayn
ayrl	al
ayrlnd	and
ayrnst	ernst
ayrnvt	at
ayrp	a
ayrs	ars
ayrvn	ayn
ayrvn	ayn
ayrvnsvn	ayn
ayrvvd	a
ayrvyng	ayn
ayrvyn	ayn
ayrvyn	ayn
ayrvyyn	ayn
ayry	ajay
ayryk	a
ayrys	ayres
ayryzary	ajay
ayrz	a
'aysa	magsaysays
aysa	a
'aysa	magsaysays
aysa	a
ays	amways
aysa	a
aysak	adisak
aysak	adisak
aysaks	magsaysays
aysama	ama
aysan	maysan
aysask	ask
aysbl	al
aysfalz	al
'aysh	ayush
aysh	ayush
'aysh	ayush
aysh	ayush
ays	amways
ayskandr	andr
aysk	ask
ayslt	at
ayslyk	ayse
aysman	ayman
aysmn	ayn
aysnstat	at
ayspvrt	art
aysrat	ararat
aysrt	art
aysrt	art
aystbrn	ayn
aystlnd	and
aystmas	as
aystmn	ayn
aystmvs	avs
aystragv	stray
aystrbrvk	ayse
aystr	ar
aystr	ar
aystvvd	ayse
aystvy	ajay
aystyk	ayse
aystyn	ayn
aysvn	ayn
aysvn	ayn
aysy	ajay
aysyzaky	ajay
ayt	at
ayt	at
aytamar	ar
aytcv	av
aytcvn	ayn
ayth	ayah
ayth	ayah
aytj	a
aytj	a
aytjy	ajay
aytkn	ayn
aytr	ar
aytsn	ayn
ayva	a
ayvald	al
ayvanz	anay
ayvar	ar
ayvayng	ayn
ayvgnh	ayah
ayv	av
ayvjnh	ayah
ayvlyn	ayn
ayvnd	and
ayvns	anns
ayvrs	ars
ayvrsvn	ayn
ayvry	ajay
ayvs	avs
ayvs	avs
ayvstys	avs
ayvsv	av
ayvsyn	ayn
ayvtyk	a
ayvyn	ayn
ayzak	yzaak
ayzaksvn	ayn
ayzcyl	al
ayzdy	addy
ayz	a
ayzl	al
ayzmn	ayn
ayzrvda	ayda
ayzv	av
azad	azad
azalya	alya
azaly	al
azana	azana
azar	ar
azbvrn	rn
azcyl	al
azhr	azhar
azla	a
azln	azlan
azr	ar
azvr	ar
azycl	al
baabar	baabar
baafj	ba
baba	baba
baba	baba
babah	babah
babar	babar
babar	babar
bab	baba
bab	baba
bab	baba
babk	babak
babk	babak
babl	baba
babr	babar
babt	baba
babv	baba
babvrav	baba
babvskyn	baba
baby	baba
baby	baba
baby	baba
babykv	baba
babyrl	baba
babytz	baba
bacaltr	bacar
bacarac	bacar
bacas	bas
bac	ac
bacldr	badr
bad	abad
bad	abad
badkk	babak
badkvk	babak
badlvc	ba
badmn	baden
badnyk	babak
badr	badr
badrmn	badr
badryk	badry
badvyn	baden
badvyyn	baden
bady	badry
badyg	ba
badyn	baden
badyn	baden
badyngtn	baden
badyngtvn	baden
badyvn	baden
badz	ba
badzyak	babak
bafl	ba
bafy	ba
bafy	ba
baga	bagga
bagam	bagga
bagarly	baggarly
bagay	bagga
bagdan	banan
bagham	baugham
bagly	bagley
bagly	bagley
bagm	ba
bagsav	av
bagvly	bally
bagyd	ba
bagz	ba
bagz	ba
bahyh	babah
bajva	ba
bajyk	babak
bakar	babar
bakas	bas
bakaya	bakaya
bakly	babak
baknr	babak
bakr	babak
bakr	babak
bakska	ba
baksr	babak
baksy	babak
bakvm	babak
bakvs	babak
baky	babak
bakyr	babak
balak	babak
balandr	andr
balans	alans
balard	ballard
balary	barbary
balas	bas
balast	ballast
bal	baal
bal	baal
balbyr	balbir
balcvnas	balchunas
bald	bald
baldrd	bald
baldvr	bald
baldyngtn	bald
baldyngtvn	bald
balfnz	balfanz
balga	ba
balham	balham
balka	ba
balkvsky	bally
balma	balma
balmasda	balma
balmr	balmer
balndra	balendra
balny	balleny
balsam	balsam
balsara	barbara
balsk	baals
balsly	bally
balsvn	balson
baltaks	baltais
baltays	baltais
baltazar	balthazar
baltzl	baal
balv	ba
baly	bally
balyga	ba
balyk	babak
balyn	allyn
balyn	allyn
balystyk	babak
balyt	balit
bambrgr	br
bamn	ba
bamsv	bamse
bana	banan
banabyv	banan
ban	banan
ban	banan
band	banded
bandd	banded
bandyrdy	bandy
bandz	banan
bangartz	bartz
bang	bang
bangrz	bang
banklr	bankler
bankraft	kraft
bankrvft	bank
banks	banks
bankvala	bankwalla
banl	banan
banr	babar
bantvn	banan
banty	banan
bantyng	bang
bany	banan
bany	banan
bany	banan
banyta	ba
banytv	banan
banyvra	ba
bap	ba
baptysta	baptista
baptyst	baptist
barakvta	barbara
baras	barbaras
barasv	barbaras
barat	ararat
barbagalv	barbagallo
bar	babar
barbas	barbaras
barbr	babar
barbvrak	barbara
barbvr	babar
barby	barbary
bard	bard
bardvlvmz	bard
bardyk	bard
barf	barff
barfrd	bard
barfvrd	bard
barfyt	bart
barg	babar
bargs	babars
bargvs	babars
barh	babah
barjyl	babar
barkalv	bark
barkasfyld	bald
barkay	barbary
bark	bark
barkly	barbary
barkraft	barbara
barkr	babar
barksdyly	barbary
barksfyld	barksfield
barkvlv	bark
barkvs	babars
barlas	barlas
barl	babar
barl	babar
barlv	babar
barnaby	barnaby
barnam	barnard
barnard	barnard
barnas	barnabas
barn	barn
barnd	barnard
barnsa	barbara
barnsav	barn
barnsv	barn
barnt	barn
barny	barbary
barnyk	bark
barqard	bard
bars	babars
barsy	barbary
barta	barta
bart	bart
bart	bart
barthvlvmyvs	barth
bartk	bark
bartkvr	babar
bartl	bart
bartl	bart
bartlmas	barbaras
bartlmvs	babars
bartlt	bart
bartlt	bart
bartly	barbary
bartmvs	babars
bartn	barn
bartn	barn
bartvk	bark
bartvlvmvs	babars
bartvlvmyvs	babars
bartvlyny	barbary
bartvn	barn
bartvnykv	bart
barty	barbary
barty	barbary
bartyh	barth
bartys	barbarys
bartz	bartz
barva	barbara
barvc	babar
barvn	barn
barvn	barn
barvns	babars
barvnya	barbara
barvz	babar
baryaks	barbarys
bary	barbary
bary	barbary
bary	barbary
bary	barbary
baryngr	babar
baryngtn	barbary
baryngtvn	barbary
barys	barbarys
basa	ba
bas	bas
bas	bas
baskar	baskar
baskrvyl	bas
basky	bas
basl	bas
basma	basma
basn	bas
basr	babar
bassa	basss
bassn	basss
bastard	bastard
bast	ballast
bastyk	babak
bastylvs	bas
bastyn	bas
bastyn	bas
bastyn	bas
bastyvn	bas
basval	baal
basv	bas
basv	bas
basvm	bas
basyl	bas
basylyka	ba
basylysk	ask
basylyvs	bas
basyn	bas
batals	baals
batan	bataan
bat	bat
batl	bat
batlr	babar
batnat	bat
batn	bat
batra	batra
batrby	barbary
batrs	babars
batrss	basss
batrst	bat
batrvrs	babars
batrys	barbarys
batrz	bat
baty	bat
batyl	bat
batyng	bang
bava	ba
bav	av
bavcmp	ba
bavdn	ba
bavdn	ba
bavdvyyn	ba
bavdyn	ba
bavdyn	ba
bavdysyn	ba
bavgmn	ba
bavkam	kam
bavkvs	avs
bavm	ba
bavmgartnr	babar
bavprs	babars
bavry	badry
bavs	avs
bavyz	ba
baxvm	ba
bayard	bayard
bay	bayly
bayda	bayda
baydn	bayda
bayfyld	bald
baykrastaf	bas
baykrztaf	afaf
bayla	bayla
bayls	baals
bayly	bayly
baylyngsly	bayly
baylyngtvn	bayly
baylyv	bayly
baylz	bayla
baynvn	ayn
bayprt	bart
bayr	babar
bayrd	bard
bayrn	barn
bayrn	barn
bayrtay	barta
bayrtyh	babah
bayrvn	ba
baysvt	bat
bayz	ba
bazby	buzby
bazby	buzby
bazt	bat
bbkak	bk
bbyt	b
bcldr	badr
bclr	br
bdal	bdale
'bdalh	bdale
'bdallh	all
'bdalrhman	abdalrahman
'bdalrhman	abdalrahman
'bdalrhmn	mn
'bdalrhmn	mn
'bdal'zyr	dayr
'bdal'zyz	allyz
'bdhby	y
bdkk	bk
bdkvk	bk
'bdl	l
bdlak	bak
bdl	b
bdlvc	b
'bdl'zyz	z
bdmy	amy
bdnar	bednar
bdrk	bark
bdryk	bk
'bdval'zyz	allyz
'bdvl	l
'bdvlrhmn	mn
bdyn	bryn
bdyra	byra
bdyr	br
bfj	b
bgdad	brad
bgly	lyly
bgnvld	bald
bgvyl	beyl
bgyr	br
bhamnd	bond
bhara	behara
bhnam	behnam
bhrv	b
bhst	best
bhyja	ba
bjly	lyly
bka	ba
bkar	bar
bk	bk
bk	bk
bk	bk
bkdvr	bk
bkhvrst	borst
bkmn	bk
bkmn	bk
bkmyr	bk
bkr	bk
bkr	bk
bkr	bk
bkr	bk
bks	bks
bkt	bk
bkva	ba
bkvf	bk
bkvk	bk
bkvy	bk
bkvyt	bk
bkvyyr	bk
bky	bk
bky	bk
bkyngsal	sal
bkyngsl	bk
bkyngsyl	beyl
bkyr	bk
bkys	bks
bla	blaha
blac	black
blaf	afaf
blafs	blas
blaha	blaha
blak	bak
blaksvm	blake
blalak	blal
blal	blal
blal	blal
blam	lam
blamkh	blal
blamy	amy
blancard	blanchard
blanch	blanche
blansdan	blanstan
blansdn	blanstan
blanstan	blanstan
blanzdvn	blanstan
blas	blas
blasdn	blas
blask	blask
blasr	blas
blasy	blas
blasyvs	blas
blavadnyk	black
blavyz	blaz
blayt	blatt
blaz	blaz
blazk	blaz
blazkyyvz	blaz
bl	blal
bldn	b
bldrd	bald
bldvyjn	b
bldvyn	bryn
bldvyyn	bryn
bldyng	bang
bldyngtvn	bryn
blga	ba
blka	ba
blk	bk
blklnd	blokland
blkly	lyly
blkmn	mn
blkmn	mn
blksvm	blom
blksyr	br
blkvl	blal
blnk	blank
blnkhvrn	blenkhorn
blnkv	b
blnky	b
bls	blas
bltbrg	berg
bltrav	av
blv	blvd
blvc	blvd
blvhm	blohm
blvksvm	blom
blvm	blom
blvmbrg	berg
blvmn	blvd
blvmnfld	blvd
blvnsdvm	blom
blvnsdvn	blunsdon
blvnzdm	blom
blvrnj	blvd
blvskvm	blom
blvyn	blvd
blvz	blaz
blvzvm	blom
blyk	bk
blyk	bk
blyn	lyn
blyn	lyn
blynda	lynda
blyngasly	sly
blyngtn	lyn
blynkv	b
blynkv	b
blynkvv	b
blyr	br
blystvn	blystone
blyta	blyth
blyvys	billys
blyz	blaz
bnaksy	b
bnamar	benamar
bnan	banan
bnary	barbary
bn	b
bndang	bang
bndastvn	aston
bndk	bk
bndly	bradly
bndr	andr
bndrvb	b
bndy	bandy
bng	bang
bng	bang
bng	bang
bngt	bengt
bnh	b
bnjyman	ayman
bnkr	br
bnkr	br
bnks	banks
bnr	br
bns	bens
bnsn	sn
bnsn	sn
bnsvn	b
bnt	b
bnt	b
bnt	b
bntly	gently
bntn	b
bntn	b
bntv	b
bntvn	b
bntz	bentz
bntz	bentz
bnya	ba
bnyamyn	bryn
bnyfasyvs	bas
bnyn	bryn
bnz	benz
bnzn	zn
bqyr	br
brabant	brabant
braby	bray
bracmn	bran
brad	brad
brad	brad
bradly	bradly
bradr	badr
bradrtn	brad
bradrtvn	brad
bradsav	brads
brady	brady
bradys	bradlys
brafvrd	brad
bragham	braham
braham	braham
brahym	braham
brak	bak
brakly	bradly
brakny	bray
brambav	bram
bram	bram
bramr	br
bran	bran
bran	bran
bran	bran
brandl	brand
brandy	brandy
brann	bran
bransav	brans
bransdvn	bran
branskvmb	brans
bransvyk	brans
brant	brant
brant	brant
brardy	brady
brasard	brassard
brasayr	br
brasrz	basra
brasyrz	br
brat	brat
bratlt	brat
bratr	br
bratyna	bratina
bravn	bran
bravn	bran
bravnfyld	brad
bravnr	br
bravnyng	bragg
bravtvn	bran
bravv	bravo
bravyc	bravo
brayan	bran
bray	bray
brayd	brad
brayn	bran
braynklr	br
brayr	br
brays	brays
brays	brays
brayslav	brays
braysvn	brays
brayt	brat
braytn	bran
braytvn	bran
braytvyt	brat
brazvn	bran
br	br
brbvr	br
brca	ba
brcr	br
brd	bard
brd	bard
brdly	bradly
brdly	bradly
brdly	bradly
brdn	br
brdn	br
brdn	br
brdsang	bang
brdsav	av
brdy	brady
brdyk	bk
brdyt	br
brfvrd	bard
brganty	brant
brgard	bard
brgaylv	br
brg	berg
brg	berg
brgdan	bran
brgland	langland
brgl	br
brgmn	br
brgr	br
brgs	borgs
brgs	borgs
brgsvn	br
brgyvt	br
brhan	bran
brj	br
brkah	barkah
brkaspyr	br
brkat	brat
brkat	brat
brk	bark
brk	bark
brk	bark
brkly	br
brksfyld	bald
brkt	br
brkvl	br
brkvvyc	br
brky	br
brlacr	br
brl	br
brlnd	brand
brlsvn	br
brlv	br
brlyn	bryn
brlyng	bang
brlyng	bang
brml	br
brmn	br
brmn	br
brnadvs	brads
brnal	bernal
brnan	banan
brnard	barnard
brnard	barnard
brnardv	barnard
brnardy	barnard
brnardyn	barnard
brnardz	barnard
brncavd	blvd
brnc	br
brncly	br
brndan	breanndan
brnd	bernd
brnd	bernd
brnd	bernd
brndl	br
brndl	br
brnds	bonds
brndvn	barn
brndy	brandy
brndy	brandy
brndys	brandys
brnhard	bernhard
brnhart	barnhart
brnhr	br
brnr	br
brnsav	av
brnsv	br
brnt	bernt
brnt	bernt
brnt	bernt
brnv	br
brnvl	br
brny	br
brny	br
brnyr	br
brnz	benz
brq	br
brsav	brs
brs	brs
brsfvrd	brs
brslav	slav
brslr	br
brsmn	brs
brsvn	brs
brsy	brs
brt	bart
brtlsvn	br
brtn	br
brtrand	brand
brtr	br
brts	berts
brtvn	br
brtvn	br
brtvn	br
brty	bruty
brty	bruty
brtyh	br
brvanhat	brat
brvark	bark
brvda	broda
brvd	blvd
brvdfyld	bald
brvdhast	brest
brvdly	bradly
brvdr	br
brvdrtvn	br
brvhl	brohl
brvkav	av
brvk	bk
brvk	bk
brvk	bk
brvk	bk
brvkn	br
brvknr	br
brvkr	br
brvks	bks
brvksl	br
brvkvl	br
brvkz	br
brvmbrg	berg
brvmbrgr	br
brvmfyld	bald
brvmly	br
brvmyj	br
brvnl	br
brvnr	br
brvnvyyn	bryn
brvnyyv	br
brvr	br
brvsrd	bard
brvstr	br
brvsyav	av
brvty	bruty
brvtzmn	br
brvvr	br
brvyk	bk
brvylv	br
brvyn	bryn
brvyns	brans
brvynyng	bang
brvyr	br
brvyr	br
brvz	br
brxard	bard
bryan	bryan
bryan	bryan
bryant	bryant
bry	br
bry	br
bry	br
bry	br
brybr	br
bry	br
bry	br
brydlav	bryde
brydvl	bryde
brydy	brady
brydyng	bryn
brygvy	bryguy
bryj	br
bryj	br
bryjmn	bryn
brykaspyr	br
brykspyr	br
bryl	beryl
brym	br
brymr	br
brymstvn	bryn
bryn	bryn
bryn	bryn
bryndan	bryn
brynd	bryn
bryndl	bryn
bryngardnr	bringardner
bryngtn	bryn
bryngtvn	bryn
brynk	bryn
brynkmn	bryn
brynr	br
brynsn	bryn
bryr	br
bryr	br
brys	brays
brys	brays
brysbyn	bryn
brysbyn	bryn
brysnv	br
brystvl	br
brysynda	brenda
bryta	brita
bryt	br
brytlyng	bryn
brytv	br
brytvn	bryn
brytys	brays
bryvn	bryn
bryvny	bryony
bryvr	br
bryvry	br
bryykpr	br
bryytvn	bryn
bryza	ba
brza	ba
bsak	bak
bsam	besam
bs	bs
bsbrys	bs
bskt	bs
bskv	bs
bsl	bs
bsma	basma
bsmy	bs
bst	best
bsval	val
bsvl	bs
bsvn	bs
bsyl	beyl
bsym	bs
bsyra	byra
bsyt	bs
btan	banan
btcldr	badr
bthvn	b
btl	tl
btmn	mn
btrys	bs
btsy	betsy
btvl	b
bty	ty
bty	ty
btyg	b
btyyv	b
btza	betza
bvaly	bally
bvas	bas
bvay	bray
bvay	bray
bvayvyn	ayn
bv	b
bvby	b
bvbys	bobbys
bvca	ba
bvca	ba
bvc	b
bvcga	ba
bvda	ba
bvda	ba
bvdapaty	papay
bvdar	bar
bvd	blvd
bvd	blvd
bvd	blvd
'bvdhaby	abby
bvdla	bodla
bvdn	b
bvdn	b
bvdnmylr	br
bvdra	ba
bvdrv	b
bvdv	b
bvdvr	br
bvdvyn	bryn
bvdy	b
bvdyvn	b
bvdyvyn	bryn
bvfalv	b
bvgard	bard
bvgham	baugham
bvgs	bs
bvhl	buhl
bvhr	bohr
bvjy	b
bvkl	akl
bvkl	akl
bvkly	lyly
bvkr	br
bvksy	b
bvkvn	b
bvla	ba
bvlard	bard
bvl	b
bvldn	b
bvldt	boldt
bvldvyjn	b
bvldzr	br
bvlf	alf
bvln	ln
bvlr	br
bvlr	br
bvltan	banan
bvltn	b
bvltvn	b
bvlv	b
bvlvc	b
bvlvs	bs
bvlvyjn	b
bvlyng	bang
bvmbr	br
bvmbrgr	br
bvm	b
bvmgardnr	bumgardner
bvmhard	bomhard
bvmn	mn
bvnandr	andr
bvnar	bar
bvnavglya	alya
bvn	b
bvn	b
bvngard	bongard
bvnstra	boonstra
bvntn	b
bvnvmv	b
bvnvnv	b
bvny	b
bvnyfass	basss
bvnyfasyvs	bas
bvnyfkyvs	bs
bvnyfyss	basss
bvnyn	bryn
bvnytz	bitz
bvqam	am
bvra	ba
bvrad	brad
bvrap	b
bvrascy	bray
bvr	br
bvrcrt	bart
bvrdr	badr
bvrdyk	bk
bvrga	ba
bvrg	berg
bvrgv	b
bvrgyvys	bs
bvrjya	ba
bvrkval	val
bvrkvl	b
bvrkvyl	beyl
bvrky	b
bvrl	burl
bvrl	burl
bvrln	ln
bvrm	borm
bvrml	b
bvrmn	mn
bvrsl	b
bvrst	borst
bvrsyr	br
bvrvs	bs
bvryj	b
bvryl	beryl
bvryllv	b
bvrys	bs
bvryvn	bryn
bvryz	b
bvrz	b
bvsa	ba
bvsal	sal
bvsart	bart
bvsarv	harv
bvsaysn	magsaysays
bvs	bs
bvs	bs
bvs	bs
bvs	bs
bvs	bs
bvs	bs
bvsca	ba
bvscga	ba
bvsga	ba
bvska	ba
bvsk	bk
bvsly	sly
bvsnl	b
bvsny	b
bvstak	bostak
bvstamnt	best
bvst	best
bvstram	bram
bvstrvm	b
bvstvn	b
bvstyk	bk
bvsval	val
bvsvl	b
bvsvm	b
bvsvn	b
bvsvr	br
bvsvysn	sn
bvsy	b
bvsy	b
bvsyk	bk
bvsysn	sn
bvsyvysn	sn
bvtary	tartary
bvtays	brays
bvt	b
bvt	b
bvtcr	br
bvtlr	br
bvtrl	burl
bvtrs	brs
bvtsyh	b
bvtvn	b
bvtz	bitz
bvvdvyn	bryn
bvvn	b
bvvy	b
bvxny	b
bvy	b
bvykv	b
bvyln	ln
bvyr	br
bvyrkvyl	beyl
bvys	bs
bvys	bs
bvysvyks	bks
bvysyv	b
bvyvn	b
bvyzy	b
bvzancyv	b
bvz	b
bvzkart	bart
bvzman	banan
bvzva	ba
bvzval	val
bvzvva	ba
bvzvvyl	beyl
bvzydar	bar
bvzyd	boyd
byakv	b
byan	abyan
byang	bang
byangtay	tay
byatlyng	byung
byavys	bobbys
by	b
bybl	blal
bybr	br
bycam	am
byc	b
bycly	lyly
bycmp	b
bycyngsyl	beyl
bycz	b
byda	bayda
bydl	b
'byd	d
bydv	b
bydvl	b
bydy	b
byf	b
byfjh	b
byfrast	best
byg	b
byglhl	buhl
bygnd	bond
bygnvald	bald
bygv	b
bygvrdan	banan
bygz	b
byhan	beyhan
byhyv	b
byj	b
byjh	b
byka	ba
bykard	bard
byk	bk
byk	bk
byk	bk
byk	bk
bykly	lyly
bykn	b
byknst	best
bykrastaf	afaf
bykrastafy	bray
bykrastf	byra
bykrastyf	byra
bykr	br
bykrstf	b
bykrtn	b
bykslr	br
bykvl	b
bykvn	b
bylal	blal
bylany	billany
byl	beyl
byl	beyl
byl	beyl
bylhar	bilhar
bylky	b
bylngtvn	ln
bylr	byler
bylr	byler
bylr	byler
byls	byles
bylv	b
bylykvk	bk
bylyngaslay	bayly
bylyng	byung
bylyngsly	lyly
bylyngtvn	bynon
bylyngz	lyly
bylynsky	lyly
bylyr	byler
bylz	b
bylzybab	baba
bymn	lymn
bymyng	byung
byn	bynon
byn	bynon
byn	bynon
byn	bynon
byndmn	bynon
bynfng	byung
byng	byung
bynh	b
bynjn	bynon
bynmdart	bart
bynqam	am
bynr	br
byns	bens
byns	bens
bynvd	blvd
bynvy	b
byny	b
byny	b
byny	b
bynyyvn	bynon
bynz	benz
bynz	benz
bynz	benz
bypyn	bynon
byra	byra
byr	br
byr	br
byr	br
byr	br
byr	br
byrbk	bk
byrc	byra
byrd	byrd
byrd	byrd
byrdmr	byrd
byrdn	byrd
byrfys	bobbys
byrg	berg
byrgl	byra
byrk	bark
byrla	byra
byrmn	byron
byrnbvym	byrne
byrn	byrne
byrnh	byrne
byrns	byrnes
byrtay	tay
byrt	bart
byrtryk	bk
byrtyh	byra
byrtyh	byra
byrvt	byra
byryc	byra
byryganty	gantry
byryng	byung
byrz	byra
bysayv	magsaysays
bys	bobbys
bysh	bush
byskmp	b
bysl	b
bysly	sly
bysmark	bismark
bysm	sm
bysr	br
bystandr	bystander
byst	best
byst	best
bysyn	bynon
bytankrt	bank
bytard	bard
byt	b
byt	b
bytmn	mn
bytn	b
bytrays	brays
bytryk	bk
bytz	bitz
byvan	banan
byv	b
byvcamp	basecamp
byvcmp	b
byvdvyn	bynon
byvfyz	b
byvgam	am
byvkmp	b
byvkraft	kraft
byvly	lyly
byvlyv	b
byvmnt	b
byvmvnt	b
byvngs	bs
byvr	br
byvrly	lyly
byvrz	b
byvsh	bush
byvtl	tl
byvys	bobbys
byvzvyl	beyl
byyvcmp	b
byyvnyk	bk
byz	b
byzr	br
byzvanat	anant
byzvas	bas
byzvyl	beyl
byzyr	br
bzva	ba
cagn	ca
cakv	ca
calk	cal
cambrlayn	cambrian
camplyn	carolyn
cand	anand
candran	chandran
candr	andr
candvnya	ca
cansy	canaans
cany	candy
capla	ca
capl	cal
capmn	ca
capra	capra
capyn	ca
card	caird
carltn	carlton
carltvn	carlton
carlvt	carl
carly	carly
carlyh	carly
carlyn	carly
carlz	carl
carng	charng
cartvn	carhart
caryk	cary
cas	cas
casmz	cas
castyn	cas
catany	candy
cav	av
cavda	ca
cavhan	canaan
cavn	ca
cavvyn	ca
cavvyv	av
cavz	ca
cay	ca
caykn	ca
cayld	ca
cayldz	ca
cayz	ca
ch	church
ckrd	cd
clatvn	cl
clyvs	cls
clyyan	yan
cmaly	chemaly
cmbrlyn	charlyn
cmbrz	cm
cmbzy	cm
cnadr	badr
cn	c
cnd	cd
cndlr	cr
cnslvr	cr
cnth	th
cny	c
cpdy	cody
cpz	c
crag	craig
craskaynt	cracraft
crbl	cl
crc	c
crcyl	cl
crpy	cr
crskynay	cray
crvbyny	cr
crvyc	c
cry	cary
cry	cary
cryl	cheryl
cryskynty	sky
crystal	crystal
crysynth	cr
csbrv	cs
cs	cs
csny	chesny
csny	chesny
cstr	cr
ctal	cal
ct	c
ctvyn	ayn
cva	ca
cva	ca
cv	c
cv	c
cv	c
cv	c
cv	c
cvdhary	cary
cvkry	cary
cvksy	c
cvlka	ca
cvn	c
cvnpyg	c
cvrn	rn
cvsak	chusak
cvvanak	nanak
cvy	c
cvy	c
cvylr	cr
cya	ca
cya	ca
cyaky	laky
cyang	yang
cybansky	cybanski
cy	c
cy	c
cycstr	cyr
cyk	c
cyk	c
cyk	c
cykn	c
cykry	cary
cyky	c
cykz	c
cyldz	c
cylt	celt
cylth	th
cyltj	c
cyltjh	c
cyly	lyly
cylyjh	lyly
cylyngvrs	crs
cylyngvrt	cort
cym	cm
cyn	ayn
cyn	ayn
cynn	conn
cynv	c
cyp	c
cyp	c
cyplvydn	c
cypmn	mn
cypn	c
cyrag	cyr
cyrak	cyr
cysm	cm
cysmn	mn
cysty	ty
cysvlm	cm
cyta	ca
cytam	tam
cytan	canaan
cyt	c
cyt	c
cytrdy	cordy
cytvvd	cd
cytvyn	ayn
cytyk	c
cyv	c
cyv	c
cyzvba	ba
cyzv	c
cyzvrv	c
dabac	ac
dabas	dadas
dabl	dal
dabny	dabney
dabs	dadas
dabsvn	dabin
dabvs	dadas
dabvys	dadas
dabyl	dal
dabynsky	darby
dabynsn	dabin
dabynsvn	dabin
dabynz	danz
dada	dada
dad	dada
dadgyvn	dada
dadh	dada
dadk	dada
dadly	dada
dads	dadas
d'a	a
dadv	dada
dadyr	dada
daf	afaf
dagan	dagan
dagan	dagan
dag	dag
dag	dag
dag	dag
dagly	dagley
dagn	dag
dagr	dag
dagrty	dag
dagrz	dag
dagvac	dag
dagz	dag
dahak	dahar
dahaml	dahl
dahn	dan
dahrty	day
dahvd	d
dahvk	dahuk
daj	dada
daj	dada
dajyvn	dan
dakas	dadas
dak	dada
dak	dada
dak	dada
dakhvrn	dakin
daklvz	dada
dakmn	dakin
dakn	dakin
dakryng	dag
daks	dadas
daks	dadas
daktrz	dada
dakv	dada
dakvrs	dakars
dakyng	dag
dakynz	danz
dakz	dada
dalajr	dalal
dalan	dallan
dalas	dallas
dalayr	dayr
dalbk	dal
dalbrgr	dal
dalbyr	dayr
dal	dal
dal	dal
dal	dal
dalfr	dal
dalmn	dal
dalms	dadas
dalmyya	dada
dalnz	danz
dalrs	dadas
dalrympl	dalrymple
daltvn	dalton
daly	daly
daly	daly
daly	daly
daly	daly
dalynar	daly
dalyngr	daly
damar	dhamar
dambl	dal
damlr	dada
dampltvn	damon
damvn	damon
damvntt	dada
damyan	dan
damyanv	dan
damyla	dada
damyngs	dadas
damyny	amy
damynykas	dadas
damytrv	dada
damyvn	damon
dana	dana
danald	danald
dana	dana
danavan	dan
dan	dan
dandas	dadas
dan	dan
dan	dan
dan	dan
dandy	andy
danfrd	d
danfy	dan
dang	dag
dang	dag
dangtay	day
dangvy	davy
dangyv	dan
dangyvn	dan
danham	denham
danh	dan
danjl	dal
dankan	dan
dankv	dan
dankv	dan
danky	dan
danlvp	dan
danly	daly
dannbargr	anbar
dannly	danny
danr	dan
dansmvr	dan
danstr	dan
dansy	daisy
dansyng	dag
dantn	dan
danvan	dan
dany	danny
dany	danny
danydyn	dan
danyl	dal
danyl	dal
danyl	dal
danylsvn	dan
danylv	dan
danylz	danz
danys	dannys
danyyls	dannys
danz	danz
dapay	day
dapnyk	dada
daprk	dada
daprry	day
dapry	day
darang	dag
dara	dada
darby	darby
dar	dahar
darham	durham
darl	dal
darly	daly
darlyngtn	darlington
darnal	darnall
darnl	dal
darnl	dal
dart	dart
darv	dada
darvn	darvon
darygvs	daryls
daryl	daryl
das	dadas
das	dadas
dasn	dadas
dasvn	dadas
dasyng	dadas
dasyvk	dadas
dat	at
dath	darth
datjh	daatje
datry	datri
datsvn	dan
datvn	dan
datvyt	at
daty	day
daty	day
davad	dada
davark	ark
davbr	br
davd	d
davd	d
davd	d
dav	av
dav	av
dav	av
davknyz	dada
davkynz	danz
davn	dan
davnprt	dart
davny	davy
davnyng	dag
davnyng	dag
davrs	dadas
davryn	dan
davsan	dan
davs	avs
davsn	dan
davsvn	dan
davt	dada
davvd	d
davvd	d
dayal	dal
dayan	dan
dayan	dan
dayanysya	dada
dayanysys	dannys
dayaz	day
daybala	dalal
daybl	dal
daycync	dancy
day	day
day	day
daydryc	day
day	day
dayk	day
dayksvn	dan
dayky	day
daykynk	day
daykynz	danz
daylaygan	dagan
daylvn	dan
daymnd	d
dayn	ayn
dayn	ayn
dayr	dayr
dayrdryk	dayr
dayr	dayr
dayrktvr	dayr
dayrt	dart
days	dadas
dayt	day
dayvd	d
dayvrjh	day
dayvrjh	day
dayvrt	dart
dayvrth	darth
dayvrtj	day
dayvrtj	day
dayvrya	dada
dayvvn	dan
dayvyn	ayn
dbatvnya	ba
dblr	dr
dbyt	d
ddfyld	d
ddjn	d
ddryk	dr
ddy	addy
dfrvy	davy
dgly	daly
dgraf	graf
dgrf	d
dgrlvnd	d
dgvtardy	hardy
dha	dhaka
dhamar	dhamar
dhnr	dr
dhnrt	dart
dhvk	d
djamyla	djamila
djly	daly
dkan	dan
dkk	d
dklrk	dirk
dkr	dr
dkstr	dr
dkyah	ayah
dky	d
dk	d
dlal	dalal
dlany	danny
dl	d
dlh	d
dlman	dolman
dlny	d
dlrd	d
dlryv	d
dltn	d
dltvvya	divya
dlvra	dora
dlvryz	d
dlvys	ds
dly	daly
dlykatny	delikatny
dlys	dollys
dlysyv	d
dma	dema
dma	dema
dmkak	aka
dmkh	d
dml	d
dmlr	dr
dmn	mn
dmpstr	dempster
dmr	dr
dmrz	d
dmsq	sq
dmyla	layla
dmynysvs	amys
dmys	amys
dnald	danald
dnaqy	d
dnavlt	lt
dn	d
dndlr	dr
dn	d
dndryj	dr
dng	deng
dnham	denham
dnjvr	dr
dnkvaltr	dr
dnkynd	d
dnl	d
dnmn	mn
dnnl	d
dnryj	d
dnsr	dr
dntvn	d
dnv	d
dnvks	ds
dnyh	d
dnyl	d
dnylz	d
dnyng	deng
dnys	dannys
dnysvn	d
drabk	drabek
dradr	dr
dragan	dragan
draganys	dragan
dragn	drag
dragr	dr
drakmn	drake
dral	dal
dralt	dr
dramatys	dramatis
dram	dream
drap	dr
drapr	dr
drast	dr
dratmn	dratman
draty	dr
dravn	dr
dravr	dr
draynh	dr
drayr	dayr
drbs	rbs
drby	darby
drcmn	dr
drdh	dr
drg	dr
drgvmyr	dr
drgvn	dr
drgvns	dons
drk	dirk
drksl	dr
drmvt	dr
drnal	dal
drnk	drnek
drntr	dr
drsnr	dr
drtcn	dr
drth	darth
drv	dr
drv	dr
drvdyng	deng
drvdys	dr
drvmand	amand
drvmr	dr
drvny	dr
drvnys	dannys
drvr	dr
drvt	dr
drvyk	dr
drvyt	dr
drvzn	dr
drydjy	drury
dryfvs	dr
dryjr	dr
dryk	dr
dryk	dr
drym	dr
drymr	dr
drymz	dr
drynks	drinks
drynz	danz
dryr	dr
dryry	drury
drys	dr
dryskvl	dr
dryskyl	daryl
dryv	dr
dryv	dr
dryvt	dr
dryxa	dr
ds	ds
dsl	ds
dsmvlynz	danz
dsmvnd	d
dsmyt	ds
dsnvyrz	ds
dsrazyrs	ds
dsrvzyrz	ds
dstly	daly
dsvtv	ds
dtlfs	ds
dtmn	mn
dtryj	d
dts	dots
dtvylr	dr
dva	va
dvak	bak
dvalybay	daly
dvan	dan
dvanyr	dayr
dvar	ar
dvarth	darth
dvaykynk	ayn
dvbay	day
dvbratz	datz
dvbrydj	bryde
dvbrykyn	bryn
dvbryz	d
dvbsvn	d
dvbvys	ds
dvbynsvn	dobyns
dvbynyn	ayn
dvbyr	dayr
dvcarm	arm
dvcaylard	duchaylard
dvct	d
dvcync	sync
dvda	dada
dvdamany	danny
dvd	d
dvdgvn	d
dvdj	d
dvdl	d
dvdly	daly
dv	d
dv	d
dvfvr	dr
dvgan	dagan
dvgan	dagan
dvg	d
dvgyvn	d
dvha	doha
dvhh	d
dvhrty	ty
dvhvr	dr
dvhyrst	st
dvjn	d
dvk	d
dvk	d
dvlan	dan
dvl	d
dvlkya	diya
dvlman	dolman
dvlr	dr
dvly	daly
dvlyn	lyn
dvmba	domba
dvm	d
dvm	d
dvmn	mn
dvmnykv	d
dvmykv	d
dvmykz	d
dvmyngv	d
dvmynykas	das
dvmynyk	d
dvmynyk	d
dvmynyks	ds
dvmynykyvs	ds
dvmynyn	ayn
dvmynyvs	ds
dvnacy	lacy
dvna	dvina
dvnald	danald
dvnat	nat
dvnatv	d
dvnaty	katy
dvnay	day
dvn	d
dvn	d
dvng	deng
dvnham	denham
dvnkn	d
dvnly	daly
dvnpk	d
dvnpyk	d
dvns	dons
dvntsk	ask
dvnvan	dan
dvnyny	d
dvnys	dannys
dvpalm	depalm
dvplr	dr
dvplt	lt
dvpry	dory
dvpyvys	ds
dvra	dora
dvrand	durand
dvrand	durand
dvran	dan
dvran	dan
dvrapt	capt
dvras	das
dvrasy	d
dvrath	rath
dvraty	katy
dvravks	ds
dvraya	rayya
dvrazyv	d
dvrcak	demcak
dvrcn	d
dvrdal	dal
dvrfman	dorfman
dvrham	durham
dvrkn	d
dvrkyn	parkyn
dvrl	d
dvrld	d
dvrma	dorma
dvrnd	d
dvrnd	d
dvrn	dorn
dvrn	dorn
dvrrans	durans
dvrst	st
dvrsy	d
dvrsy	d
dvrtcn	d
dvrt	dart
dvrth	darth
dvrtj	d
dvrtjh	d
dvrtvn	d
dvrty	ty
dvrty	ty
dvrvc	c
dvrvty	ty
dvrvyn	ayn
dvry	dory
dvrynda	dada
dvrys	ds
dvrys	ds
dvrysvmy	dory
dvs	ds
dvskv	d
dvsn	sn
dvstalyk	daly
dvsty	dusty
dvta	ta
dvvaykynk	ayn
dvvl	d
dvy	davy
dvykynk	d
dvykynk	d
dvyn	ayn
dvyndr	dr
dvyny	davy
dvynyng	deng
dvyr	dayr
dvysr	dr
dvyt	d
dvytv	d
dvyvyr	dayr
dvyykynk	d
dvzat	duzat
dvzyyr	dayr
dyab	diab
dya	diya
dya	diya
dyala	diyala
dyamantaras	diamantaras
dyamdy	dady
dyamvnd	d
dyana	dana
dyan	dan
dyaz	diaz
dybat	bat
dybath	baath
dybatvnya	dyballa
dyb	yb
dybl	d
dybt	d
dybtvnya	diya
dybv	d
dybyt	d
dycyr	cyr
dyda	dada
dy	dady
dy	dady
dy	dady
dydrysz	dr
dydryx	dr
dydyrycs	cs
dygan	dagan
dygazmn	mn
dygh	d
dygnarv	dyna
dygraf	graf
dygrf	d
dygrv	d
dygv	d
dygvyd	d
dykanynk	bank
dykavty	dady
dyk	d
dyk	d
dykl	akl
dykns	dykins
dyknz	danz
dyknz	danz
dyksay	day
dyks	dykes
dyksn	sn
dykstra	dikstra
dyksvn	d
dyksvn	d
dykv	d
dykv	d
dyky	dady
dyky	dady
dykynz	danz
'dyl	l
dylan	dylan
dylayr	dayr
dyl	d
dylma	dilma
dyln	dylan
dylny	dady
dylr	dr
dylvrs	dyers
dyly	lyly
dyly	lyly
dylyngr	dr
dylyngtn	dylan
dylyp	lyly
dylyp	lyly
dylyv	lyly
dymad	d
dyma	dema
dyma	dema
dymars	demars
dymarst	dart
dymaryp	dimaryp
dymas	das
dymask	ask
dym	d
dymn	lymn
dymrs	dyers
dymsak	bak
dymvk	d
dymyng	deng
dymytar	tartar
dymytry	dady
dymytrys	amys
dymytryv	d
dymytryv	d
dymytryvs	ds
dyna	dyna
dyna	dyna
dyna	dyna
dynamyt	dyna
dynbym	dyna
dyn	dyna
dyn	dyna
dyn	dyna
dyng	deng
dynglv	dyna
dyngsvr	dr
dyngy	dady
dyngy	dady
dynl	dyna
dynlr	dr
dynn	dinn
dynpyk	dyna
dynr	dr
dyns	dobyns
dyns	dobyns
dynsmvr	dr
dynt	dent
dynv	dyna
dyny	dady
dynyngr	dr
dypak	dipak
dypayvla	layla
dypayvlv	paypal
dypbvy	dady
dypld	d
dyprsyv	d
dyprtr	dr
dypytrv	d
dyr	dayr
dyr	dayr
dyr	dayr
dyrdrk	dirk
dyrdryk	dr
dyrk	dirk
dyrk	dirk
dyrks	dirks
dyrvkv	d
dyrvrtj	d
dysantv	sandys
dysav	av
dysay	day
dys	ds
dysgy	dady
dysmvnd	d
dysnt	dent
dystl	tl
dytjy	dady
dytmar	dietmar
dytr	dr
dytvrz	d
dytvtala	latala
dyva	dyna
dyvakarvny	dakar
dyvanatan	devanathan
dyvan	dan
dyvar	ar
dyvayn	ayn
dyvayn	ayn
dyvayzr	dayr
dyvha	doha
dyvn	d
dyvnh	d
dyvnpk	d
dyvnyda	dada
dyvrt	dart
dyvrt	dart
dyvrth	darth
dyvrtj	d
dyvrtjh	d
dyvrtjh	d
dyvvsr	dr
dyvya	divya
dyvy	dady
dyvyd	d
dyvyd	d
dyvyd	d
dyvy	dady
dyvydsvn	ds
dyvydyan	dan
dyvyldh	d
dyvys	ds
dyvysn	dyson
dyvysvn	dyson
dyvyt	d
dyyala	diyala
dyzny	dady
dyzr	dr
dyzvn	d
dz	d
dzgagnh	d
fablr	faber
fabrh	fabre
fabrv	fabre
fabrys	fabris
fabyanv	abyan
facs	acs
fad	fadl
fadl	fadl
fadnbrg	fadl
fadvr	fadl
fadyla	fadila
fadyl	fadl
'faf	afaf
fagan	fagan
fagans	fagans
fajn	fan
fajyvar	farer
faks	fays
falcvk	falk
falk	falk
falknr	falk
falkrsvn	falk
falkv	falk
falkvnr	falk
faln	fan
falsam	balsam
faltak	falk
faltls	als
faltvn	fan
falvn	fan
faly	fay
falyvt	fafat
falz	faiz
famyvs	famus
fandryc	fac
fang	fan
fangvs	fan
fants	fan
fara	ara
farag	farag
faragv	farag
farat	ararat
farkas	farkas
farl	carl
farly	farley
farmr	farmer
farsbrg	farag
farst	fast
fartk	falk
farvanya	fan
farvanyah	farah
farvgya	arya
farvk	falk
farvk	falk
farvq	farooq
farvz	faiz
faryd	farid
fary	farry
faryha	fariha
faryvr	farer
fasbrg	fasig
fas	as
fas	as
fasl	fasel
fatyma	fatima
fatys	fays
favaz	fawaz
favl	fadl
favns	fagans
favns	fagans
favst	fast
favst	fast
favst	fast
favst	fast
favzya	a
favzy	fay
favzyya	fawziyya
faxry	farry
fayf	f
fayk	fay
fayls	fays
fayn	ayn
faynk	fay
faynly	fay
faynrty	fay
faynstvn	ayn
fayntvn	ayn
fayrbank	fairbank
fayrvz	fay
fayt	fafat
fayyz	fay
fayza	faiza
fayz	fay
fayz	fay
fayzl	fay
faza	zaza
faz	fawaz
fazl	fadl
fazya	a
fazy	fay
fazy	fay
fbrv	f
fcnr	fr
fdl	fadl
fdr	dr
fdr	dr
fdrl	f
fdrmn	mn
fdvr	fr
fdyla	fla
fdyl	f
fhd	fahd
fht	f
fk	f
flaglly	fly
flahrty	flaherty
flakygr	fla
flardynga	flardinga
flat	flat
flat	flat
flavka	fla
flay	fay
flaygyr	fla
flays	fays
fldman	feldman
fldmar	feldmar
fldmn	mn
fldr	dr
fldspar	feldspar
flj	f
flk	falk
flkynz	f
flmr	flor
flsty	fly
flth	th
fltj	f
fltjh	f
fltyv	f
flvch	foch
flvdyn	flynn
flvra	fla
flvr	flor
flvr	flor
flvrk	fork
flvrns	ferns
flvrs	frs
flvry	flory
flvryn	flynn
flvrz	f
flvt	flat
flvvrz	f
flvyd	floyd
flyjh	fly
flyks	fly
flykyngr	fly
flym	fly
flymyng	fly
flyndrz	fly
flynt	flint
flyny	fly
flysz	fly
flyvry	fly
flyzardv	fly
fmmth	fm
fmt	fm
fmtj	fm
fmya	fm
fncarc	marc
fndr	andr
fn	f
fn	f
fng	feng
fngr	fr
fnr	fr
fnsky	sky
fntvn	f
fntyman	ayman
fnvyk	f
fny	f
fnys	fannys
fra	afra
fragvrgya	freya
fram	frahm
framsan	fran
framsvn	framson
frandsn	fran
fran	fran
frangakys	frangakis
frankl	frank
frankl	frank
franklyn	fran
frankv	frank
frankv	frank
frankvy	frank
frankvys	franks
frankvyz	frank
frans	frans
fransr	frans
franssydtj	frans
fransvyz	frans
fransyka	frans
fransyntay	frans
fransynth	frans
fransyntjh	frans
fransynty	frans
fransyntyh	frans
fransyntz	frans
fransyska	fransiska
fransyska	fransiska
fransyskas	frans
fransyskvs	frans
fransysyvs	frans
frantysk	frank
frantzn	fran
fraq	fr
frary	fry
frasr	fr
frast	fast
frasty	grasty
frayda	ayda
fraydman	fran
fraydmn	fran
fraydy	fay
fray	fay
fraygrsa	frs
fraytgrsa	fritgersa
frazr	fr
frazyr	fr
frazyyr	fr
frda	freda
frdaynnd	ford
frd	ford
frdkyn	fr
frdrkyng	feng
frdryk	fry
frdryk	fry
frdryk	fry
frdryk	fry
frdrykv	fry
frdt	fr
frdya	freya
frdy	fry
frdy	fry
frdyg	fr
frg	fr
frgt	fr
frgvsn	fr
frh	fr
frj	fr
frjn	fr
frlang	lang
frly	fly
frm	fm
frnands	anand
frnandv	anand
frnandz	anand
frnasyskas	askanas
frnasyskaz	askanas
frnc	fr
frnk	frank
frnk	frank
frnkh	fr
frnkl	fr
frnkl	fr
frnklyn	flynn
frnksvn	fern
frnkvys	freys
frnkvyz	fr
frnsaynt	fr
frns	ferns
frnsnyt	fr
frnsnyt	fr
frnsvys	ferns
frnsynty	fry
frnsyska	fransiska
frnsyska	fransiska
frnzl	fr
frq	fr
frr	fr
frsr	fr
frtyk	fr
frvanyah	ayah
frvanyh	fr
frvk	fr
frvk	fr
frvmyn	fr
frvnyah	ayah
frvz	fr
frybrg	fry
fryda	freda
frydbrgr	fr
fryd	fry
frydgyr	fr
frydh	fry
frydl	fry
frydmar	fr
frydmn	fry
frydmn	fry
frydryk	fry
frydyn	fry
fry	fry
fry	fry
fryha	fry
fryks	frs
frylnd	fry
frylyng	fry
frylyngr	fr
frylz	fry
frymal	freemal
frymvt	fry
fryngtvn	fry
frynk	frank
frynk	frank
fryr	fr
fryr	fr
fryrmat	fermat
frys	freys
frys	freys
frys	freys
frytag	freitag
frytas	freitas
fryt	fry
frytgrsa	fritgersa
frytn	fry
fryts	frits
frytv	fry
frytvl	fry
frytzyvs	frs
fryvald	fry
fryvvgl	fry
fryz	fry
fryzr	fr
fryzr	fr
fsdal	fosdal
fst	fast
fsyg	fs
ftc	tc
ftcn	f
ftra	fetra
ftr	fr
fvd	d
fvjy	f
fvjyta	ta
fvjyvka	a
fvkv	f
fvldz	f
fvlgam	am
fvlkanys	fannys
fvlk	falk
fvlks	fs
fvlmn	mn
fvln	ln
fvlr	fr
fvlr	fr
fvly	fly
fvmrtvn	f
fvndal	fundal
fvndv	f
fvngn	f
fvng	feng
fvnky	funky
fvntnvt	f
fvn	f
fvnyvk	f
fvrbs	rbs
fvrbz	f
fvrd	ford
fvrdham	fordham
fvrdsandn	fan
fvrjy	f
fvrk	fork
fvrlang	lang
fvrmn	mn
fvrmn	mn
fvrnr	fr
fvrny	f
fvrny	f
fvrnyr	fr
fvrr	fr
fvrrv	f
fvrsayt	f
fvrsayt	f
fvrsblam	lam
fvrsbrg	forsberg
fvrs	frs
fvrsyl	f
fvrt	art
fvrts	forts
fvry	fry
fvsng	feng
fvt	f
fvtrr	fr
fvts	fs
fvtynvs	fs
fvy	f
fvys	fays
fvyy	f
fvzard	fozzard
fvzy	f
fvzyh	f
fxrya	rya
fxry	fry
fxryya	rya
fxyr	fr
fyaban	abyan
fyaksy	f
fyaskvnarv	harv
fybr	br
fydalgv	algal
fydl	fadl
fydlr	fr
fydvr	fr
'fyf	f
fygard	figard
fygvra	fera
fyhan	fan
fyk	f
fyks	fs
fylaks	fs
fyl	f
fylk	falk
fylpat	pat
fyl	f
fyl	f
fylps	alps
fylr	fr
fylvs	fs
fylvz	f
fylyas	as
fyly	lyly
fylyp	lyly
fylyps	fs
fylyps	fs
fylz	elz
fymtjh	f
fymyjh	f
fynan	banan
fynan	banan
fync	sync
fyn	ayn
fyn	ayn
fynk	fink
fynkl	akl
fynly	fly
fynly	fly
fynly	fly
fynstad	finstad
fyny	f
fynyn	ayn
fynys	fannys
fy	f
fyps	fs
fyrbnks	franks
fyrbryn	bryn
fyr	fr
fyrhrst	fast
fyrma	firma
fyrn	fern
fyrvdr	dr
fyrvk	f
fyrvz	f
fyrvz	f
fysbyn	ayn
fys	fays
fys	fays
fysk	fisk
fysr	fr
fyta	ta
fytc	tc
fytzjrald	bald
fytzvl	f
fyvr	fr
fyvstl	tl
fyza	zaza
fyz	f
fyzh	f
fyzl	f
fzya	a
gaba	gaba
gabara	gabara
gabbl	gabel
gablr	gabler
gabrylh	ga
gabrylh	ga
gabryylsvn	gabon
gabvr	gabor
gabyn	gabon
gacr	cr
gadbry	gadbury
gadbt	gat
gadbvry	gadbury
gadbvys	gadbois
gadfrvyd	ga
gadfry	gary
gadgl	gadil
gadmn	gan
gadrv	ga
gadsn	gadsden
gadsvard	harvard
gadvyn	gan
gady	gandy
gadyjn	gan
gadyl	gadil
gaf	afaf
gaf	afaf
gafny	gaffney
gafran	gan
gafyn	gan
gagnh	gagne
gahrty	gaherty
gajnh	ga
gajr	ga
gala	ga
galaghr	gallagher
galagr	gallagher
galahad	galahad
galan	gan
galant	gallant
galatyn	gallaty
galavy	galbavy
galbavay	galbavy
galc	ga
galdn	galen
gal	gaal
gal	gaal
gal	gaal
gal	gaal
galj	ga
galkv	galko
galn	galen
galp	gap
galpyn	galpin
galt	gat
galv	ga
galvla	ga
galvsn	galvan
galvvy	galbavy
galvy	galbavy
galybrt	gat
galy	gay
galy	gay
galy	gay
galy	gay
galyla	ga
galylh	ga
galylh	ga
galyty	gallaty
galyvn	galen
galyzya	alya
gamak	gamal
gamal	gamal
gambynv	ga
gaml	gamal
gaml	gamal
gamrv	ga
gamrvs	gas
gamvn	gan
gamyj	ga
gamysh	amys
ganapaty	ganapathy
ganar	gan
ganatra	ganatra
ganavan	gan
gandlc	gan
gandrsvn	gan
gandrzyk	gan
gandvrp	gan
gandy	gandy
gan	gan
gang	gang
gang	gang
gangvly	gang
ganl	gan
ganrvs	gans
gans	gans
gansvn	gan
gantram	guntram
gantr	ganter
gantr	ganter
gantr	ganter
gantrp	gantry
gantrt	gantert
gantvrp	gan
gantvrph	gan
ganty	gantry
ganvn	gan
ganvyl	gan
ganyr	gan
ganysan	gan
ganzak	ganzak
ganzalz	ganzak
gapta	ga
gapysty	gap
garadvan	garagan
garafalv	garagan
garans	gans
garbh	garbe
garby	gary
gardnr	gardner
gardynr	gardner
garfyld	garfield
garfynkl	garfinkel
garlyk	garlick
garmz	garms
garn	gagarin
garnr	garner
garnt	garnett
garny	gary
garsky	gary
garss	gass
garsvl	garshol
garsya	ga
gart	art
gartmn	gartin
gartryj	gary
gartyn	gartin
garvd	ga
garvfalv	ga
garvla	ga
garvtv	ga
garyk	gary
garyk	gary
garys	garrys
garytv	gary
gasard	asgard
gas	gas
gaskat	gat
gaskvn	gaskin
gaskvyn	gaskin
gaskvyyn	gaskin
gaskyn	gaskin
gaskynz	gas
gaslr	gas
gaslr	gas
gaslyk	gas
gaslyng	gang
gaspar	gaspar
gaspr	gaspar
gasta	ga
gastavs	gas
gastavvs	gas
gastlav	gastli
gastlv	gastli
gastylv	gas
gastyn	gan
gastynyv	gas
gasvl	gas
gasy	gas
gasyk	gas
gasynk	gas
gata	gatta
gat	gat
gat	gat
gathard	gath
gatkvmb	gat
gatlyb	gat
gatly	gat
gatlyn	gatlin
gatmn	gan
gatmn	gan
gatryj	gat
gatsf	gat
gats	ats
gats	ats
gatvyn	gan
gatys	gas
gatyz	gatz
gatz	gatz
gatzvylr	gatz
gavazny	gay
gav	av
gavrd	ga
gavr	ga
gavtyr	ga
gavyndan	gan
gavynd	ga
gavyn	gan
gaya	gaya
gayat	gat
gaybs	gas
gayda	gayda
gaydry	gay
gaydval	gaal
gaydv	gay
gaygl	gay
gay	gay
gaylr	gayler
gaylvn	gan
gaymn	gayman
gaymvnd	gay
gaynl	gay
gaynvr	gaynor
gaynvr	gaynor
gayr	gay
gayt	gat
gayvn	gan
gayytz	gatz
gazk	ga
gazmn	gan
gby	g
gdard	gd
gdbry	gary
gdk	gd
gdralt	gd
gdr	dr
gdyra	byra
gdyrh	gd
gdyr	gd
gdys	gds
gf	f
gfran	fran
glas	glass
glaskv	glass
glasyr	glaser
glasyyr	glaser
glatz	glatz
glayr	dayr
gldastyyn	glynn
gldbrg	g
gldbrgr	br
gldfsman	geldefsman
gldfsmn	glen
gldfvt	g
gld	gd
gldkmp	goldkamp
gldmn	glen
gldr	dr
gldyng	g
gldzmn	glen
gldzvrsy	g
glf	gulf
gl	g
glndvrf	glandorf
gln	glen
glryk	g
gls	gils
glsyrz	g
gltr	g
glvb	b
glvj	g
glvrya	rya
glvvy	g
glyb	yb
glyc	c
glycmn	glynn
glyk	g
glyksmn	glynn
glyn	glynn
glynz	glynn
glysvn	glynn
glyvs	gs
glyzr	zr
gmbl	g
gmg	g
gml	g
gml	g
gmyj	g
gnagy	gnagy
gnks	genks
gnvsys	gipsys
gnysylda	gilda
gnzals	als
gnzals	als
gnzalz	gonzalez
gnzalz	gonzalez
gnz	g
gph	g
gpj	g
grab	arab
grabnar	grabnar
grabn	graben
grabynr	grabnar
grad	grad
graf	graf
graft	graft
grag	g
gragty	grasty
graham	graham
graham	graham
grah	grah
grahrna	grahorna
gralyn	gran
gramss	gramsas
granbrgr	gran
grandastrvm	grand
grand	grand
gran	gran
grantam	grantham
grant	grant
granvyn	gran
granyt	grant
granzyv	gran
grardyn	gran
graskyn	gran
grasr	graser
gratr	grater
grav	gorav
grav	gorav
grav	gorav
grav	gorav
graym	gray
grayngr	gray
graysldyz	gradys
graysyld	grad
grayvas	grass
grayy	gray
grayyngr	gray
grayyv	gray
grbs	rbs
grbyah	grah
grbyh	grah
grdan	gordan
grdn	gran
grdnr	g
grdy	grady
grfyt	grit
grg	g
grg	g
grg	g
grgvr	g
grgvr	g
grhard	gerhard
grhart	gearhart
grhart	gearhart
grjvaysn	gran
grkv	grov
grl	girl
grly	gray
grlyk	g
grmak	mak
grmban	gremban
grm	gorm
grnandr	andr
grnd	grand
grndmstr	g
grndydyr	grundy
grn	gran
grngr	g
grnjr	jr
grnjr	jr
grnly	gray
grnsyng	g
grnt	grant
grnvyl	g
grnycr	cr
grny	gony
grqty	grasty
grsaph	caph
grsdvrf	gersdorf
grs	greers
grs	greers
grsldys	gradys
grsr	sr
grstl	gerstl
grsty	grasty
grstynn	glynn
grta	greta
grtcn	gran
grt	grit
grt	grit
grtrvd	gd
grtrvyd	gd
grvby	gray
grv	grov
grvgvry	gary
grvhvl	g
grvlayt	gray
grvlyt	grit
grvm	g
grvnr	g
grvnvald	bald
grvnynk	g
grvs	gris
grvsjvhan	gran
grvsk	ask
grvsr	sr
grvsy	gray
grvt	grit
grvt	grit
grvthavs	avs
grvvr	g
grvvy	gray
grvyncm	cm
grvyn	gran
grvynlnd	grand
grvynvld	gd
grybh	grah
grybl	g
grybyh	grah
gryf	graf
gryf	graf
gryfr	fr
gryfr	fr
gryfr	fr
gryfy	gary
gryfys	garrys
gryfyts	grants
gryfytz	gritz
gryg	g
gry	gary
grygr	g
grygvr	g
grykv	grov
grylk	grilk
grylnbk	bk
grynbrg	g
gryndly	gary
gryng	g
gryngh	grah
gryn	bryn
gryngr	g
grynham	grinham
grynj	g
grynjr	jr
grynsvn	bryn
grynvald	bald
grynv	grov
grynvp	g
grynvvd	gd
grynyas	nyasas
grynyj	g
grypnkrl	girl
gryr	cyr
grysayld	gd
grys	garrys
grysld	gd
grysldys	gradys
grysmvr	g
grysr	sr
gryst	grist
grysvald	bald
grysvld	gd
grysvn	gran
grysyld	gd
grysyldh	grah
gryt	grit
gryts	grants
grytz	gritz
grytzn	gran
grytzvn	gran
gryvl	g
gryvlyt	grit
gryvnvd	gd
gryyn	bryn
gryynvald	bald
gryzly	grizzly
gryzvn	gran
gsan	gan
gs	gs
gskvyn	gs
gskvynh	gs
gskyn	gs
gskyns	gs
gskynz	gs
gstavvs	gustavs
gst	gs
gstl	gerstl
gtys	tys
gvada	dada
gvang	gang
gvan	gan
gvan	gan
gvanyav	av
gvard	harvard
gvbl	g
gvbyn	gwyn
gvcan	gan
gvda	dada
gvda	dada
gvda	dada
gvdal	dal
gvdard	goddard
gvdata	gudata
gvdat	gat
gvdaynaf	afaf
gvd	gd
gvdgr	g
gvdhv	g
gvdl	g
gvdman	godman
gvdmn	mn
gvdnaf	afaf
gvdram	ram
gvdran	gran
gvdrv	g
gvdrv	g
gvdryc	c
gvdsn	sn
gvdsvn	g
gvdvyn	gwyn
gvdvyn	gwyn
gvdyng	g
gvdyn	gwyn
gvdyr	cyr
gvdyvayn	ayn
gvdyvyn	gwyn
gvgan	gan
gvgr	g
gvgvan	gan
gvhd	gd
gvh	g
gvhyn	gwyn
gvkyanv	g
gvland	goland
gvlan	gan
gvldyng	g
gvl	g
gvlsby	gatsby
gvlt	lt
gvlvmb	mb
gvly	lyly
gvmz	g
gvmz	g
gvnar	ar
gvnna	gonna
gvntvrp	g
gvnvt	g
gvny	gony
gvnzals	als
gvnzals	als
gvnzalv	g
gvnzalz	gonzalez
gvpala	gopala
gvpalan	gopalan
gvpta	gupta
gvpth	gath
gvpvl	g
gvpynat	gat
gvralavala	ala
gvral	gural
gvralp	guralp
gvran	gran
gvrapartap	gurupartap
gvraspy	grasty
gvrav	gorav
gvrbrg	g
gvrdf	f
gvrd	gd
gvrd	gd
gvrdn	g
gvrdyn	gwyn
gvrgan	gan
gvrganz	gan
gvr	g
gvr	g
gvrky	gorky
gvrl	girl
gvrly	lyly
gvrm	gorm
gvrmt	mt
gvrnal	gornall
gvrny	gony
gvrtvn	g
gvrv	g
gvrvsamy	amy
gvrvytz	gatz
gvry	gary
gvryk	g
gvryncm	cm
gvryndr	andr
gvryng	g
gvrynmn	bryn
gvrys	garrys
gvsf	f
gvs	gs
gvstav	gustav
gvstavs	gustavs
gvstavvs	gustavs
gvstlv	g
gvsvl	g
gvsvyl	g
gvsy	g
gvthard	gotthard
gvtjs	gs
gvtlyb	yb
gvty	ty
gvtyk	g
gvvdgr	g
gvvdyng	g
gvvrd	gd
gvvvsys	gipsys
gvvyndr	andr
gvyat	gat
gvydv	g
gvy	g
gvykarys	garrys
gvylam	lam
gvyl	g
gvyl	g
gvyl	g
gvylrmv	g
gvyn	gwyn
gvyn	gwyn
gvyvda	dada
gvyydv	g
gvyyjr	jr
gvyylym	lyly
gvyyn	gwyn
gvzvytz	gatz
gyanasy	gnagy
gyat	gat
gybsn	sn
gybsvn	g
gybvny	gony
gybvnz	g
gybvr	g
gydry	gary
gydv	g
gydvn	g
gydz	g
gyft	gift
gy	g
gygr	g
gyjsbrtas	gas
gyjsbrtvs	gs
gylagly	lyly
gylam	lam
gylam	lam
gylbay	bayly
gylbrt	art
gylfrd	gd
gylfvrd	gd
gyl	g
gyl	g
gyl	g
gyl	g
gylmn	mn
gylmn	mn
gylmr	mr
gyln	ln
gylnr	g
gylpyn	gwyn
gylr	lr
gylrm	gorm
gylrmv	g
gylrvy	g
gylry	gary
gylspay	gay
gylspy	g
gylt	lt
gylvt	g
gylyam	am
gyly	lyly
gyly	lyly
gylys	gs
gylys	gs
gylyta	ga
gylyz	lyly
gylyz	lyly
gyml	g
gymnv	g
gymnz	g
gyn	gwyn
gynkz	g
gynsbrg	g
gyntn	gwyn
gyntvn	gwyn
gypjh	g
gypn	g
gyrard	gerard
gyr	cyr
gyr	cyr
gyrhart	gearhart
gyrtrvyd	gd
gyrtsn	sn
gyrvlayt	g
gyrvlyt	g
gysbrtvs	gs
gys	gs
gysh	gish
gysylda	gilda
gytard	guitard
gyt	g
gyt	g
gytgy	g
gytlmn	mn
gytlyn	glynn
gytn	g
gytnyk	g
gyts	gs
gytvmr	mr
gytvnd	gd
gyvf	f
gyvlyty	lyly
gyvn	g
gyvvany	gony
gyvvn	g
gyvyn	gwyn
gyvz	g
gyyankvla	lanka
gyzav	av
haba	haba
habrdr	haber
habr	haber
habr	haber
habrkam	ham
habrlc	haba
habrmn	han
habrt	habert
habs	ahabs
habvra	haba
habvrg	haba
habyn	han
habz	haba
hachaltr	hal
hacynsvn	han
hacynz	hack
hacysvn	han
hadgz	haddad
hadlnd	hadland
hadlstvn	han
hadly	hadley
hadramat	hadramawt
hadramavt	hadramawt
hadsn	han
hadsvn	han
hadsvn	han
hadvba	haba
hadya	hadaya
hady	haddy
hadyl	haddy
hafbk	hak
hafmn	han
hafmn	han
hafmn	han
hafnylyng	hafs
hafr	hafer
hafsah	hafsah
hafs	hafs
haga	haga
hagan	hagan
hagard	haggard
hagard	haggard
hagdal	hal
hag	ag
hagkynz	haga
haglr	hagler
haglyn	glynn
hagmn	hagan
hagmn	hagan
hagn	hagan
hagr	hagar
hags	ags
hagsvn	hagan
hagtn	hagan
hagyn	hagan
hahtaha	haba
haj	haj
hajkynz	haj
hajr	haj
hajrz	haj
hajs	haj
hajyr	haj
hajz	haj
hakabay	hay
hakdt	hak
hak	hak
hak	hak
hakly	hak
haknys	hays
haksa	hak
haksav	hak
haks	hak
haksl	hak
haksv	hak
hakvlynn	hann
hakvyl	hak
haky	hak
hakyng	hak
halam	hallam
halan	han
halat	halat
haldr	haldre
halfldr	haldre
halgr	hal
hal	hal
hal	hal
halkdys	haleys
halk	chalk
halknr	hal
halm	halm
halmn	halm
halnd	hand
haln	hal
halpyn	halpin
halr	hal
halr	hal
halrt	hart
halstd	halsted
halst	hals
haltgrn	hal
haltsyngr	hal
haltvn	hal
haltz	hal
halvb	hal
halybrtvn	hal
halydy	haddy
halyfyld	harald
haly	hal
haly	hal
halymn	lymn
halyvl	hal
halzr	hal
hamacy	hamam
hamah	hamah
hamans	hamans
hamanz	hamam
hamarkvyyst	hamam
hambyg	ham
hambyj	haj
hamd	ham
hamfry	fry
hamfryz	ham
hamfryz	ham
hamh	h
haml	hal
haml	hal
hammanz	hamam
hamns	hamans
hampryvn	ham
hampsayr	ham
hampsyr	ham
hamptvn	hampton
hamr	ham
hamsayr	hams
hamvnd	hand
hamvndz	ham
hamy	amy
hamyl	hal
hamyltn	ham
hamyltvn	ham
hanafvrd	hanan
hana	hanaa
hanbvt	han
handl	hand
handrsvn	han
hang	chang
hangrfvrd	hand
han	han
hankh	hank
hanklr	hank
hankz	hank
hansakr	hans
hansn	han
hansn	han
hansr	hans
hansvn	han
hansvn	han
hant	anant
hantyngtvn	han
hanv	han
hanya	han
hanyfa	hanifa
hany	han
hanyh	h
hanymn	han
hapkarft	hart
hapkraft	kraft
hapkrft	hart
hapkynz	hinz
hapr	apr
hapsvn	han
harald	harald
haraldsn	haraldsen
harary	harry
haratz	haratz
harbd	harbud
harbr	har
harbr	har
harbr	har
harbrn	harburn
harbryj	haj
harbvd	harbud
harbvr	har
harbyg	har
harbyj	haj
hardn	harden
hardymn	hardy
hardyng	harding
hardyn	hardy
hardysvn	hardy
hargravz	harare
har	har
harkl	hal
harkr	har
harkvm	ham
harkyn	harkin
harkynz	har
harld	harald
harld	harald
harl	hal
harlnd	harland
harln	harlan
harlv	harv
harman	harman
harmanvs	harman
harmn	harman
harmnvs	harms
harmvtv	harv
harmz	har
harnr	har
harp	har
harpr	har
harpvld	harpold
harr	har
harryg	harry
harsa	harsha
hars	hadars
hars	hadars
hartag	hart
hartah	hart
hartfyld	hartfield
hart	hart
hart	hart
hartl	hart
hartlp	hartlep
hartly	hartley
hartmn	hartman
hartr	har
hartvl	hart
hartvyl	hart
hartygan	hartigan
harvard	harvard
harv	harv
harvhysa	harsha
harvld	harvard
harvl	harv
harvn	harv
harvn	harv
harvny	harv
harvy	harv
harycn	han
haryharan	hariharan
harykn	han
harynkar	har
harys	harrys
harysvn	harrys
haryv	harv
haryz	har
hasakah	hasakah
hasal	hal
hasbrvk	hasbro
hasby	hay
has	haas
has	haas
haskal	hal
hask	ask
haskl	haskel
haskl	haskel
haskynz	haas
haslvm	haslum
hasmn	han
hast	haste
hasttlr	har
hastvn	han
hastyngz	haste
hasyk	hak
hatap	hate
hatcsvn	han
hatcynsvn	han
hatcynz	haratz
hatcysvn	han
hat	halat
hatlndnsys	hans
hatly	hay
hatm	ham
hatmykr	har
hatr	har
hatrl	hal
hatvn	han
hatvn	han
hatvry	harry
havard	havard
havdvn	han
havgtaylyng	hay
hav	av
hav	av
hav	av
havk	hak
havk	hak
havkr	har
havkyn	han
havkynz	hinz
havl	hal
havly	hay
havlz	hz
havn	han
havn	han
havs	avs
havsr	har
havtvn	han
havtylyng	tyng
havtyn	han
havvla	havola
havvnn	hann
havy	hay
havys	hays
haybrd	hay
haybz	hay
hayc	hay
haydar	hadar
hayd	hay
haydmn	haydn
haydn	haydn
haygdan	han
hayky	hay
haylnd	hand
haylt	hay
haylvrd	hay
hayly	hay
haym	ham
hayngh	h
hayn	ayn
hayn	ayn
haynly	hay
hayns	hans
hayns	hans
hayny	hay
haynz	hay
haynz	hay
hayply	hay
hayr	har
hayrvnymvs	hays
hayslvp	hays
haysvn	hays
haytr	hayter
hayts	hays
haytz	hay
hayvard	harvard
hayvkynsvn	ayn
hayvkz	hay
hayvl	hal
hayz	hay
hayz	hay
hazn	han
hbntvn	h
hbrn	horn
hbrvq	h
hbvrn	horn
hbyba	ba
hbybh	h
hdad	haddad
hdak	hak
hdavy	davy
hdaya	hadaya
hdaya	hadaya
hdaydah	hudaydah
hd	d
hdlnd	hand
hdlnd	hand
hdlvnd	hand
hdly	holy
hdramavt	hadramawt
hdramvt	h
hdrmat	mat
hdryk	h
hdsa	a
hds	ds
hdya	a
hdyda	ayda
hdydh	h
hdyh	h
hdyl	h
hdyn	ayn
hfrvn	hf
hfsa	hfs
hfsah	hafsah
hfs	hfs
hfsh	h
hgarty	hegarty
hglnd	hand
hgtylyng	hg
hgy	hg
hgy	hg
hgyr	hg
hhmn	mn
hjr	jr
hjry	fry
hk	h
hkr	kr
hkr	kr
hksav	av
hksv	h
hkt	h
hktvr	h
hkym	h
hkyng	hg
hkzn	zn
hlab	halab
hlal	dalal
hlan	han
hlavyn	hlavin
hlb	b
hlblyng	helbling
hlbyg	hg
hlbyng	hg
hld	d
hldn	h
hlfmn	mn
hlga	helga
hl	h
hlkant	kant
hlk	h
hllr	lr
hlmn	mn
hlmn	mn
hlmnstayn	ayn
hlmr	mr
hlmz	hz
hlmz	hz
hlna	na
hlnd	hand
hlndr	andr
hln	ln
hln	ln
hlr	lr
hlstrvm	ahlstrom
hlt	helt
hltlandnsys	hans
hltlndnsys	hans
hltvn	h
hlv	h
hlvj	h
hlvm	h
hly	holy
hly	holy
hlyndn	lyn
hlyvl	h
hlzgng	hg
hlzmn	mn
hmah	h
hmam	hamam
hmans	hamans
hmanz	danz
hmar	har
hmbayj	h
hmbyj	h
hmdan	hamdan
hmd	md
hmh	h
hml	h
hmp	h
hmpsayr	dayr
hmpsr	sr
hmra	hamra
hmr	mr
hmr	mr
hmr	mr
hmstd	d
hmsyrh	h
hmyd	d
hmyltn	h
hmyltvn	h
hmza	hamza
hmz	hz
hmzh	h
hna	na
hna	na
hnan	hanan
hnclyf	hf
hnd	hand
hndl	h
hndrsn	hahn
hndrsvn	hahn
hndrycvz	hz
hndrycy	landry
hndryka	a
hndrykas	andras
hndryk	h
hndrykh	h
hndrykj	h
hndrykjh	h
hndryks	hendriks
hndryks	hendriks
hndryks	hendriks
hndryksh	h
hndryksn	hahn
hndryksvn	hahn
hndrykvs	hs
hndryky	landry
hndy	handy
hndz	hz
hn	hahn
hn	hahn
hnj	h
hnjy	h
hnkl	akl
hnks	hanks
hnl	h
hnly	heinly
hnnfnt	hunt
hnryk	h
hnryt	h
hnsly	sly
hnsn	hahn
hnt	hunt
hnth	h
hntj	h
hntjh	h
hntyg	hg
hnya	a
hnyfa	a
hnyfh	h
hnygan	gan
hnyg	hg
hny	h
hny	h
hnyj	h
hnyk	h
hnyngsn	hahn
hny	h
hnz	hinz
hpkraft	kraft
hplr	lr
hqyr	cyr
hraby	raby
hrak	hak
hran	han
hranyky	hranicky
hrayzyng	hg
hrbayj	h
hrbrt	hart
hrbvrt	hart
hrbyj	h
hrdasfyld	herd
hrd	herd
hrd	herd
hrdsfyld	herd
hrdzfyld	herd
hr	h
hrlayndyz	hz
hrlndys	andys
hrlvy	h
hrlyndys	andys
hrman	harman
hrman	harman
hrman	harman
hrman	harman
hrmans	hermans
hrmn	mn
hrmn	mn
hrmn	mn
hrmn	mn
hrmnvs	hs
hrmnyvs	hs
hrms	harms
hrmvsv	h
hrmz	hz
hrnaky	laky
hrnandz	anand
hrndvn	horn
hrn	horn
hrn	horn
hrn	horn
hrnkr	kr
hrnsbay	hay
hrra	hera
hrsfal	horsfall
hrt	hart
hrtlyng	hertling
hrtvk	h
hrv	harv
hrvn	h
hrvnymvs	hs
hrvs	hs
hrvy	h
hryk	h
hrykn	h
hryng	hg
hryngsav	av
hrys	harrys
hrysvn	h
hryt	h
hryvl	h
hsaka	aka
hsakah	hasakah
hs	hs
hs	hs
hsh	h
hskah	h
hskh	h
hsmans	klansmans
hsmns	hs
hsna	hasna
hsn	hosn
hsn	hosn
hst	hs
hstr	hs
hstyngz	hs
hsymanz	hyman
hsyn	hs
hsyn	hs
hsyn	hs
hsyn	hs
htcr	cr
htkvks	hs
htryk	h
htzlr	lr
hvadly	bradly
hva	va
hvar	har
hvbr	br
hvbrmn	mn
hvbvrvg	hg
hvbvrv	harv
hvbvrvq	h
hvcynsvn	ayn
hvdaydah	hudaydah
hvdgy	h
hvd	d
hvdkyns	hans
hvdkynz	hinz
hvdsn	hosn
hvdsvn	h
hvfgard	hofgaard
hvfrd	herd
hvfryn	bryn
hvft	h
hvgan	gan
hvgard	hugard
hvgard	hugard
hvgarty	hegarty
hvg	hg
hvg	hg
hvg	hg
hvglnd	hand
hvgnbvm	h
hvgn	h
hvgs	hgs
hvgtaylyng	ayling
hvgtylyng	tyng
hvgv	h
hvgvyn	ayn
hvhnsvn	hahn
hv	h
hv	h
hvk	h
hvkn	h
hvland	hand
hvldn	h
hvldzvrs	hs
hvl	h
hvl	h
hvlkamb	kamb
hvlknr	h
hvlm	halm
hvlmn	mn
hvlmz	hz
hvlndnsys	hans
hvlrvyd	d
hvls	hals
hvlstn	h
hvltlndnsys	hans
hvlymn	lymn
hvlzn	zn
hvlzvars	ars
hvmak	hak
hvm	h
hvm	h
hvmn	mn
hvng	hg
hvnygbrg	hg
hvp	h
hvp	h
hvpr	apr
hvqtylyng	tyng
hvqym	h
hvrgan	horgan
hvrkan	horkan
hvrn	horn
hvrnr	h
hvrsfvrd	herd
hvrst	herst
hvrtmn	mn
hvrtr	h
hvrvat	horvat
hvrvt	h
hvrvvytz	hitz
hvrvytz	hitz
hvrygmv	h
hvryhan	han
hvry	fry
hvryng	hg
hvryv	h
hvs	hs
hvsmn	mn
hvstvn	h
hvtn	h
hvvart	hart
hvvn	h
hvvr	h
hvya	a
hvybrg	hg
hvyd	d
hvygn	h
hvyjn	h
hvyman	hyman
hvyng	hg
hvysr	sr
hvyt	h
hvytynk	hank
hvyyskn	h
hvz	hz
hybax	dax
hybrg	hg
hybrt	hart
hybvrn	horn
hycmn	hyun
hycns	hans
hydajat	hidajat
hydland	hyland
hydn	haydn
hydn	haydn
hydnr	hyde
hydr	hydra
hydryc	hydra
hydrys	hydras
hyfa	a
hyflr	lr
hyftz	hitz
hygarty	hegarty
hygl	h
hygn	hyun
hygrmn	hyun
hygvnt	hunt
'hyh	h
hy	h
hyjdan	dan
hyjmn	hyun
hykarv	harv
hyk	h
hykmn	hyun
hyksvn	hyun
hykv	h
hyky	h
hyky	h
hylbry	fry
hyldbrand	hyland
hyld	hyland
hyl	h
hyl	h
hyl	h
hyl	h
hyl	h
hylkr	kr
hylmr	mr
hylnbrnd	hyland
hylnd	hyland
hylnd	hyland
hylnth	h
hylry	fry
hyls	hals
hylsntygr	h
hylsvn	hyun
hylt	helt
hylth	h
hylt	helt
hyltj	h
hyltjh	h
hyltjh	h
hyltj	h
hyltn	hyun
hylyard	hillyard
hyly	lyly
hylyrstyn	lyn
hylys	hays
hylyth	blyth
hylz	hz
hym	h
hymn	hyman
hymn	hyman
hymstd	d
hyncly	holy
hyncy	dancy
hynd	hand
hyndryka	hydra
hyngan	mangan
hyng	hg
hyn	hyun
hynj	h
hynly	heinly
hynr	h
hyns	hynes
hyns	hynes
hyns	hynes
hynsvn	hyun
hyntvn	hyun
hyntz	heintz
hynv	h
hynvnn	hann
hynvz	hz
hynz	hinz
hynz	hinz
hynz	hinz
hynz	hinz
hynz	hinz
hypgryv	h
hyp	h
hyps	hs
hyray	hay
hyrdgn	hyun
hyrd	byrd
hyrly	holy
hyrn	horn
hyrnh	h
hyrn	horn
hyrt	hart
hyrvnymas	hyman
hyrvnymvs	hs
hyrvta	ta
hysan	han
hys	hays
hyskvks	hays
hyskvt	h
hyslap	hyslop
hysl	hyslop
hyslvp	hyslop
hysmans	klansmans
hysmns	mns
hysr	sr
hytn	hyun
hytr	h
hytr	h
hyts	hs
hytsvn	hyun
hytvn	hyun
hytz	hitz
hytz	hitz
hyvard	harvard
hyvgn	hyun
hyv	h
hyvkynz	hinz
hyvm	h
hyvngan	mangan
hyvnsv	h
hyvvyt	h
hyvz	hz
hyvzr	zr
hyyn	hyun
hyz	hz
hyzman	hyman
hyzmans	hamans
hyzmns	mns
hyzmnz	hinz
hyzymnz	hinz
hzltvn	hz
hzmnz	hz
jabjh	h
jab	joab
jab	joab
jad	d
jad	d
jad	d
jagard	jagard
jag	ag
jagr	jager
jagv	jago
jahmanh	jahmane
jahns	jans
jakamynth	jamih
jaksvn	jan
jakvas	javas
jakvbh	jake
jakvb	jake
jakvbjh	jake
jakvbj	j
jakvbs	jakes
jakvbsvn	jan
jakvbsvn	jan
jakvby	jay
jakvbz	jake
jakvmyntay	jay
jakvmyntyh	jake
jakvmynty	jay
jakvmyt	jake
jakvs	jakes
jakvyz	jake
jakvz	jake
jakyvz	jake
jala	jala
jalvnn	jann
jamvna	jamuna
jana	jana
janardhan	janardhan
janatvn	jan
jancs	jans
jang	jang
jang	jang
jang	jang
jangnykl	jang
jangr	jang
jangtayy	jay
jan	jan
jan	jan
jan	jan
jan	jan
jank	jan
jank	jan
jankynsvn	jan
jansh	jans
jans	jans
jansjh	jans
jansj	jans
jansky	jansky
jansn	jan
jansn	jan
jansvn	jan
jansvn	jan
janth	jan
jant	jayant
jant	jayant
jantj	j
jantvj	j
jantyh	jan
janvth	jan
janvt	jan
janvtjh	jan
jany	jan
janyka	jana
janz	jan
janz	jan
jap	gap
japjh	h
japj	j
jaras	aras
jarbvt	jarbot
jardyn	jan
jars	jamars
jart	art
jarvala	jala
jarvys	jarvis
jarytjn	jan
jasck	jack
jas	janas
jaspr	jasper
jasprz	jasper
jastam	stam
jastas	stas
jastjh	jarash
jastj	j
jast	east
jastjy	jay
jastyh	jarash
jastyn	jan
jastyn	jan
jastyn	jan
jastyn	jan
jastys	janas
jasva	java
jasvyndr	jasvinder
jatjy	jay
jatyndr	andr
javf	java
javyd	javed
javyka	java
javyr	java
jayan	jayan
jayant	jayant
jayaram	jayaram
jayn	ayn
jayn	ayn
jaynvr	jay
jayp	jay
jbhh	h
jbh	h
jbyr	jr
jdy	jody
jf	f
jf	f
jfkk	j
jfry	fry
jfryz	fry
jhamanh	hamah
jhang	jhang
jhan	han
jhar	har
jhmanh	h
jhra	jahra
jkbs	bs
jk	j
jkmn	mn
jkmn	mn
jksvn	j
jkvbs	bs
jkvbsvn	j
jkvbz	j
jkyn	ayn
jla	jala
jlal	jalal
jl	j
jlj	j
jlny	j
jlth	th
jlt	lt
jltjh	h
jlvmark	mark
jmal	jalal
jmal	jalal
jmar	jamar
jml	j
jml	j
jmml	j
jmvla	jala
jmyla	layla
jmylah	lylah
jmyla	layla
jmyl	j
jmylh	h
jmylh	h
jmyl	j
jnah	nahnah
jna	jana
jndryav	av
jndryc	c
jng	jang
jng	jang
jn	j
jnk	junk
jnk	junk
jnks	jenks
jnks	jenks
jnkynsvn	ayn
jnkz	j
jnt	j
jntjs	js
jntry	gantry
jnyfr	fr
jnykh	h
jnyk	j
jnyngz	j
jnyrv	j
jnysylda	dada
jpsn	sn
jpy	j
jrada	dada
jrald	jerald
jrard	ararat
jrard	ararat
jrardy	hardy
jrgnz	jr
jrhard	erhard
jrmyas	jrs
jrmy	jr
jrmyk	jr
jrmys	jrs
jrs	jrs
jrstl	jrs
jrtrvd	jr
jrvnymvs	jrs
jrvnyvs	jrs
jrvys	jrs
jryng	jang
jryngr	jr
jrytsma	asma
jryty	jory
jrytzvn	jr
jsf	js
jspr	jr
jstr	jr
jstvn	js
jsyka	js
jsyk	js
jtrv	j
jtsam	jetsam
jvab	joab
jvana	jana
jvandr	andr
jvang	jang
jvan	jan
jvan	jan
jvanyta	tanya
jvav	av
jvay	jay
jvbal	jalal
jvbj	j
jvb	b
jvb	b
jvbyn	ayn
jvdas	dadas
jvd	d
jvdy	jody
jvdy	jody
jvf	f
jvf	f
jvfl	j
jvgla	jala
jvhana	jana
jvhan	han
jvhansn	anshan
jvhansn	anshan
jvhansvn	anshan
jvhansvn	anshan
jvhansvn	anshan
jvhany	many
jvhanz	danz
jvhanz	danz
jvlay	jay
jvl	j
jvl	j
jvltz	oltz
jvlyanth	jayant
jvlyantjh	jayant
jvlyantj	j
jvlyant	jayant
jvlyany	joly
jvlyf	f
jvly	joly
jvly	joly
jvly	joly
jvnas	janas
jvngan	mangan
jvnganz	danz
jvn	j
jvn	j
jvn	j
jvnv	j
jvny	j
jvnyn	ayn
jvnyvr	jr
jvprv	j
jvrah	jurah
jvra	ra
jvran	jan
jvravlv	av
jvrgnz	j
jvrj	j
jvrjn	j
jvrjn	j
jvrjya	a
jvrjyv	j
jvrk	ark
jvrvytz	j
jvry	jory
jvryng	jang
jvrysma	asma
jvrytsma	asma
jvs	js
jvslyn	lyn
jvsth	th
jvstj	j
jvsty	ty
jvsva	java
jvsvyg	g
jvsyp	j
jvtlyn	lyn
jvvn	j
jvydyp	j
jvynr	jr
jvynr	jr
jvysf	f
jvys	joys
jvyt	j
jvyt	j
jvza	juza
jvzf	f
jvzfvs	js
jvzp	j
jvzy	j
jvzyh	h
jvzy	j
jvzy	j
jyaf	afaf
jya	a
jyakvb	b
jyan	jan
jyany	many
jyavrdany	danny
jybsvn	j
jybyns	dobyns
jygang	gang
jy	j
jy	j
jyjsbrtvs	js
jykmn	mn
jylam	lam
jylbrt	jurt
jyl	j
jylt	lt
jylyan	jan
jylz	elz
jym	j
jyml	j
jymsvn	j
jymy	amy
jymyny	amy
jymz	j
jymz	j
jymz	j
jynakyraman	janakiraman
jyng	jang
jyn	ayn
jyn	ayn
jyn	ayn
jyn	ayn
jyn	ayn
jyns	jans
jyntvn	ayn
jynyk	j
jynz	j
jyph	h
jyrardyn	ararat
jyrmaska	laska
jyrvsk	ask
jysh	josh
jys	joys
jysr	jr
jystr	jr
jysvz	j
jyta	ta
jyvk	j
jyvrdanv	jordan
jyvvany	many
jyvvyl	j
jyvyl	j
jyzan	jan
jyzn	zn
jyzsbrtvs	js
jzyrh	rh
kab	kalb
kabrylv	k
kaclyng	kang
kacv	k
kacvn	kan
kacy	kay
kacyh	h
kadlask	alaskas
kadmn	kaden
kadmvs	kado
kadn	kaden
kadrybysyk	k
kadrykys	katys
kadv	kado
kadyn	kaden
kafry	fry
kafy	kafka
kafyn	kafka
kagbvrn	karn
kagl	kagle
kagl	kagle
kaglyn	glynn
kagsal	kabal
kagsvl	karl
kahan	kan
kahvn	kan
kakalk	kalkan
kakands	kanaka
ka	kafka
kakbryd	kaki
kakdkar	kakodkar
kakraft	kraft
kakryl	kaki
kakshd	kaki
kaktvs	kafkas
kaky	kay
kakyvla	kanaka
kakyvr	kar
kala	kalevala
kalafatas	kalafatas
kalafvt	kalafut
kalahan	kalkan
kalanan	kalkan
kalatvr	kalathur
kalbavt	kalb
kalb	kalb
kalb	kalb
kalbryj	kalb
kalbyda	kalb
kal	kabal
kaldl	kabal
kaldvl	kabal
kaldvl	kabal
kaldys	kaldis
kalhyn	kalkan
kalhynh	kalb
kal	kabal
kalkan	kalkan
kalklasvr	kasmalkar
kalman	kalman
kalmn	kalkan
kalmn	kalkan
kalmys	kalmyk
kalpak	kalpak
kalpana	kalpana
kalps	alps
kalpyn	kalkan
kalr	kar
kalrty	karty
kalry	kay
kalsgh	kalb
kalsvn	kalkan
kalsyn	calsyn
kalt	kalt
kaltvn	kalkan
kalv	kalev
kalvm	kam
kalvnlv	kalev
kalvrt	kalt
kalvyn	kalkan
kalya	alya
kalyan	kalyan
kalyany	kalyan
kalyarv	kalyan
kaly	kay
kalygy	kay
kalyla	kayla
kalynsan	kansan
kalynt	kalt
kalynz	kalb
kalys	kalbs
kalys	kalbs
kalysyak	kayak
kalyyvs	kalbs
kamacv	kama
kamala	kamala
kamal	kamal
kamama	kama
kamar	kar
kamat	kama
kamb	kamb
kambs	kamb
kambytz	kamb
kambyy	kamb
kambz	kamb
kamdar	kamdar
kamhvlz	kamholz
kam	kam
kam	kam
kaml	kam
kamln	kam
kamlys	kam
kamn	kam
kamns	kamens
kampagna	campagna
kampar	kar
kampbl	kam
kamp	kam
kampr	kamper
kamptvn	kam
kampvs	kam
kampylv	kam
kampyvtr	kamper
kamr	kam
kamrvd	kam
kamrvn	kam
kamrvs	kam
kamskaya	kamskaya
kamstak	k
kamya	kama
kamyng	kang
kamyn	kam
kamyv	kam
kanakakvrn	kanakakorn
kana	kana
kanak	kanak
kanal	kanal
kanal	kanal
kanan	kannan
kanava	kana
kanbvy	kan
kan	kan
kandayv	kanda
kandly	kan
kandv	kan
kandvyyt	kant
kandy	andy
kanfr	kan
kanfyld	kan
kang	kang
kang	kang
kang	kang
kan	kan
kanknt	kant
kanln	kan
kanly	kan
kanly	kan
kann	kannan
kanr	kan
kanrly	kan
kanrvy	kan
kansl	kansans
kanstabarys	kansans
kanstabv	kansans
kantara	kara
kanth	kant
kant	kant
kant	kant
kantra	kana
kantr	kant
kantrl	kant
kanv	kan
kanvry	kan
kanya	kana
kanyf	kan
kanyg	kang
kanyngham	kam
kanys	kans
kanysna	kana
kanytz	katz
kanyvn	kan
kanzy	kan
kapa	kapalka
kapanga	kapanga
kap	kapp
kapk	k
kaplan	kaplan
kapln	kaplan
kaplynk	kaplenk
kapnr	kapner
kapral	kapral
kaps	gaps
kapsvn	kapson
kapvr	kar
kapyla	kayla
karabvlvt	ararat
karagr	kar
karahr	kar
kara	kara
karanjlv	karan
karan	karan
karara	kara
karasa	kara
karas	karas
karaskv	karas
karasv	karas
karayl	karayel
karbajal	carbajal
karbala	karbala
karbn	karn
karbvnly	kar
karbvnya	kara
kar	kar
kardal	kardal
kardl	kardal
kardl	kardal
kardlys	kar
kardnas	karas
kardynaly	kardal
kargyl	karl
karhart	carhart
karkarn	karn
karkas	karas
karlayl	karl
karl	karl
karl	karl
karlkvyst	karl
karls	karls
karlsvn	karls
karltvn	karl
karltvn	karl
karlvs	karls
karlvt	karl
karlyn	karyn
karlyn	karyn
karman	karmann
karmvdy	kar
karmvna	kana
karmycayl	karl
karn	karn
karn	karn
karnlyan	kalyan
karnr	kar
karnry	karn
karnya	kara
karny	karn
karny	karn
karnz	karn
karp	karp
karplas	karlas
karpntr	kar
karpntyr	kar
karstnsn	karn
karstnz	kar
karsvn	karn
karsvn	karn
kart	art
kartnr	kar
kartrayt	ararat
kartr	kar
kartvyz	kar
karty	karty
kartyk	karty
kartyr	kar
kartys	karty
karvlyn	karyn
karvr	kar
karvsv	kar
karvsv	kar
karvyn	karyn
karyaga	arya
kary	kar
kary	kar
karyda	kara
karydyan	yaryan
karyh	kar
karyjr	kar
kary	kar
karylv	kar
karyra	kara
karys	karyns
kasak	k
kasama	kasama
kasam	kassam
kasanvva	kana
kasara	kara
kasat	kasat
kasgrvh	kafkas
kasl	kafkas
kaslmn	kan
kasm	kam
kasmn	kan
kasmycy	kasey
kasnr	kar
kasnyr	kar
kasprzak	kasprzak
kasrtynv	karty
kasryl	kafkas
kasta	kast
kastanv	kast
kastlv	kast
kastlv	kast
kastnr	kastner
kastnr	kastner
kastrcm	kast
kastrgyn	kast
kastr	kast
kastrv	kast
kastrykam	kam
kastrykvm	kast
kastryvm	kast
kastvl	kast
kastvry	kast
kasty	kasaty
kastylv	kast
kastyn	kast
kasvf	kafkas
kasvn	kan
kasy	kasey
kasyng	kang
kasynly	kasey
kasynsky	kandinsky
kasyv	kafkas
kata	katta
katalanv	atalanta
katan	kattan
kataryn	karyn
katb	kateb
katbrt	kasat
katcy	katy
katkart	art
katl	karl
katl	karl
katlmn	kan
katlr	kar
katlyr	kar
katn	kan
katr	kar
katrntj	kaj
katryj	kaj
katryjn	katrin
katry	katy
katryna	katrina
katryna	katrina
katryn	karyn
katryn	karyn
katryn	karyn
katryn	karyn
katryn	karyn
katrynth	kathryn
katryntjh	katryntje
katryntj	katryntje
katrynty	katy
katvala	kalevala
katvpys	katys
katy	katy
katyng	kang
katz	katz
kavasyn	kan
kavayy	kay
kav	av
kav	av
kavdlyng	kang
kavdyl	karl
kavh	kaveh
kavh	kaveh
kav	av
kavly	kay
kavly	kay
kavlyng	kang
kavn	kan
kavrz	katz
kavs	avs
kavstn	kan
kavyta	kavita
kaya	kaya
kayak	kayak
kay	kay
kayk	k
kaylas	kaylas
kayl	kay
kayn	ayn
kayn	ayn
kayny	kay
kaypr	kar
kayras	karas
kayrd	kay
kayrvf	kay
kaysr	kayser
kayt	kay
kayt	kay
kazdan	kazdan
kazgryf	kazi
kazmayr	kazmaier
kazvhyrv	kazi
kazvnvzy	kay
kazy	kay
kazyr	kar
kazyrr	karr
kbakyan	banan
kbakybv	akbar
kbanys	albanys
kbrg	g
kbr	br
kbyr	kr
kbyr	kr
kcng	kang
kdavr	kr
kd	d
kdl	k
kdl	k
kdr	dr
kdym	k
kdyn	ayn
kdyra	byra
kdyr	kr
kdysya	kaya
kdysyh	h
kfart	art
khv	k
kk	k
klabvrn	klan
klaf	afaf
klag	ag
klag	ag
klagstvn	klan
klak	k
klamn	klan
klamr	klammer
klanfyld	klan
klansy	klans
klantvn	klan
klarjh	klan
klark	ark
klark	ark
klar	kar
klartay	tartary
klarth	barth
klartjh	klaartje
klartj	klaartje
klartjy	klaartje
klart	art
klarty	karty
klaryj	klan
klasa	klassa
klasj	klan
klasjh	klan
klasmyr	emyr
klasn	klan
klasnr	klan
klat	klatt
klatz	katz
klavdya	kaya
klavdy	klan
klavsy	klan
klavytr	klan
klayn	klan
klayn	klan
klayr	dayr
klaysj	klan
klaysvn	klan
klaysvn	klan
klaytvn	klan
klaz	blaz
klazvra	klazura
klazyng	kang
klbay	kay
klb	kalb
klbrn	karn
klbvrn	karn
klbvrn	karn
klby	kilby
kl	akl
kldny	keny
kldvl	akl
kldvy	ivy
klflt	kalt
klkar	kar
kl	akl
kl	akl
klmanz	danz
klmbv	k
klmn	klan
klmp	klemp
klnfyld	d
kln	klan
kln	klan
klnr	kr
klrtay	kay
klrty	karty
klrvs	ks
klt	kalt
kltn	klan
kltnr	kr
klvb	b
klvbk	k
klvkynas	nas
klvly	lyly
klvmpnr	kr
klvnfrv	k
klvsn	klan
klvth	th
klvynn	kevyn
klybr	klyber
klybrn	karn
kly	lyly
kly	lyly
klyf	f
klyfrd	kurd
klyft	k
klyftvn	klan
klyk	k
kly	lyly
kly	lyly
klyla	kayla
klymr	klyber
klymvf	f
klyngrvt	k
klynk	k
klyn	lyn
klyn	lyn
klynsvrg	klug
klynz	kenz
klyr	klyber
klyr	klyber
klyr	klyber
klyr	klyber
klyrtyh	h
klys	ks
klysh	kish
klytvn	klan
klyvy	lyly
kma	kama
kmal	kamal
kmal	kamal
kmbry	kory
kmbs	bs
kmbz	k
kmdr	dr
kmfvys	ks
kmfyld	d
km	k
kmkr	kr
kmllv	k
kmpastr	kast
kmpbl	k
kmp	kemp
kmp	kemp
kmpr	kr
kmpstr	kempster
kmpvs	ks
kmpy	k
kmr	kr
kmr	kr
kmr	kr
kmrvn	k
kmsptr	kr
kmstr	kr
kmylah	lylah
kmyla	kayla
kmylh	h
kmyr	emyr
knamvry	kory
knavay	kay
kndal	kendal
kndl	knel
kndryk	k
kndv	k
kndvlf	alf
kndy	andy
kndyg	g
kndy	andy
kng	kang
kng	kang
kn	k
kn	k
kn	k
knnyng	kang
knpvl	knel
knrad	konrad
knrad	konrad
knrad	konrad
knradvs	konrads
knrat	rat
knrdyng	kang
knr	kr
knsyngtv	k
knta	kenta
kntarv	harv
knvb	knob
knvfynkh	h
knvl	knel
kny	keny
kny	keny
knykrbkr	kr
knyngtvn	ayn
knyn	ayn
knysky	sky
knyvn	k
knyvn	k
knz	kenz
kpjh	h
kpl	pl
kply	lyly
kpr	kr
kprt	kert
kptan	kan
kpystran	tran
krab	krab
kra	kara
kracly	kr
kracly	kr
kracn	kr
kracr	kr
krakart	karak
krakfrd	kr
krakfvrd	kr
krak	k
krak	k
krakt	kraft
kramary	kram
kramhvrn	kram
kramr	kr
krandlmyr	kr
kransvyk	k
kransvyyk	k
kranzvyk	k
krap	kapp
krapr	kr
kraqtvn	kr
kraras	karas
krasby	kr
kras	karas
krasn	krasen
krasyk	k
kratr	kr
kratrz	katz
kratygr	kr
kratzr	kratzer
kravfvrd	kr
kravl	kr
kravly	kr
kravn	kr
kravn	kr
kravsvn	kr
kray	kay
kraydr	kr
krayg	kraig
krayg	kraig
krayj	kr
krayj	kr
kray	kay
kraysvl	kr
krazn	kr
krazyr	kr
krbla	kubla
krbl	kr
krbsr	kr
krbtry	kory
krbvnyl	kr
krbyt	kr
krc	kr
krdal	kardal
krdla	kr
krdl	kr
krdry	kory
krft	kraft
krftvn	kr
krg	kr
krg	kr
krgr	kr
krgr	kr
krhang	kang
krh	kr
kr	kr
krk	k
krkraft	kraft
krkraft	kraft
krly	kr
krlyvs	krs
krmr	kr
krmyk	k
krmyt	kr
krnay	kay
krnfrd	kr
krn	karn
krn	karn
krn	karn
krnl	kr
krnlys	krs
krnlyvs	krs
krns	kerns
krnsvyk	k
krnvl	kr
krnyz	kr
krnz	krenz
krps	krs
krray	kay
krs	krs
krs	krs
krs	krs
krskyntyh	krs
krslyk	k
krsn	krs
krsnr	kr
krsnr	kr
krsnv	krs
krspv	krs
krst	krs
krstn	krs
krsts	krs
krt	kert
krtlnd	kr
krtr	kr
krtyn	kr
krtzr	kr
krvash	kresh
krvasz	kr
krvb	kr
krvcfvrd	kr
krv	kr
krvd	kr
krvg	kr
krvkfvrd	kr
krvk	k
krvkn	kr
krvl	kr
krvm	kr
krvm	kr
krvmh	kr
krvm	kr
krvm	kr
krvmn	kr
krvmr	kr
krvmy	kr
krvmyts	krs
krvnhym	kr
krvny	keny
krvnz	krenz
krvpyk	k
krvsby	kr
krvscn	kr
krvs	krs
krvsh	kresh
krvsn	kr
krvsn	kr
krvtyv	kr
krvvd	kr
krvyl	kr
krvyn	kevyn
krvyr	kr
krvz	kr
krvzyr	kr
kry	kory
krycfyld	kr
kry	kory
kryda	ayda
krydr	kr
krygan	gan
kryg	kr
kryg	kr
krygr	kr
krygr	kr
kry	kory
kryk	k
kry	kory
kry	kory
kryla	kayla
krylas	kaylas
kryl	kr
krylyz	kr
krym	kr
krymn	kr
kryn	karyn
kryn	karyn
kryn	karyn
krynz	krenz
krypyv	kr
kryqr	kr
kryr	kr
krysan	kansan
krysayntay	kay
krys	korys
krysc	kr
krys	korys
krys	korys
krysh	kresh
krysjh	kr
krys	korys
krys	korys
krysp	kr
kryspn	kr
kryspyjn	kr
kryspyn	karyn
kryssayntyh	kr
krysta	krystal
krysta	krystal
krystal	krystal
krystal	krystal
krystal	krystal
kryst	krystal
krystlr	kr
krystmn	krystal
krystmn	krystal
krystn	krystal
krystr	kr
krystv	krystal
krystvf	krystal
krystvfr	kr
krystvfrsvn	krs
krystvn	krystal
krystvn	krystal
krystyana	kana
krystyan	ryan
krystyan	ryan
krystyansn	kansan
krysty	kristy
krysty	kristy
krystyjnth	kristys
krystyjntjh	kristys
krystyjntj	kristys
krystyna	kristys
krystyn	karyn
krystynh	kristys
krystyn	karyn
krystyn	karyn
krystyn	karyn
krystynty	kristy
krysvayjn	kr
krysvjyn	karyn
krysvyjn	kr
krysvyn	karyn
krysvzn	kr
krysy	kory
krysy	kory
krysy	kory
krysz	kr
krytr	kr
kryvas	krs
kryvasz	kr
kryvn	kr
kryvsn	kr
kryvvnvz	kr
kryyk	k
krzna	kana
ksavan	kesavan
ksav	av
ksay	kay
ks	ks
ksk	k
kskyn	ks
ksl	ks
ksl	ks
ksln	ks
kslr	kr
kst	kast
kstlak	k
kstl	ks
kstlvt	kast
kstnr	kr
kstrap	trapp
kstr	kr
kstrcm	cm
kstrsvn	ks
ksvan	kan
ksvn	ks
ksydy	ks
ksym	ks
ksym	ks
ktan	kan
ktara	kara
ktb	tb
ktcam	kam
kt	k
kt	k
ktlar	kar
ktl	tl
ktl	tl
ktlt	kalt
ktly	lyly
ktnzrv	k
ktsymatyds	mats
ktvla	la
ktvyn	kevyn
kty	katy
kty	katy
ktyl	k
ktz	katz
kvaayntn	ayn
kvaknbas	bas
kvaknbvs	ks
kva	va
kval	val
kvalsyk	k
kvanbay	kay
kvang	kang
kvang	kang
kvang	kang
kvan	kan
kvanlan	klan
kvanrad	konrad
kvanrad	konrad
kvanradt	brandt
kvanradvs	konrads
kvanrdt	kant
kvanryd	anand
kvantvn	kan
kvarsky	sky
kvartzyth	barth
kvasman	klansman
kvast	kast
kvasym	k
kvatryn	karyn
kvavryng	kang
kvaylysy	lyly
kvayman	ayman
kvayntana	santana
kvayntvn	ayn
kvayt	kuwayt
kvba	ba
kvb	b
kvb	b
kvbla	kubla
kvbn	k
kvbsa	kobsa
kvbv	k
kvbv	k
kvbyb	yb
kvbylah	lylah
kvbyla	kayla
kvcar	kar
kvc	c
kvcran	kan
kvcy	k
kvcyh	h
kvdamah	hamah
kvdama	camama
kvdvgnv	k
kvdy	k
kvganda	kanda
kvglan	klan
kvglyn	glynn
kvgvma	kama
kvhan	khan
kvhn	kuhn
kvjh	h
kvjyas	as
kvkal	kabal
kvkalyk	kalmyk
kv	k
kvkbrn	karn
kvk	k
kvkfyld	d
kvk	k
kvknbas	bas
kvknj	j
kv	k
kvk	k
kvkryl	kr
kvksvn	ks
kvktavay	kay
kvkvnn	kenn
kvkvrk	k
kvkya	kaya
kvlasa	klassa
kvl	k
kvl	k
kvlka	kafka
kvlmn	mn
kvln	ln
kvln	ln
kvln	ln
kvlnv	k
kvlr	kr
kvlsar	kar
kvls	ks
kvlsvn	k
kvlt	kalt
kvlty	kelty
kvlvl	k
kvlycala	cala
kvly	lyly
kvly	lyly
kvlyha	kuha
kvlyn	lyn
kvlyng	kang
kvlyngvvd	d
kvlyns	flynns
kvlynz	kenz
kvlyr	kr
kvlys	ks
kvmar	kar
kvmarv	marv
kvmbr	br
kvmptvn	k
kvmr	kr
kvmr	kr
kvmvrv	k
kvmvryta	ta
kvn	k
kvng	kang
kvng	kang
kvnka	kafka
kvn	k
kvn	k
kvnrad	konrad
kvnrad	konrad
kvnradvs	konrads
kvnrat	rat
kvnrat	rat
kvnrayt	kuwayt
kvnryat	yat
kvnt	kant
kvnv	k
kvnvpka	kafka
kvnvr	kr
kvnvvr	kr
kvnyng	kang
kvpjanz	danz
kvpj	j
kvp	k
kvpln	ln
kvplnd	nd
kvpls	ks
kvpnz	kenz
kvpr	kr
kvpr	kr
kvps	kips
kvradyny	brady
kvram	kram
kvran	kevran
kvran	kevran
kvrapaty	koorapaty
kvrbt	k
kvrbyn	ayn
kvr	kr
kvrdas	kordas
kvrds	ds
kvrdyk	k
kvrdz	k
kvrkam	kam
kvrkvl	k
kvrl	karl
kvrly	lyly
kvrn	karn
kvrnlh	h
kvrnlvs	ks
kvrnlys	ks
kvrnlyvs	ks
kvrnlyvsn	karn
kvrnlyz	allyz
kvrnval	val
kvrnyvl	k
kvrnz	kenz
kvrp	karp
kvrsl	k
kvrslv	k
kvrsn	sn
kvrstn	k
kvrt	kert
kvrth	irth
kvrtl	tl
kvrtlnd	nd
kvrtlnt	kant
kvrtrayt	kert
kvrtz	katz
kvrvnla	la
kvrvyn	kevyn
kvrya	rya
kvry	kory
kvry	kory
kvrydvr	kr
kvrygan	gan
kvry	kory
kvry	kory
kvryla	kayla
kvryl	beryl
kvrzayn	ayn
kvsada	dada
kvsak	k
kvsay	kay
kvsh	kish
kvsjh	h
kvsj	j
kvsky	sky
kvskymaky	sky
kvslv	k
kvsmans	klansmans
kvsmanz	danz
kvsmas	kamas
kvsmns	mns
kvsnkv	k
kvsta	kosta
kvsta	kosta
kvstanza	costanza
kvst	kast
kvstn	k
kvstrmn	mn
kvstylv	k
kvstys	katys
kvsvgh	h
kvsyn	ayn
kvsyra	byra
kvsz	k
kvta	ta
kvtcay	kay
kvt	k
kvtcy	k
kvtjanz	danz
kvtla	kotla
kvtmayr	mayr
kvtny	keny
kvtrvnyv	k
kvty	katy
kvtz	katz
kvvar	kar
kvv	k
kvvs	ks
kvyalsky	sky
kvyalyk	k
kvy	ivy
kvycy	ivy
kvyk	k
kvyknbas	bas
kvyknbvs	ks
kvyl	k
kvyl	k
kvyl	k
kvylyn	kevyn
kvymn	lymn
kvyn	kevyn
kvyn	kevyn
kvyn	kevyn
kvyn	kevyn
kvyn	kevyn
kvyn	kevyn
kvyn	kevyn
kvynrad	konrad
kvynrad	konrad
kvynrad	konrad
kvynrat	rat
kvynrayt	kuwayt
kvynrdvs	ks
kvynrydvs	karyns
kvynryt	k
kvyntana	santana
kvyntn	kevyn
kvynt	kant
kvyntvn	kevyn
kvypr	kr
kvyryn	karyn
kvysman	klansman
kvyst	kast
kvyt	k
kvyt	k
kvyykl	akl
kvyylyn	kevyn
kvyyman	ayman
kvyymn	lymn
kvyynln	kevyn
kvyyntanar	anntar
kvyyntvn	kevyn
kvyy	ivy
kvyyst	kast
kvyyt	k
kvyytz	katz
kvyzmn	mn
kvzn	zn
kvzv	k
kvzy	k
kvzy	k
kvzyn	ayn
kyalasa	klassa
kyasvn	k
kyat	yat
kyb	yb
kybh	h
kybl	k
kybl	k
kyblr	kr
kyblr	kr
kybv	k
kycn	k
kycrv	k
kycyn	ayn
kyd	d
kyd	d
kydl	k
kydra	hydra
kyf	f
kyf	f
kyfr	fr
kyfr	fr
kygan	gan
kygynz	kenz
kyhl	kohl
kyhv	k
kyjv	k
kykbrd	kurd
kykbryd	bryde
ky	k
ky	k
ky	k
ky	k
kyk	k
kykvma	kama
kylan	klan
kylbay	bayly
kylbrv	kyle
kylby	kilby
kylbyn	kyle
kylg	kilg
kylgvr	kr
kylh	kyle
kylhvrn	karn
kyl	kyle
kyl	kyle
kyl	kyle
kylpk	k
kylr	kr
kylr	kr
kylr	kr
kylrmt	kyle
kylt	kalt
kyly	lyly
kylyvn	kyle
kylz	kyle
kymbal	kabal
kymbrly	kimberly
kymbry	kory
kym	k
kym	k
kympa	kimppa
kymv	k
kymvn	k
kymvra	kara
kymz	k
kyna	dyna
kynan	kannan
kynann	kannan
kynard	kinard
kyn	ayn
kyncn	ayn
kyngastvn	kast
kyngfay	fay
kyngry	kory
kyngsfvrd	kingsford
kyngstvn	kingston
kyngztn	ayn
kynh	h
kyn	ayn
kyn	ayn
kyn	ayn
kyn	ayn
kyn	ayn
kyn	ayn
kyn	ayn
kyn	ayn
kynknn	kenn
kynkyd	d
kynmn	mn
kynmn	mn
kynrsly	sly
kynsla	la
kynsl	k
kynsmn	mn
kynsvn	ayn
kynt	kant
kynt	kant
kyntl	tl
kyny	keny
kyny	keny
kynyny	keny
kynyvn	ayn
kynz	kenz
kynzman	kan
kynzy	k
kyp	k
kyp	k
kyp	k
kyplyng	kang
kypyng	kang
kyra	byra
kyran	kan
kyras	karas
kyrbay	kay
kyrby	kirby
kyr	kr
kyrk	k
kyrta	ta
kyrty	karty
kyrvn	k
kyryl	kyle
kyrysy	kory
kysa	a
kys	ks
kys	ks
kys	ks
kys	ks
kyslv	k
kysnrvs	ks
kysr	kr
kysr	kr
kystvfr	fr
kysvn	k
kysy	k
kysydy	k
kysy	k
kysynjr	jr
kysyn	ayn
kytagvcy	kyte
kytamvra	tamra
kytc	kyte
kytcn	kyte
kyt	kyte
kyt	kyte
kyt	kyte
kyt	kyte
kyt	kyte
kytl	kyte
kytly	kyte
kyts	kits
kyty	katy
kytyng	tyng
kyv	k
kyvcy	k
kyv	k
kyvk	k
kyvkyvlys	ks
kyvmr	kr
kyvng	kang
kyvng	kang
kyvng	kang
kyvs	ks
kyvsmatv	k
kyvyvaly	daly
kyvzvn	k
kyzr	kr
kzmnz	kenz
'laaldyn	alaaldin
labat	labatt
labdn	labdon
labdvn	labdon
labkyn	laban
labla	la
labl	l
lab	la
labrad	labroad
labryvla	la
labsr	la
labyn	laban
lacln	ln
lacns	lacys
lacyny	lacy
ladasky	ladasky
ladr	badr
ladrvt	la
ladvn	lan
ladvvyka	la
ladvvykvs	las
ladvyg	la
ladyk	ladak
'ladyn	ayn
ladyvyl	l
lafam	lam
lafavntyn	lan
lafgryn	lan
lafvrkad	la
lafy	la
lagrlyng	lang
lagrstrvm	lagerstrom
lagvmvrvf	la
lagvn	lan
lahlma	lahelma
lahyj	lahij
laj	la
lajrbrg	la
lakay	laky
lakh	la
laklh	la
lak	ladak
lak	ladak
lak	ladak
lak	ladak
lakr	kr
laks	las
laksv	la
laksyn	lan
'lakvabah	babah
lakvtvrh	la
lakvvd	la
laky	laky
laky	laky
lakysa	la
lalkyn	lal
lal	lal
lals	ls
laly	laly
lalyt	laly
lamark	lamark
lamastvs	lamastus
lambard	lombard
lambardv	lamb
lambda	lambda
lambly	laly
lambrn	lamborn
lambrt	lambert
lambrvs	lambros
lambvly	laly
lambvrn	lamborn
lambvrn	lamborn
lam	lam
lam	lam
lamplayt	lamp
lampn	lamp
lampy	lamp
lampyt	lamp
lamrs	lamars
lamvrs	lamars
lamykyn	lamykin
lana	lana
landagr	land
landastrvm	land
landayr	dayr
landbrg	land
landgrn	lan
landgryn	lan
landkvyyst	land
land	land
landl	land
land	land
landmn	landman
landn	lan
landr	andr
landrs	landers
landrvm	landrum
landry	landry
landrz	land
landyn	lan
landyn	lan
landys	andys
langdvn	lan
lang	lang
lang	lang
lang	lang
langly	langland
langnz	lanz
langsa	langs
langsav	langs
langstvn	langston
langsv	langs
langv	lang
langyr	lang
lanj	lan
lanka	lanka
lankart	lanka
lankstaf	laff
lanktvn	lan
lan	lan
lan	lan
lan	lan
lan	lan
lanr	lan
lanr	lan
lansdyl	dylans
lansfrd	land
lans	alans
lanstz	lantz
lansyng	lang
lanta	atalanta
lant	langoulant
lantlvsamad	lantlosamade
lantrman	lanterman
lantz	lantz
lantz	lantz
lanvm	lam
lanvsy	lan
lany	lanny
lany	lanny
lanz	lanz
lapasv	lapaso
lap	lap
laplayn	ayn
lap	lap
lapvrd	laird
lapvrs	lars
lapvrt	lap
lapvta	la
lapvvrs	lars
lapydary	lapidary
lapyskv	lap
lara	lara
laraly	laly
lardynga	larga
larja	la
larj	la
larn	lan
larns	lars
larns	lars
larsn	lars
larsn	lars
larsvn	lars
lartr	larter
larvc	la
larvkvyh	la
larv	harv
larvrl	l
laryf	larry
larysa	la
laryvyr	lamar
larz	la
laskala	laska
laska	laska
laskary	larry
lask	ask
laskvs	las
las	las
las	las
las	las
lasnyk	lasnik
last	last
lastra	lastra
lastr	last
lastry	last
lastyng	lang
lasvn	lan
lasyngr	las
latala	latala
lata	latala
latam	lam
latbry	larry
latbvry	larry
latkynz	lanz
lat	at
latz	blatz
lavandh	land
lavayn	ayn
lavd	la
lav	av
lav	av
lavls	ls
lavmn	lan
lavnka	lanka
lavnyvs	avs
lavray	lavey
lavrns	laverns
lavstad	lovstad
lavtn	lan
lavtvn	lan
lavygnh	la
lavyn	lan
lavyt	la
lavzak	ladak
layan	lan
laybs	laylas
laybz	layla
laydvyna	layla
laydya	layla
'laydyn	ayn
layhv	layla
laykz	layla
lay	layla
layl	layla
lay	layla
laymak	ladak
laymb	lamb
laynd	land
layng	lang
layn	ayn
layn	ayn
layrd	laird
laytbrn	lan
laytmn	lan
laytnyng	lang
layv	layla
layv	layla
layv	layla
layvly	laly
layvrytsn	lan
layvsay	layla
layvvy	layla
layvy	layla
'layyn	ayn
lazara	lazara
lazard	lazard
lazarv	lazar
lbanrd	bard
lbanvrd	bard
lbdan	dan
lbdvn	ln
lbn	ln
lbrynydys	bryn
lbvn	ln
lbvr	lr
lbvrt	lt
lclh	h
lcmn	ln
lcmr	lr
lcnr	lr
ldfvrd	lord
ldj	j
ldk	k
ldvaydj	j
ldvyk	k
lf	alf
lflr	lr
lftvs	ls
lg	g
lhan	han
lhlh	h
lhman	lehman
lhman	lehman
lhmn	ln
lhmn	ln
lhnrr	lr
lhrntz	lantz
lhryan	ryan
lhyj	j
lhy	l
lj	j
lkambr	br
lkrn	ln
lkrvs	ls
lks	ks
lksn	ln
lkvst	last
lky	laky
lmbrn	ln
lmbrn	ln
lmbrt	lt
lmbvrnh	h
lmbvrn	ln
lmbvrn	ln
lmbvvrn	ln
lm	alm
lmp	lamp
lmpyng	lang
lmrz	l
lmvn	ln
lmyr	emyr
lndahl	landahl
lndavr	ln
lnd	land
lndry	landry
lndrz	ln
lndvay	ln
lndy	lindy
lndyn	ln
lndynv	ln
lndz	ln
lngly	lyly
lnglyng	lyn
lngmyd	ln
lngmyd	ln
lngss	langs
lngstn	ln
lngstvn	ln
lnky	laky
lnlvsamad	hamad
lnlvzamyd	ln
lnndn	ln
lnrt	ln
lns	lens
lnsvn	ln
lntlvsamad	hamad
lntlvsamyd	ln
lntyn	ln
lpard	lepard
lpart	art
lpla	la
lp	l
lpvrs	lars
lpvrta	la
lpvvrs	lars
lrap	lap
lrbz	lr
lrd	lord
lrmn	ln
lsard	lessard
lsly	lyly
lsr	lr
lsr	lr
lst	last
lsyak	ls
ltbry	lory
ltjy	lt
ltryj	lt
ltv	lt
lvalay	laly
lvats	ats
lvayngh	ayn
lvaynj	ayn
lvayn	ayn
lvbv	lvov
lvbvtyn	lyn
lvbyn	lyn
lvc	c
lvdmn	ln
lvdvrf	f
lvdvvyka	la
lvdvvykas	las
lvdvyjk	k
lvdvyka	la
lvdvykas	las
lvdvyk	k
lvdvyks	ks
lvdvykvs	ls
lvdvysvs	levys
lvfarv	harv
lvfasv	lvov
lvfbarv	harv
lvfr	fr
lvfstrvm	lofstrom
lvgh	h
lvgndra	andra
lvgz	l
lvjyk	k
lvka	la
lvkard	lockard
lvkas	las
lvk	k
lvk	k
lvk	k
lvk	k
lvk	k
lvk	k
lvkn	ln
lvks	ks
lvkstvn	ln
lvkv	lvov
lv	lvov
lv	lvov
lv	lvov
lvmas	las
lvmbardv	lombard
lvml	l
lvm	l
lvmn	ln
lvnan	banan
lvnav	av
lvndan	andaman
lvnd	land
lvndvn	ln
lvnj	j
lvn	ln
lvn	ln
lvnly	lyly
lvnmv	lvov
lvnyg	g
lvny	l
lvny	l
lvny	l
lvnyngdal	dal
lvnz	lanz
lvnz	lanz
lvpatkyn	lyn
lvp	l
lvpr	lr
lvprsty	lusty
lvpyn	lyn
lvpz	l
lvra	la
lvra	la
lvrc	c
lvrd	lord
lvrjyv	lvov
lvrna	lorna
lvrn	ln
lvrns	rns
lvrnt	lent
lvrntzn	ln
lvrnz	lanz
lvrnzn	ln
lvrnzv	lvov
lvrnzy	l
lvrtvn	ln
lvrty	ty
lvry	lory
lvry	lory
lvry	lory
lvry	lory
lvry	lory
lvsantvs	antevs
lvs	ls
lvs	ls
lvsmvr	lr
lvsrv	lvov
lvsskv	lvov
lvst	last
lvstr	lr
lvsty	lusty
lvsyh	h
lvsy	l
lvsy	l
lvsy	l
lvsytv	lvov
lvtbg	g
lvtmpyv	lvov
lvtr	lr
lvtynz	lanz
lvtz	lutz
lvvra	la
lvvrjat	at
lvvt	lt
'lvy	ivy
'lvy	ivy
lvyd	loyd
lvy	levy
lvy	levy
lvyndn	lyn
lvyng	lang
lvyn	lyn
lvyn	lyn
lvynsvn	lyn
lvys	levys
lvysyly	lyly
lvysyvr	lr
lvyyngh	h
lvyyng	lang
lvyysaly	laly
lvyyzv	lvov
lvyz	l
lvzanv	lvov
lvzyr	lr
'lya	alya
'ly	lyly
'lya	alya
'lya	alya
'lya	alya
lya	alya
'ly	lyly
'ly	lyly
lyam	lam
lyang	lang
lyanz	lanz
lyav	av
lybannrd	libannord
lybanvrd	bard
lybcn	lyn
lybl	l
lyblyt	lt
lybmn	lymn
lybrcak	lyly
lybrg	lyly
lybrn	lyn
lybrty	lyly
lybryk	lyly
lybskamb	kamb
lybsn	lyn
lybvrn	lyn
lybvytz	lutz
lybyd	loyd
lyby	lyly
lycarsvn	lyn
lycfyld	lyly
lyc	lyly
lycmr	lr
lyctn	lyn
lycvrvyys	levys
lydal	dal
lyda	lydea
lyd	loyd
lydman	landman
lydn	lyn
lydn	lyn
lydrak	badrak
lydrdrap	lap
lydrdrp	lyly
lydrdrvp	lyly
lydrdvrp	lyly
lydr	dr
lydvr	lr
lydvyna	lydea
lydya	lydea
lydya	lydea
lyfayv	lyly
lygyv	lyly
lyhy	lyly
lyk	lyly
lykyvry	lyly
lyla	layla
lyla	layla
lyla	layla
ly	lyly
lylbk	lyly
ly	lyly
ly	lyly
ly	lyly
ly	lyly
ly	lyly
lyly	lyly
lyly	lyly
lylynd	lyly
lylyntal	lyly
'lyma	kolyma
'lym	m
'lyma	kolyma
lymbax	lax
lymbvrg	lyly
lym	lyly
lymn	lymn
lymr	lr
lymyng	lyn
'lyn	lyn
lynan	lyn
lynars	lars
lyndal	lynda
lyndan	lyn
lyndbk	lyn
lyndbrg	lyn
lyndgard	lindgard
lyndgrn	lyn
lyndhlm	lyn
lynd	lyn
lynd	lyn
lyndl	lyndel
lyndl	lyndel
lyndmn	lyn
lyndmn	lyn
lyndn	lyn
lyndnmvt	lyn
lyndr	lyn
lyndrmn	lyn
lyndrvts	lynds
lyndsy	lynds
lyndvn	lyn
lyndz	lyn
lyndzy	lyly
lyngas	lyndas
lyngly	lyly
lynhan	lyn
lynh	lyn
lynkh	lyn
lynk	lyn
lynkln	lyn
lynkvln	lyn
lynkvys	levys
lyn	lyn
lyn	lyn
lyn	lyn
lyn	lyn
lyn	lyn
lyn	lyn
lyn	lyn
lynstrat	lyn
lynval	l
lynvnn	lynn
lynvra	lyra
lypard	lepard
lypkyn	lyn
lypskamb	kamb
lypskmb	lamb
lypskm	lyly
lypskvmb	lamb
lypskvmp	lamp
lypst	last
lypyj	lyly
lyr	lr
lyr	lr
lyrn	lyn
lyrykal	l
lyryk	lyly
lysbth	lyly
lysbtjh	lyly
lysbtj	lyly
lysbtjy	lyly
lyskanv	lyly
lyskmb	lamb
lyskn	lyn
lysky	lyly
lys	lilys
lysn	lyn
lysn	lyn
lystr	lr
lystvn	lyn
lysvn	lyn
lysvn	lyn
lysy	lyly
lysyn	lyn
lyt	lt
lytl	l
lytltvn	lyn
lytly	lyly
lytmn	lymn
lytn	lyn
lytrl	l
lytv	lyly
lytvn	lyn
lytvn	lyn
lytvyn	lyn
lyva	la
lyvandn	lan
lyvandvn	lan
lyvayn	lyn
lyvbvny	lyly
lyvh	lyly
lyv	lyly
lyv	lyly
lyv	lyly
lyv	lyly
lyv	lyly
lyvnard	lenard
lyvnardv	lenard
lyvndvn	lyn
lyvngvd	lyly
lyvn	lyn
lyvnl	l
lyvnsbry	lyly
lyvnvra	lyra
lyvnz	lanz
lyvvh	lyly
lyvv	lyly
lyvy	lyly
lyvyngstvn	lyn
lyvyn	lyn
lyvyn	lyn
lyvys	levys
lyvyv	lyly
lyvyvs	ls
lyvyvy	lyly
'lyyah	ayah
lyyl	lyly
lyyvvh	lyly
lyza	la
lyza	la
lyzard	lazard
lyzardz	lazard
lyzbty	lyly
lyz	lyly
lyzn	lyn
lyzr	lr
lyzvt	lt
mabanag	mabanag
mabay	may
maby	mawby
mac	mac
mactld	mac
madaba	madaba
madaks	mads
madj	madej
madlyn	madelyn
madlyn	madelyn
madlyn	madelyn
madn	madon
madrvn	madon
madsn	mads
madvn	madon
madvray	may
madygan	mangan
mady	mady
madys	mads
madysvn	mady
madyv	mady
mafry	mary
mafyn	man
magagna	magagna
magard	maggard
magdalynth	magda
magd	magda
maglyrv	marv
magr	mager
magrvdr	mager
mags	maggs
magvayr	mayr
magvyr	mayr
magyl	magi
mahadvan	mahadevan
mahajan	mahajan
mahalt	mahault
mahaly	mahaly
maha	maha
mahavlt	mahault
mahtv	mah
mahvlt	mah
mahvt	mah
majv	maj
majy	maj
majyv	maj
makarayg	marmara
makayvly	may
makk	mak
maklaqlyn	lyn
mak	mak
mak	mak
mak	mak
makryj	maj
maksvl	mak
maksy	mak
maksym	m
maksymylyan	lyman
makv	mak
makvmbr	mak
makvnvcy	macy
makvsy	mak
maky	macky
makynvn	mak
makyras	mayras
makysak	mak
makzym	m
malamvd	malamud
malan	malan
malbrg	malberg
mald	malde
maldn	malan
malkvk	mak
malkvm	m
maln	malan
malnr	malnar
malrvny	many
maltyn	maltin
malvn	malan
malvny	many
malygan	mangan
malyk	mak
mama	mama
mamfvrd	mama
mamn	mama
mamrt	mama
mamy	mama
manama	manama
mana	mana
mana	mana
manbr	manber
manc	mac
mandal	mandal
manda	manda
mandar	mandar
mandavyl	mandal
mandl	mandl
mandr	andr
mandy	mandy
mangan	mangan
manglany	manglani
mangr	mangan
mangyn	mangan
manjyt	manjit
manjyt	manjit
manka	mama
mank	mayank
mankrt	man
manks	mans
mankvs	mans
manky	many
manly	manley
manma	mama
man	man
manrv	marv
mansn	man
manstr	mans
mansyl	mans
mansyngr	mangan
manta	mama
mantl	mantle
mantnz	man
mantras	manamas
mantvr	mantor
mantyks	mans
manty	mantey
manvly	many
manvly	many
manv	man
manv	man
manv	man
manv	man
manvry	many
manx	manx
manyja	mama
manyks	mans
many	many
many	many
manyng	mangan
manyskas	maniskas
manys	mandys
manyt	many
manyv	many
manz	man
mapartyda	marmara
maplz	maple
maraly	marmara
marany	many
marat	marat
marazas	marazas
marbac	mac
marbl	marble
marc	marc
marcyndv	marcy
mardr	mar
mardvc	marc
marfy	mary
margalta	malta
margalyty	marty
marganth	mangan
margant	margaret
margarta	margarita
margaryta	margarita
margarytay	mary
margarytjh	marytje
margarytj	marytje
margarytj	marytje
margarytjy	mary
margaryt	margaret
margaryt	margaret
margaryt	margaret
margaryty	mary
marglyn	marilyn
margrta	marta
margryjh	mary
margryta	margarita
margryth	mary
margryth	mary
margrytj	marytje
margrytjy	mary
margryt	margret
margrytyh	mary
margvlyn	marilyn
margvlys	marys
margvlyvks	marks
marjnt	mar
markham	markham
markly	markley
mark	mark
mark	mark
marks	marks
marksn	marks
markstynr	mar
markv	mark
markv	mark
markvm	mark
markvpvly	mark
markvs	marks
markvs	marks
markvs	marks
markvyt	mark
markvyza	marmara
markvz	mark
markyl	mark
marky	mark
markyngtvn	mark
markyyvs	marks
marla	marla
marlat	marlatt
marl	mar
marly	marley
marlyn	marilyn
mar	mar
marn	man
marpl	marple
marrl	mar
marsal	marsala
marsla	marla
marsl	mars
marslv	mars
marslynv	mars
mars	mars
mars	mars
marstvn	marston
marsy	mars
martl	martel
martlnd	martland
martn	marten
martntjy	marty
martyjn	martyn
martyjn	martyn
martyjntjh	marty
martyjntjy	marty
marty	marty
marty	marty
martynh	martyn
martynj	martyn
martynj	martyn
martyn	martyn
martyn	martyn
martynsn	martyn
martynth	martyn
martynth	martyn
martyntjh	martyntje
martyntj	martyntje
martynt	martyn
martynt	martyn
martynv	martyn
martynvs	martyn
martynz	martyn
martynz	martyn
martynz	martyn
martyzn	martyn
martyzntj	marty
martz	martz
marvaha	marva
marvcy	marcy
marv	marv
marvn	marv
marvn	marv
marvny	many
marvyn	martyn
marvyn	martyn
marvyt	marv
marxam	mama
marya	marmara
maryana	mana
maryan	maryann
maryganth	mangan
marygant	mangan
maryh	mary
maryjh	mary
maryjh	mary
maryjkn	mary
maryj	mary
maryjnt	mary
marykandv	mandar
marykn	mary
marylyn	marylynn
mary	mary
mary	mary
maryn	martyn
marynv	marv
marysh	marsh
marys	marys
marysvn	marys
maryth	mary
maryth	mary
marytj	marytje
marytj	marytje
marytjy	mary
marytjy	mary
maryt	mary
maryt	mary
maryv	marv
maryvs	marys
maryyany	many
maryz	mary
marzk	mark
marz	marz
masahyrv	marv
masara	marmara
masataka	masataka
masatv	masato
masayv	magsaysay
masbrg	mama
maskary	mary
maskl	maskell
mask	ask
maskyas	mayas
masld	masud
maslly	may
masna	masna
masna	masna
masrmn	mn
mastn	mast
mastyr	mast
masvn	man
masyk	mak
masy	may
masymv	mama
masyn	man
matakv	mata
mata	mata
matana	matana
matar	matar
matay	may
matjka	matejka
matlv	mat
mat	mat
matsvda	matsuda
matsvmvtv	mats
matsvn	mats
matvla	mama
matv	mat
matvr	mar
matvs	mats
matynv	mat
matys	martys
matys	martys
matyv	mat
matyvs	mats
mavbay	may
mavby	mawby
mav	av
mav	av
mav	av
mavn	man
mavpyn	man
mavr	mar
mavrs	mars
mavsr	mar
max	max
mayfyld	mayfield
mayklys	mays
mayklzn	man
mayk	mak
maykn	man
maykvhn	man
maykvk	mak
mayln	man
may	may
may	may
maymvn	ayman
mayndrt	mat
mayn	ayn
mayn	ayn
maynr	mayr
mayr	mayr
mayr	mayr
mayr	mayr
mayr	mayr
mayr	mayr
mayrn	mayr
mayrs	mars
mayryk	mayr
mayrz	marz
maysal	magsaysays
maysa	magsaysays
maysl	mays
maystyk	mays
maytag	maytag
maytham	hamam
mayt	mat
mayt	mat
mayty	may
mayvhay	may
mayv	may
mayz	may
mazra	mama
mbark	bark
mcld	md
mctld	md
mdaba	baba
mdavr	md
mdba	ba
mdh	md
mdlyn	lyn
mdnyk	md
mdnyt	md
mdrk	mark
mdrr	dr
mds	mds
mdsn	mds
mdsvn	mds
mdvna	mana
mdyna	dyna
mdynh	md
mdynh	md
mdyn	md
mdynny	manny
mdynt	md
mdysvn	md
mdysvn	md
mfrg	mg
mfrk	mark
mfrvk	k
mgdalnt	mg
mgdalyntj	daly
mgdalyyntjh	daly
mgda	magda
mgdayntj	mg
mglaglyn	glynn
mglat	mat
mgnan	magnan
mgnasn	masna
mgnh	mg
mgny	many
mgr	mg
mgy	mg
mgy	mg
mgy	mg
mgynl	mg
mgys	mgs
mgysy	mg
mgyv	mg
mhadvan	han
mhama	mama
mharak	hak
mhl	mehl
mh	h
mhma	mama
mhrah	mahrah
mhra	mara
mhrg	mg
mhrh	rh
mhrk	mark
mhrm	m
mhvyt	mt
mjdl	l
mj	j
mjya	maya
mjyd	md
mjykal	al
mjyk	k
mkah	mah
mkalyr	mayr
mka	mika
mkardl	kardal
mkdaln	ln
mkdrmvt	mt
mkdvlnd	md
mkdvnald	bald
mkdvnald	bald
mkdvyl	mkel
mkfarlnd	mcfarland
mkfarlyn	charlyn
mkfrlyn	lyn
mkgavyn	mn
mkgrat	marat
mkgvvan	man
mkgvyrk	mark
mkgvyr	mayr
mkgyry	mary
mkh	h
mkh	h
mkhnry	mary
mkkah	mekkah
mkkan	kan
mkkarty	karty
mkkarty	karty
mkkavn	mn
mkkna	mana
mkkny	many
mkknzy	m
mkkrkn	mn
mklaglyn	glynn
mklaqlyn	lyn
mklarn	barn
mklavlyn	lyn
mklavlyn	lyn
mklavvgyng	lang
mklyn	lyn
mklyn	lyn
mk	k
mk	k
mkmahan	mahajan
mkmahvn	mah
mkmahvn	mah
mk	k
mkmanys	mandys
mkmvln	ln
mkmylan	dylan
mknat	mat
mknyl	mkel
mknyl	mkel
mkra	mara
mkrayh	h
mkray	may
mkrdy	mady
mkrvn	mn
mkrys	marys
mksfyld	md
mksn	mn
mksymv	m
mktavys	mays
mkvc	c
mkvtv	m
mkvy	ivy
mkvy	ivy
mkyl	mkel
mky	m
'ml	l
mla	la
mlandr	andr
mlany	many
mlayyr	mayr
mlbay	may
mlcr	cr
mlcyr	cyr
mlka	melka
mlkvlm	m
mlkvm	m
mlmn	mn
mln	ln
mlr	lr
mlth	myth
mlv	m
mlvn	mn
mlvr	mr
mlybv	m
mlydy	lyly
mly	lyly
mlyngr	mr
mlyn	lyn
mlyny	lyly
m'ma	mama
mmh	h
mmta	mamta
mnama	mama
mnamh	amna
mnard	menard
mndl	mandl
mndl	mandl
mndl	mandl
mndr	andr
mndvza	mn
mndybl	mn
mndyk	mn
mndy	mandy
mndz	mn
mnfvl	mn
mngan	mangan
mngh	mn
mng	meng
mngs	mgs
mnhart	barnhart
mnh	mn
mnjyvn	mn
mnk	mn
mnkvsv	mn
mnkyvs	mns
mnma	mama
mnnyng	meng
mnrv	marv
mnsa	mansa
mnsn	mn
mnstryna	mns
mnsvr	mns
mnsvr	mns
mnsvr	mns
mnsvry	mns
mntl	mn
mnt	mn
mntqh	mn
mntsr	mn
mntsynn	mn
mnty	monty
mntzr	mn
mnyjr	jr
mnyks	mns
mny	many
mny	many
mnyng	meng
mnyn	mn
mnzr	mn
mnzs	mns
mnzyz	mn
mpl	pl
mpl	pl
mqbrh	rh
mqrby	darby
mqsvd	md
mranda	manda
mrdys	mrs
mrdyt	mr
mrhavs	avs
mrjynyv	mr
mrkl	mr
mrkly	lyly
mrknt	mont
mrkr	mr
mrnda	manda
mrny	many
m'rq	m
mrsr	mr
mrsrya	mrs
mrsryv	mrs
mrtn	mn
mrtnz	mr
'mr	mr
mrvah	mah
mrvan	man
mrygan	mangan
mryj	mr
mryk	mr
mryks	mrs
mryman	man
mry	mary
mry	mary
mrymn	mn
mrynly	lyly
mrys	marys
mryt	mr
mrz	marz
msalxy	ms
msa	mesa
msandr	andr
msbarn	barn
msks	ms
mskyn	mn
mslyn	lyn
msman	man
msr	mr
mss	ms
mstan	mastan
mst	mast
mst	mast
mstrz	marz
ms'vd	md
msyf	ms
msyna	dyna
msyngr	mr
msyn	mn
msyvs	ms
mtana	mana
mtlyn	lyn
mt	mt
mt	mt
mtna	etna
mtna	etna
mtrnc	mt
mtrnyc	mt
mtrv	marv
mtrync	mt
mtsgr	mr
mtsvmvtv	mt
mtsvn	mn
mtvr	mr
mtyn	martyn
mtyn	martyn
mtyv	mt
mtyv	mt
mtyv	mt
mtyvs	ms
mtyvs	ms
mtyvsvn	mn
mtyvz	mt
mtzgr	mr
mtzyng	meng
mvalr	lr
mvanzr	mr
mvbay	may
mvbly	lyly
mvdgyl	l
mvd	md
mvdy	mady
mvdy	mady
mvfad	md
mvganty	monty
mvhama	mama
mvhan	han
mvhr	mr
mvkasa	mukasa
mvk	k
mvkryj	j
mvlandr	andr
mvldn	mn
mvlk	k
mvl	l
mvln	ln
mvlr	lr
mvlr	lr
mvlvy	ivy
mvlygan	mangan
mvly	lyly
mvlynary	mary
mvmfvrd	md
mv	m
mvnagan	monagan
mvnak	mak
mvnakv	m
mvnaz	m
mvndfrans	mondfrans
mvndvr	mr
mvnkar	menkar
mvnk	monk
mvnks	monks
mvnkz	m
mvn	mn
mvn	mn
mvnrv	marv
mvns	mns
mvntag	montag
mvntagv	montag
mvntalbanv	montalbano
mvnta	monta
mvntanarv	antananarivo
mvntanv	montanan
mvntgmry	mary
mvntgvmry	mary
mvnt	mont
mvntral	al
mvntrv	marv
mvntvya	maya
mvntyjv	m
mvnvlyt	mt
mvnyz	m
mvnzlr	lr
mvrabytv	raby
mvrad	murad
mvral	al
mvrals	als
mvralt	muralt
mvra	mara
mvrandv	rand
mvran	man
mvranv	m
mvras	maras
mvravan	moravan
mvray	may
mvrayns	mns
mvrc	marc
mvrdac	mac
mvrdak	mak
mvrfy	m
mvrhavs	avs
mvrhavs	avs
mvrkl	akl
mvrkn	mn
mvrlan	morlan
mvrl	l
mvrl	l
mvrl	l
mvrlyj	j
mvrly	lyly
mvrman	man
mvr	mr
mvrnyng	meng
mvrs	mrs
mvrs	mrs
mvrs	mrs
mvrstad	maurstad
mvrtan	man
mvrtn	mn
mvrtvn	mn
mvrtymr	mr
mvrtymr	mr
mvrty	marty
mvrtymvr	mr
mvrv	marv
mvrvny	many
mvrvyl	l
mvryl	beryl
mvry	mary
mvry	mary
mvryn	bryn
mvrysn	mn
mvrysvn	mn
mvrysvn	mn
mvryta	mata
mvsal	sal
mvsana	mana
mvsfys	mays
mvsla	la
mvsmn	mn
mvs	ms
mvsvn	mn
mvsvy	ivy
mvsyg	mg
mvsy	m
mvsyr	mayr
mvsyvn	mn
mvsz	m
mvta	mata
mvtana	mana
mvt	mt
mvtvr	mr
mvtvrz	marz
mvtysv	m
mvvr	mr
mvyl	l
mvy	ivy
mvynyhan	han
mvynz	m
mvyr	mayr
mvysan	maysan
mvys	mays
mvyss	masss
mvysvn	mn
mvyz	m
mvyzvn	mn
mvzyna	dyna
mvzz	m
myav	av
myayndrt	maya
mycalys	mysts
myca	ca
mycan	man
mycaylys	mays
mycl	cl
mycltjn	mn
mycltn	mn
mycltyn	martyn
myclys	mysts
mycn	mn
mydlbrv	marv
mydltn	mn
mydltvn	mn
myd	md
mydr	dr
mydy	mady
mygn	mn
mygnran	man
mygnry	mary
mygr	mr
mygr	mr
mygvyl	l
myhalyk	kalmyk
myhan	han
myjr	jr
myjry	mary
mykak	mak
mykalk	kalmyk
myka	mika
mykas	myras
mykayl	kay
mykayyl	kay
mykayylyz	lyly
mykayylz	elz
mykk	k
myklacln	maclachlan
mykljn	mn
myklm	m
myklsn	mn
myklsvn	mn
myk	k
mykna	myrna
mykr	kr
myks	ks
myks	ks
myks	ks
mykt	mt
mykvk	k
mykvlyk	k
mykv	m
mykyng	meng
mykynz	m
mykz	m
mylad	milad
mylam	lam
mylam	lam
mylan	dylan
mylara	mylar
mylard	mylar
mylar	mylar
mylasys	laylas
mylbrt	mort
myldrd	md
mylgram	milgram
mylks	milks
mylkv	m
mylky	milky
mylman	man
mylman	man
mylmv	m
myln	ln
mylnr	mylar
mylnvr	mylar
mylnyvm	m
mylr	mylar
mylstvn	mn
mylt	lt
mylt	lt
myltn	mn
mylvard	harvard
mylv	m
mylvs	myles
mylvt	mt
mylyanz	danz
mylygan	mangan
mylykn	lyly
myly	lyly
myly	lyly
myly	lyly
mylynd	lyly
my	amy
mymas	mass
my	amy
my	amy
mymy	amy
myna	myrna
myna	myrna
mynamv	amy
mynard	maynard
mynard	maynard
mynaryk	masaryk
myndrt	mort
myngv	m
mynky	amy
myn	mn
myn	mn
myn	mn
myn	mn
myn	mn
mynral	al
mynr	mr
mynrva	marva
mynrz	marz
mynsr	mr
mynstrl	minstrel
mynsy	amy
myntakah	mah
myntakva	mintaka
myntka	atka
mynt	mont
myntr	mr
myntvn	mn
myntz	mintz
mynvaryng	mary
mynyard	minyard
myny	many
mynz	m
mynz	m
mypl	pl
myra	myra
myra	myra
myrankr	myra
myrfld	md
myr	emyr
myrmak	mak
myr	emyr
myr	emyr
myr	emyr
myrs	mrs
myrsy	myra
myrty	marty
myrva	myra
myrvl	myra
myrvt	mt
myrydyt	mt
myrz	marz
myrz	marz
myrz	marz
mysa	mesa
mysa	mesa
mysan	maysan
mysat	myst
myslav	slav
mysl	myst
mysl	myst
mysm	m
mysn	mn
mysra	myra
mystry	mistry
mystyk	myst
mysvnr	mr
mysyk	myst
mytal	al
mytava	ava
mytcl	cl
mytcm	m
mytnyk	myth
mytrvvyk	myth
mytsl	myth
mytv	myth
mytv	myth
mytvn	mn
mytvnn	mann
myv	m
myvs	ms
myvsn	mn
myvvz	m
myvz	m
myvzr	mr
myyh	myth
myyr	emyr
myyrs	mrs
myz	m
myz	m
myzvn	mn
myzyra	myra
mzdh	h
mzyk	k
mzyvn	mn
nab	na
nabl	nabil
nabyl	nabil
nadan	nan
nadansvn	nan
nadvlny	nadolny
nadyg	nadig
naf	najaf
naf	najaf
naf	najaf
nafza	na
nagasaky	nagasaki
nagasyva	nagasiva
nagnt	nat
nagy	nagy
naham	nam
najr	jr
najyah	nahnah
najya	najya
nakagaky	nakagaki
nakamvra	nakamura
nakasvra	nakasora
nakasyma	nakashima
nak	nanak
naksvn	n
nakvyyn	n
nal	nawal
nalyk	nanak
nam	nam
nandvany	anand
nanly	nan
nan	nan
nans	nans
nansy	nans
nantvn	nan
nap	na
nap	na
naptvn	napton
napvlytanv	nan
narad	narad
nardn	n
nardv	nardi
nardy	hardy
narla	narla
narsavag	narsavage
narv	harv
nasav	nas
nas	nas
nas	nas
natan	nan
nat	nat
natsn	nats
navar	navarre
navarv	navarre
navas	navas
nav	av
nav	av
navya	na
navylv	av
naya	na
naydv	na
nayfh	nayfeh
nayflr	nayar
naykrbykr	nayar
nayks	nas
nayks	nas
naykvlas	nas
naylr	naylor
naylz	na
naymah	nahnah
nayrmn	n
nayt	nat
nayt	nat
nazaha	nazahah
nazarytyan	yaryan
nazaryv	nazario
nbatay	tay
nbatyh	nb
nbaty	katy
nbl	nb
'nbr	br
nbrs	brs
nda	dada
ndkarny	karn
ndn	n
ndvd	nd
ndyn	n
nfan	fan
nfdv	n
nfjan	jan
nfl	l
nfysa	na
nfyza	na
nfza	na
ngtyv	n
ngy	nagy
nhavs	avs
nhnh	h
njaf	najaf
njf	f
njva	na
njyah	ayah
njya	najya
njyh	h
nklas	niklas
nkls	ls
nknz	n
nkv	n
nkv	n
nl	l
nlkyn	n
nls	ls
nlsn	n
nlt	lt
nmazy	may
npan	n
np	np
npl	np
npr	np
nptvn	n
npvra	na
nrad	narad
nrdnflt	lt
nrs	ns
nrtrvp	np
nrvp	np
nry	nery
nry	nery
nsly	sly
nsnal	nawal
nsva	na
nsvm	ns
nsyda	ayda
nsyha	na
nsyh	ns
nsyra	byra
ntakr	kr
ntrtvn	n
ntyfa	na
ntyha	na
nvala	ala
nvar	invar
nvayl	l
nvaz	n
nvbl	l
nvbl	l
nvda	dada
nvdyng	tyng
nvf	f
nvgnt	n
nvjans	jans
nvjanz	danz
nvjnans	nans
nvjns	ns
nvjnt	n
nvks	ks
nvkv	n
nvlan	lan
nvld	nd
nvlf	nolf
nvl	l
nvl	l
nvnys	ns
nvp	np
nvra	na
nvrbay	barbary
nvrda	dada
nvrdbay	nordby
nvrdbvrg	nordborg
nvrddrap	np
nvrdnstvrm	ns
nvrdrap	np
nvrdrvph	h
nvrdt	nordt
nvrdvrp	np
nvrdvrp	np
nvrha	norha
nvrkat	nat
nvrn	n
nvrsrap	np
nvrsvrp	np
nvrtkat	nat
nvrtvrph	h
nvrtvrp	np
nvrvvd	nd
nvry	nery
nvsak	bak
nvsl	l
nvt	n
nvtzn	n
nvtz	notz
nvvala	ala
nvvrddrp	np
nvvsl	l
nvvyk	k
nvya	na
nvyfl	l
nvyjanz	danz
nvyk	k
nvyl	l
nvyl	l
nvyls	ls
nvyngtvn	n
nvys	ns
nvz	n
nyby	n
nycvlas	nyasas
nycvls	ls
nydal	dal
nyda	ayda
nydh	h
nydlz	elz
nyd	nd
nyfjan	jan
nyfyn	n
nygly	lyly
nyg	g
nygra	nigra
nygt	n
nyhalany	lanny
nykalas	alaskas
nyklas	niklas
nyklas	niklas
nyklas	niklas
nyklas	niklas
nykl	akl
nykl	akl
nykl	akl
nykl	akl
nykls	ls
nykls	ls
nykls	ls
nykls	ls
nyklsn	n
nyklsn	n
nyklsvn	n
nyklv	n
nyklz	elz
nyklz	elz
nyk	k
nyk	k
nyk	k
nykrbakr	kr
nykrbkr	kr
nykrbykr	kr
nykrsvn	n
nyks	ks
nyksvn	n
nykvla	la
nykvlas	nyasas
nykvlas	nyasas
nykvlas	nyasas
nykvlas	nyasas
nykvl	l
nykvlsan	n
nykvls	ls
nykvls	ls
nykvls	ls
nykvlsvn	n
nykvlyk	k
nykvly	lyly
nykvly	lyly
nykvlz	elz
nykvlz	elz
nykv	n
nyky	n
nyky	n
nyky	n
nyky	n
nylbry	bryony
nyljh	h
nylmg	mg
nylnd	nd
nyl	l
nyl	l
nyls	ls
nyls	ls
nyls	ls
nyls	ls
nylth	nuth
nyltjh	h
nyltj	j
nyltjy	n
nylz	elz
nymah	mah
nyma	nyman
n'ymh	h
nymh	h
nymrad	narad
nymtz	nimtz
nymy	amy
nyndk	nd
nynja	ninja
nyn	n
nyn	n
nyns	ns
nynstar	ninstar
nynv	n
nynvys	ns
nypan	n
nypnbrg	nb
nyptvn	n
nyr	cyr
nyr	cyr
nys	ns
nys	ns
nysn	n
nyspl	pl
nysylda	nelda
nytyn	n
nyvan	n
nyvark	ark
nyvayngtn	ayn
nyvayngtvn	ayn
nyvbay	bayly
nyvbry	bryony
nyvbry	bryony
nyvkvlas	nyasas
nyvkvyst	myst
nyvlnd	nd
nyvman	nyman
nyvman	nyman
nyvmn	n
nyvmyr	emyr
nyvsam	nam
nyvtn	n
nyvvyngtvn	n
nyvysvn	n
nyvyyngtvn	n
nyyvkamb	kamb
nyyvtn	n
'nyzh	h
nzahah	nazahah
nzaha	nazahah
nzahh	nazahah
nzyrah	grah
nzyra	byra
nzyrh	rh
pablt	pablo
pablv	pablo
pacvlkh	pa
pacyanv	pan
padva	pa
padvla	pa
padyal	pal
padyla	pa
paglays	paglias
paglya	pa
paglys	paglias
paglyyarv	harv
pagt	pat
pajt	pat
pakala	pakala
pakard	packard
paknas	pakenas
paks	paks
paks	paks
pakt	pak
pakvat	pat
palagy	palagyi
palak	pak
palfvrd	pal
palmrt	palmert
pal	pal
pal	pal
palrmv	pal
palsky	polsky
palsn	pal
palsyfr	pal
paltjh	pal
paltj	pal
paltjy	pal
palvmbv	pal
palydv	pal
paly	pal
paly	pal
paly	pal
palys	pal
pamfry	fry
pam	pam
panags	panagos
panas	panas
panc	pan
panda	panda
pandr	andr
pandvlfynv	pan
pandyan	pandya
pandyt	pandit
pandz	pan
panfyl	panfil
pangbvrn	pangborn
panjaby	pan
pankras	panas
pankrs	pans
pann	pan
pan	pan
pant	pant
panvalkr	panvalkar
panvn	pan
panykv	pan
panysy	pansy
papalardv	pappalardo
papay	papay
paplaskas	paplaskas
papltvn	pan
paply	papay
papn	pan
pap	papp
pap	papp
papvyk	pak
paq	pa
para	parra
parat	ararat
parayl	parayil
pardn	pardon
pardyngtn	pardington
pardyngtvn	pardington
pardy	hardy
pardz	pardi
parham	parham
park	park
parkyn	parkyn
parkz	park
parmar	parmar
parns	pans
parsanz	sanz
parsl	paars
parsn	parson
parsvns	paars
parsvnz	paars
partvn	parton
partvs	partos
party	karty
paryngtvn	parkyn
pary	parry
parys	marys
paskal	pal
paskv	pas
paskv	pas
pas	pas
pastrnak	pasternak
pastvr	pas
pasyfyk	pak
pasyr	pas
patn	pan
patr	pat
patrsvn	pan
patrsvn	pan
patrvklvs	pas
patryk	patrik
patryk	patrik
patryk	patrik
patrys	patsys
patrysya	pa
patryzyv	pat
pats	patsys
patta	patetta
patvcy	papay
patvksnt	pat
patyl	pal
pavl	pal
pavlsn	pan
pavls	pas
pavlth	pa
pavlt	pat
pavlyk	pavlik
pav	av
pavv	av
payj	papay
payk	pak
paynh	papay
payn	ayn
payntvn	paynton
payny	papay
pay	papay
paypr	paypal
payramyd	palmyra
payth	papay
paytj	papay
paytr	papay
paytr	papay
paytvn	payton
payvlsvn	pan
payvltj	papay
payvth	papay
pd	pd
pdram	pedram
pdrsn	pd
pdrsvn	pd
pdy	pd
pg	g
pgram	pegram
pgt	pt
pk	k
pkr	kr
pkyngz	p
plak	pak
plamn	plamen
plamr	mr
plank	planck
plan	lan
plant	pant
plastynv	elastoplast
platfvrm	platform
plat	plat
plat	plat
platyv	plat
playr	dayr
plc	pl
plham	pelham
plkcya	pa
plky	pl
plnknr	pl
plnth	plath
pltayr	dayr
pltcr	cr
pltfrm	perm
pltkvs	pl
pltnn	penn
plt	lt
plt	lt
pltyv	pl
pltyyr	pl
plvhn	pl
plvmr	mr
plygryny	pliny
plynskyn	lyn
plyskyn	lyn
plyt	pl
plyv	pl
pnbakr	kr
pndltn	n
pndltvn	n
pndya	pandya
pngadv	p
png	pang
pnkras	pas
pnl	pl
pn	n
pns	ns
pntvn	n
pnyman	nyman
pnynsvla	la
pnynzvla	la
pny	p
pph	h
pplr	lr
ppyn	ayn
prabst	pabst
pract	pratt
pradv	prada
pragv	prager
prahl	prahl
praktykvm	pram
pral	prall
pralt	prall
pram	pram
pramvd	pram
pranav	pranav
prangs	prongs
prank	pranke
prapys	pepys
prasad	prasad
prasana	prasana
prasant	prashant
prasn	prasen
pras	pradas
pratp	pratap
prat	pratt
prats	pratts
pratvl	pratul
pratyk	prateek
pratyks	prates
pratykv	pratt
pravl	pravil
pravyn	praveen
prayb	pb
prayl	prael
praym	pram
prayvn	pram
prayvyt	pratt
prbn	n
prc	c
prdykarv	harv
prdykys	pres
prdys	pres
prkas	pas
prks	parks
prkyns	ns
prkynz	parkyn
prlman	perlman
prlmn	mn
prl	perl
prlr	lr
prly	lyly
prmal	premal
prnt	pant
prntys	tys
prpk	perpk
prsattam	tattam
prskat	pat
prsl	pl
prslt	lt
prstn	n
prstrvd	pd
prstrv	p
prstvn	n
prsvn	n
prsynv	p
prsyval	pal
prvamr	mr
prvan	provan
prvgtv	p
prvjt	prut
prvmvntvry	pery
prvn	n
prvps	ps
prvs	pres
prvtrv	p
prvtvs	pres
prvv	p
prvvst	post
prvyn	ayn
prvy	pruy
prvys	pres
prya	priya
pryavlt	lt
prybl	pl
prycard	picard
prydy	pery
prykly	prickly
prykn	n
prykt	prut
prylv	p
prymrv	p
prymv	p
prymyvs	pres
pryng	prong
pryn	bryn
pryns	karyns
prynss	press
prynt	pant
pryny	pery
pry	pery
pryskat	pat
pryslr	pryor
prystly	priestly
prystly	priestly
pryst	myst
prystvn	n
prysyla	layla
prysyng	prong
prytcard	picard
pryty	pery
pryty	pery
prytz	pritz
pryvr	pryor
pryvs	pres
pryvst	post
pryyvty	pery
prz	p
pskyn	parkyn
psnkv	ps
ps	ps
pstma	postma
pst	post
ptcr	cr
ptkr	kr
ptla	la
ptrn	pt
ptr	pt
ptrsn	pt
ptrsn	pt
ptrsvn	pt
ptrsvn	pt
ptrvf	pt
ptrvnla	la
ptrv	pt
ptrvv	pt
ptrvyc	pt
ptryc	pt
ptryk	pt
ptry	petry
ptrz	pt
ptsy	patsy
ptv	pt
ptybn	pt
ptybvn	pt
ptyl	pl
ptyns	pts
pty	pt
pty	pt
pty	pt
ptytjyn	pt
ptzvld	pd
pvalma	alma
pva	pa
pvga	ga
pvglys	pollys
pvg	g
pvgvsyan	pan
pvhan	han
pvhar	har
pvhl	pl
pvh	h
pvkvrny	p
pvlakvs	paks
pvlgar	pulgar
pvlk	polk
pvlmytys	tys
pvlnd	nd
pvln	ln
pvln	ln
pvlnt	pant
pvl	pl
pvl	pl
pvlsn	sn
pvls	ls
pvls	ls
pvltr	p
pvlv	p
pvlvvyn	ayn
pvlyng	pang
pvlypaly	paypal
pvly	lyly
pvlys	pollys
pvlyt	pt
pvlyyam	pam
pvlz	elz
pvma	mama
pvmfry	fry
pvna	na
pvnt	pant
pvnvz	p
pvpat	pat
pv	p
pvp	p
pvp	p
pvrahv	p
pvranyk	frank
pvrjz	p
pvrkv	p
pvr	p
pvrtnvy	ivy
pvrtrfyld	pd
pvrvs	ps
pvryntvn	bryn
pvryr	cyr
pvsala	ala
pvsary	parry
pvsn	sn
pvs	ps
pvstyl	pl
pvsv	p
pvsy	p
pvtkvnn	penn
pvt	pt
pvtry	petry
pvtyt	pt
pvtyt	pt
pvtz	putz
pvvlz	elz
pvv	p
pvynt	pant
pvyntyng	tyng
pvyryr	cyr
pvysl	pl
pvyv	p
pvzyvs	ps
pyak	pak
pyatjy	p
pyatk	k
pybady	addy
pydh	h
pyd	pd
pyd	pd
pyjh	h
pyjt	pt
pykap	p
pykard	packard
pykasv	p
pykl	pl
pyk	k
pyk	k
pyk	k
pyk	k
pykrl	perl
pyks	ks
pykvlbny	p
pykz	p
pylar	mylar
pylarz	marz
pylatv	plat
pylazv	pyle
pyl	pl
pyl	pl
pylvsky	sky
pylvyv	pyle
pyly	lyly
pylysnry	lyly
pynakl	akl
pyna	dyna
pyncaz	p
pyncra	pa
pyndar	pindar
pyndv	p
pyngnvt	pt
pyng	pang
pynkvvytz	putz
pynky	pinky
pyn	ayn
pyn	ayn
pyn	ayn
pynsn	sn
pynsvn	ayn
pynth	th
pyntn	ayn
pyntr	pyotr
pyntr	pyotr
pyntr	pyotr
pyntvn	ayn
pyntvn	ayn
pynv	p
pynv	p
pynxam	pam
pynyan	pinyan
pyny	p
pynz	p
pypgras	pipgras
pyp	p
pyp	p
pypr	pype
pypvny	pype
pyramyd	pyramid
pyran	pan
pyrany	franny
pyrard	pirard
pyravat	pat
pyrkv	p
pyrlman	perlman
pyrl	perl
pyrmn	mn
pyr	cyr
pyrsn	sn
pyrsn	sn
pyrsn	sn
pyrs	pyers
pyrs	pyers
pyrsvn	n
pyrt	port
pyrv	p
pyrvz	p
pyry	pery
pyryr	cyr
pyryz	p
pyrz	p
pysah	peasah
pysan	paysan
pysh	posh
pysly	sly
pysns	pepys
pys	pepys
pys	pepys
pys	pepys
pystvn	n
pytan	pan
pyta	pa
pyth	myth
pytj	j
pytkv	p
pytmn	mn
pyt	pt
pyt	pt
pyt	pt
pyt	pt
pytr	pyotr
pytr	pyotr
pytr	pyotr
pytrsvn	pyotrs
pytrv	p
pytrz	p
pyts	pts
pytybvn	python
pyvmly	lyly
pyvn	n
pyvnyk	k
pyv	p
pyvryntn	bryn
pyvtr	pyotr
pyyk	k
pyyry	pery
pyyv	p
pyza	pa
pyzly	lyly
pyzs	ps
pyzvlytv	p
pyzyaly	alya
pyzyny	p
pyzy	p
pyzyr	pyziur
pzarays	ararats
qadsyh	h
qalya	alya
qasan	hasan
qasm	qasim
qayd	d
qays	fays
qbylh	h
qdamh	h
qdyla	layla
qdyl	l
qdym	m
qdyra	byra
qdyr	cyr
qdysh	h
qdysyha	a
qlya	alya
qlyba	ba
qlyb	yb
qlyla	layla
qml	l
qmr	mr
qntvn	n
qrbya	a
qrybyh	h
qsan	san
qsn	sn
qsym	m
qsym	m
qtran	tran
qvasym	m
qvbylh	h
'qyla	layla
'qyla	layla
'qyl	l
'qyl	l
qyt	q
qyvn	n
rabkyn	rabkin
rabld	rabold
rabl	rabel
rabnav	av
rabn	raben
rabn	raben
rab	arab
rabrt	rabat
rabrtsn	raben
rabrtsvn	raben
rab	arab
rabtm	ram
rabvyl	rabel
rabydyaks	raby
raby'h	raby
rabyjn	raby
rabyn	raby
rabyn	raby
rabynsn	raby
rabynsvn	raby
raby	raby
raby	raby
rabyv	raby
racl	cl
rac	ac
radak	ladak
radbrg	rad
radbvd	rad
radbvn	rad
radha	radha
radhyka	radha
radklyf	rad
radk	rad
radmn	rad
radnbrc	rad
radnbrgarbrvk	rad
radnbrgrabrk	rad
radnbrgrabrvk	rad
radnbrgrbrvk	rad
radnyk	rad
rad	rad
radramvny	rad
radrfrd	rad
radr	r
radr	r
radt	rad
radva	ra
radvf	rad
radvlfs	rad
radvlfvs	rad
radv	rad
radvyg	rad
radyah	radeyah
radyh	rad
radyng	rad
rady	brady
rafalkv	rafal
rafal	rafal
rafalsky	rafalski
rafa	rafa
rafayl	rafal
rafayly	ray
rafnr	r
raf	afaf
rafrty	rafferty
rafykyv	ra
rafyl	rafal
rafyn	ra
rafy	ray
ragatz	ragatz
raglnd	ragland
ragl	ragle
ragnar	ragnar
ragnarsvn	ragnar
ragnrd	rd
ragnvald	ragnvald
ragrv	agra
ragsdyl	ra
raharjv	ararat
rahbk	bk
rahrr	r
rahryg	mahrah
rahvl	rahul
rahy	ray
rajcr	r
rajndr	rajendra
rajn	raj
raj	raj
rajr	r
rajrz	raj
rajs	raj
rajv	raj
rajyv	raj
rakah	barakah
rakl	akl
rakl	akl
rak	ra
rakvn	ra
rakv	ra
rakykvt	rat
ralf	ralf
ralf	ralf
ralf	ralf
rama	rama
rambl	ram
rambv	ram
ramplz	ram
ram	ram
ram	ram
ramr	r
rams	ramses
ramsy	ramsay
ramsyr	r
ramtan	amran
ramvlvs	ram
ramvs	ram
ramy	amy
ramyrv	ram
ramz	ram
rana	rana
randl	rand
randr	andr
rangl	range
rankyn	rankin
rann	ann
ran	ragan
ran	ragan
ran	ragan
ranr	r
rantgn	ragan
rany	randy
rany	randy
rany	randy
ranyv	ra
rapbryk	ra
rap	ra
rapr	apr
rark	ark
rasa	ra
rascn	ras
rasdal	randal
rasd	rad
rasfvrd	rd
raskh	ras
rask	ask
raskyn	raskin
rasl	ras
rasl	ras
rasmn	ras
rasndal	randal
rasndyl	randy
rasnman	inman
raspyny	ras
ras	ras
ras	ras
ras	ras
ras	ras
rastn	rastin
rastram	ram
rast	ras
rastyn	rastin
rasty	grasty
rasvm	ram
rasv	ras
rasv	ras
rasv	ras
rasyd	rad
ratcsvn	rat
ratgrt	rat
ratjrt	rat
ratks	ras
ratmn	rat
ratra	ra
rat	rat
ratrfvrd	rd
rat	rat
ratstrvm	atram
ravbatm	rabat
ravdah	raidah
ravda	pravda
ravda	pravda
ravlnd	rand
ravlt	rat
ravnr	r
rav	av
rav	av
rav	av
ravrdy	raverdy
rav	av
ravrt	rat
ravs	avs
ravt	rat
ravyah	radeyah
ravyh	ra
ravyndran	ravindran
ravyraj	raj
ravy	ravey
ravy	ravey
rayblt	rat
raydah	hudaydah
raydj	raj
raydl	ray
raydn	haydn
rayfl	ray
raylh	ray
rayly	ray
raymvnd	raymond
raynr	rayner
rayp	ray
ray	ray
raysl	ray
rays	brays
raystlyn	ayn
rayt	rat
raytz	ray
rayvard	rd
rayvlyngz	ray
rayv	ray
rayvtyala	ayala
rayzl	ray
razdan	razdan
razn	ra
razvrbk	bk
rbhvlz	rb
rbrtsvn	rb
rbvk	rb
rbvsv	rb
rbyah	ayah
rbyh	rb
'rbyl	l
rbys	rbs
rdah	raidah
rda	dada
rdbvn	rd
rdfyld	rd
rdlfvs	rd
rdlvs	rd
rdmn	mn
rdmyl	rd
rdryk	rd
rdva	ra
rdvlf	ralf
rdvndv	rd
rdydh	rd
rdyh	rd
rdy	rd
rfa	ra
rfsns	rns
rfsvn	rn
rf't	r
rgd	gd
rgv	r
rhlyng	rh
rhny	rh
rhymah	rh
rhymh	rh
rhym	rh
rjas	rajas
rjat	rajat
rj	j
rkah	barkah
rkdal	dal
rkkah	barkah
rkstn	rn
rkvg	g
rlf	ralf
rlyvs	rs
rlyvz	r
rmd	md
rmfr	r
rmlyngr	r
rmncyk	k
rmn	mn
rmns	mns
rmplyng	rampling
rmvny	rony
rmy	remy
rnaldz	rn
rnalt	kalt
r'na	na
rna	erna
rnavd	rd
rnbart	barnhart
rndhl	rn
rndr	r
rndy	randy
rnj	rn
rnvys	rns
rn	rn
rny	rn
rnzlnd	nd
rnz	rn
rplagl	pl
rprt	art
rptvn	rn
rqah	raqqah
rqa	ra
rqd	rd
'rryfa	a
rsa	ra
rsl	rs
rsl	rs
rsnyk	rs
rst	rest
rsvl	rs
rsvlvyrt	rs
rsvnat	nat
rsvndl	rs
rsyda	ayda
rsydh	rh
rsyd	rd
rsynh	rh
rsynjh	rh
rsynth	rath
rsyntj	resyntje
rsyvyn	rn
rtklyf	f
rt	art
rvan	van
rvatr	r
rvay	ray
rvayz	r
rvaznr	r
rvbrj	j
rvbr	r
rvbrta	ra
rvbrt	art
rvbrtsvn	rn
rvbrtv	r
rvbvz	r
rvbyn	robyn
rvbynsvn	robyn
rvbynz	r
rvby	raby
rvby	raby
rvc	c
rvc	c
rvda	dada
rvdh	rh
rvdlv	r
rvdnbrg	g
rvd	rd
rvd	rd
rvdrygv	r
rvdrygz	r
rvdvlfas	ras
rvdvlf	ralf
rvdvlfvs	rs
rvgalsky	rogalsky
rvgvza	ra
rvhan	han
rvhl	l
rvhm	rohm
rvhn	rn
rvhrr	r
rvhr	r
rvjas	rajas
rvkan	kan
rvka	ra
rvkn	rn
rvkry	rory
rvksan	san
rvksan	san
rvkv	r
rvkyky	r
rvkz	r
rvland	land
rvldan	roldan
rvlfh	rh
rvlf	ralf
rvlf	ralf
rvlnd	nd
rvls	ls
rvlv	r
rvly	lyly
rvmfvrt	art
rvmrv	r
rvmyg	g
rvmyv	r
rvnald	ronald
rvnda	ronda
rvndh	rh
rvndl	l
rvndyn	rn
rvngv	r
rvntry	gantry
rvny	rony
rvny	rony
rvnyt	r
rvpkh	rh
rvprt	art
rvp	p
rvrkh	rh
rv	r
rv	r
rvr	r
rv	r
rvry	rory
rvrys	rorys
rvsalyn	rosalyn
rvsam	ram
rvsam	ram
rvsana	rana
rvsa	ra
rvskv	r
rvsl	l
rvslyn	roslyn
rvslyn	roslyn
rvsnal	al
rvsnblat	blatt
rvsndal	randal
rvsndl	l
rvsnfld	rd
rvsn	rn
rvsnr	r
rvs	rs
rvs	rs
rvs	rs
rvsr	r
rvstad	rostad
rvstnd	nd
rvsvlt	lt
rvsvn	rn
rvsv	r
rvsv	r
rvsyala	ala
rvsytr	r
rvtabaga	rutabaga
rvtgr	r
rvtgrt	art
rvtj	j
rvtjy	r
rvtrfrd	rd
rvt	r
rvt	r
rvt	r
rvt	r
rvt	r
rvt	r
rvt	r
rvts	rs
rvtz	ritz
rvvlvry	rory
rvvth	rath
rvvt	r
rvvt	r
rvyah	ayah
rvyal	royal
rvyapa	royappa
rvybl	l
rvydn	rn
rvyh	rh
rvyl	l
rvyly	lyly
rvymata	mata
rvyn	rn
rvyn	rn
rvypk	k
rvy	ivy
rvys	roys
rvys	roys
rvys	roys
rvytnbrg	g
rvyyz	r
rvyz	r
rvzmary	mary
rvzmary	mary
rvzndal	randal
rvznfldr	r
rvznjk	k
rvzn	rn
rvz	r
rvz	r
rvz	r
rvzvlt	lt
rvzy	r
rvzyr	r
rvzyr	r
rvzyta	ra
ryad	rad
rybak	babak
rybar	babar
rybk	bk
ryb	rb
rybrn	rn
rycard	rd
rycardsn	cardin
rycardsvn	cardin
rycar	r
rycav	av
rycmn	mn
rycmyr	r
ryc	c
rycr	r
rycy	rory
rycy	rory
ryda	rya
ryda	rya
ryda	rya
rydh	rh
rydh	rh
rydj	j
rydkvyst	myst
rydl	l
rydnbrc	bryde
rydnbrgyrbrak	ra
rydn	ryden
ryd	rd
rydr	r
rydyg	g
rydy	rory
ryfkaynd	nd
rygan	ryan
rygard	rd
ryglr	r
ryg	g
rygv	r
rygynz	r
ryhana	rana
ryhanh	thanh
ryhl	l
ryjkard	rd
ryj	j
ryjsvyjk	k
ryjsvyk	k
ryjynz	r
rykard	rd
rykard	rd
rykr	r
rykrt	art
ryksvn	rn
ryktz	ritz
rykvlsvn	rn
ryky	rory
rylnd	nd
ryl	beryl
rylsbk	bk
ryly	lyly
rymant	anant
rymnd	nd
rymnz	r
rym	m
rymrs	rs
rymvnd	nd
rymvnd	nd
rymvnd	nd
rymvn	rymon
rymyl	rymill
rymy	remy
rynah	nahnah
rynalda	reenalda
rynald	ronald
rynalds	renalds
rynaldz	reynaldo
ryndnr	r
ryndrt	art
ryndrz	r
ryng	ring
ryngst	rest
ryngvvd	rd
rynh	rh
rynkr	r
rynlda	rya
ryn	bryn
ryn	bryn
rynr	r
rynr	r
rynrt	art
ryntvl	l
rynvd	rd
rynvlda	rya
rynvld	rd
rynvld	rd
rynvlds	ds
rynvldsvn	bryn
rynvldz	r
rynvvd	rd
rypl	pl
ry	rory
ryrdan	ryan
ryrdan	ryan
ryrdn	rd
ry	rory
ryrsvn	rn
ryrz	r
rysah	rh
rysalvyrt	rysavy
rysar	r
rysavy	rysavy
rysjy	rory
ryskar	kar
ryslvrt	art
ryslyng	rysling
rysly	sly
rysnr	r
rysnr	r
rysnyk	k
rysrc	c
rys	rorys
rys	rorys
rys	rorys
rys	rorys
rys	rorys
rysr	r
rysr	r
rystv	r
rystyntjy	rusty
rysty	rusty
rysvlvrt	art
rysvlvvrt	art
rysvr	r
rysvyk	rysavy
rysy	rory
rytakv	r
ryta	rya
rytcy	rory
ryt	r
rytsgrt	ritsgert
rytvgr	r
rytysgrt	art
rytzgrt	art
rytz	ritz
rytzr	r
ryvard	rd
ryvbr	r
ryvdt	r
ryvmlr	r
ryvnsvn	rn
ryvnvld	rd
ryvpka	rya
ryvr	r
ryv	r
ryvrz	r
ryvv	r
ryvyrh	rh
ryvys	rorys
ryyad	rad
ryyd	rd
ryynks	ks
ryyr	r
ryz	r
ryzr	r
ryzvlvrt	art
ryzv	r
ryzvy	rory
rzbry	rory
rznbavm	m
rznfld	rd
rznkrans	anshans
rznlf	ralf
rznmn	mn
rzntjy	r
rzvlvrt	art
rzynt	r
saartj	saartje
sabglasyal	sal
sabhany	abhay
sablt	sabot
sabramanyam	abram
sabramanyan	samman
sab	saab
sabtns	s
sabt	sabot
sabvryn	sabin
sabvs	s
sabyn	sabin
sabyny	abby
sacat	sat
sack	ack
sacr	cr
sadgrv	sade
sadha	shadha
sadlr	sadler
sadrblam	sam
sadyah	sadah
sadyh	sadah
sadyk	sade
sadykv	sade
sadykvyh	sadah
sadykyv	sade
sadyvp	sade
safr	fr
saf	afaf
saft	sat
saftvr	saar
saftyn	san
sagars	sagans
saga	sagan
sagayy	sagady
sagn	sagan
sagrv	sage
sagrv	sage
sahasy	sahasi
sah	sadah
sahvlm	sam
sajn	san
sajrv	s
sakamvtv	sakai
sakary	sakari
sakayv	sakai
saklad	saklad
sakla	saklad
saksna	saks
saksnm	saks
saks	saks
saks	saks
saksvn	saks
saksym	saks
saktn	san
sakt	sat
sakya	shakya
saky	sky
salga	algal
salgvrv	sal
salkras	salas
salk	salk
salmvnd	salmond
salmy	sal
saltzmn	saltzman
saltz	sal
salvmn	sal
salvm	sal
salvmvn	sal
salyan	san
salygram	sam
salyn	allyn
saly	sally
salyt	salyut
salyvan	san
salzbrg	salzberg
salznbrg	salzberg
samadar	samaddar
samah	samah
samakr	sakr
saman	samman
samanta	santa
samanta	santa
samar	samar
samas	asamas
sambat	sat
sambvlyk	sam
samgyn	sam
samh	sam
samk	sam
saml	sal
samn	sam
samral	sal
samr	sam
samr	sam
samrz	sam
sam	sam
sams	sams
samtyng	sang
samvls	sams
samvn	sam
samvsky	samosky
samvyl	sal
samyr	sam
samyt	sam
samyt	sam
samz	sam
sanahan	shanahan
sanandv	sana
sana	sana
sanbrn	san
sancty	san
sandar	sardar
sandhv	sand
sandlyn	san
sandman	sandman
sandram	sandra
sandrm	sand
sandrnz	sanz
sandrs	sadrs
sandrsvn	san
sandrz	sand
sandrz	sand
sand	sand
sandyp	sandy
sandy	sandy
sangld	sand
sang	sang
sang	sang
sangv	sang
sanjay	sanjay
sanjh	san
sanjstr	san
sankar	sanka
sankn	san
sankr	sakr
sankr	sakr
sank	san
sank	san
sanla	sana
sanly	sally
sannar	saar
sanrang	sang
sanrayz	sanz
sanrjh	san
sanrth	san
sanrtjy	san
sanrt	san
sansayn	san
sansbrn	sansburn
san	san
san	san
sanss	kansans
sanst	st
sansvn	san
santana	santana
santa	santa
santh	san
santj	santje
santjy	santje
santrtj	santje
sant	anant
santsbrn	san
santv	san
santvs	santanas
santvsy	san
santyk	san
santy	san
sanvndv	sand
sanvn	san
sanv	san
sanyl	sal
sany	san
sany	san
sanyt	san
sanzbvrn	san
sanz	sanz
saprv	apr
sap	gap
sarann	saran
sara	sara
saraty	sarathy
sardgna	sardegna
sardlv	sardar
sardv	sardar
sarjh	sarah
sarknas	sharknas
sarlvt	sat
sarly	carly
sarma	sarma
sarna	sarna
sar	saar
sar	saar
sartaksv	saks
sarth	barth
sartj	saartje
sartjy	saartje
sart	art
sart	art
sartzr	saar
sarvath	horvath
sarvk	saar
sary	cary
saryvl	sal
sasaky	sky
sasan	san
saska	laska
saslav	saslav
sasmn	san
sasnhym	sam
sasn	sn
sastk	salk
sastyk	salk
saszh	sasze
sasz	sasze
saszy	sasze
satfn	san
satfyn	san
satj	sat
satkas	sankas
satn	san
satr	sat
satr	sat
sat	sat
sat	sat
satvn	san
satvn	san
satvr	sat
satv	sat
savan	san
savaram	savaram
savars	samars
savcvk	salk
savdy	sandy
savfrd	rd
savl	sal
savl	sal
savl	sal
savlz	sanz
savndrz	sadr
savsan	san
sav	av
savtr	saar
savtr	saar
savtz	savetz
savvy	savoy
savyn	san
savyr	saar
saybrmyj	j
saybrt	sat
sayda	ayda
sayks	saks
saykv	s
saylr	sayer
saymkv	s
saym	sam
saymvn	san
saymvns	s
sayp	p
sayry	sayre
saytj	j
sayt	sat
saytv	s
saytz	sanz
sayvrynglnt	saint
sayvyrdynglant	langland
sayvyr	sayer
sazh	h
sbastyn	sb
sbastyn	sb
sbayn	ayn
sbhan	shan
sbra	sabra
sbrt	sb
sbryany	bryan
sbry	sb
sbs	sbs
sbyrah	sarah
sbyra	byra
sbyrh	rh
sbystn	sb
sbyt	sb
sdah	sadah
sdah	sadah
sda	dada
sday	day
sdgrv	s
sdha	shadha
sdh	h
sdlr	lr
sdrhlm	sm
sdrvv	s
sd	d
sds	s
sdval	sal
sdvr	sr
sdv	s
sdya	a
sdyh	h
sdyk	k
sdyra	byra
sfard	bard
sfrd	rd
sf	f
sfyld	sold
sgal	algal
sgvra	ra
sha	shadha
shrab	sohrab
shr	sahr
sh	shuh
shyb	sb
skanl	skahan
skarp	karp
skar	kar
sklany	lanny
skman	akman
skrntn	rn
sksnm	sm
skspyr	spur
skstn	sn
skstvn	sn
skt	st
skvyra	byra
skyvryty	sky
slamky	sky
slamn	slan
slar	solar
slaryr	solar
slat	sat
slay	sly
slayz	slak
slbrg	g
slbrg	g
sldn	slan
sldvn	slan
slf	alf
slfy	sly
slj	j
slj	j
slk	salk
slma	salma
slma	salma
slmydy	sly
slmy	sly
slny	sly
slr	lr
sl	l
sl	l
slt	lt
slth	seth
sltjh	h
sltvn	slan
slva	silva
slvd	blvd
slvdvf	f
slvn	slan
slvn	slan
slvvd	blvd
slyj	sly
slymanyh	lyman
slyma	sloma
slymh	sly
slym	sly
slym	sly
slyna	sly
slypry	sly
sly	sly
slytr	sly
slyv	sly
smah	mah
smal	small
smalyah	mah
smalyh	small
'sman	isman
smar	mar
smar	mar
sma	asma
sma	asma
smat	mat
smbhv	sm
smblnks	s
smh	sm
smkvvn	sm
smly	sly
smma	samma
smmr	mr
smpl	pl
smpt	pt
smrn	rn
smr	mr
smr	mr
sm	sm
smsc	sc
smsl	sms
smvtyvk	sm
smyah	ayah
smyh	sm
smylh	sm
smym	sm
smyrah	sarah
smyra	myra
smyra	myra
smyrh	rh
smyr	emyr
smyr	emyr
smyr	emyr
smys	s
smytly	sly
smyz	sm
snan	sn
sna	na
sna	na
sna	na
sndbrg	sandberg
sndfvrd	nd
sndhyl	sn
sndlyn	sn
sndmn	sn
sndrs	s
sndrz	sn
snd	nd
snds	nds
sndvyk	sn
sndy	sandy
sndz	sn
snfng	sang
snftlybn	sn
sngal	sangal
snglvglv	sn
sng	sang
sng	sang
sng	sang
sngvpta	sengupta
sngvta	sita
snhal	snehal
snjh	sn
snkyat	sat
snnrtj	sn
snny	sonny
snqan	sn
snr	sn
snsbrn	sn
sn	sn
sntj	sn
snt	sn
sntyagv	sn
snvry	sn
snvtv	sn
snyrjh	sn
spard	spaniard
sparndam	spaarndam
spastyn	spahn
sphr	sphar
sprd	rd
spryngr	springer
sp	p
spynval	sal
spy	s
srab	sarab
srafyn	sn
srasvl	sr
sratvza	ra
sraynh	sr
srcak	slak
srdar	sardar
srhyr	sr
srjh	sr
srkamb	kamb
srkan	kan
srk	sr
srks	s
srkyah	ayah
srkyh	sr
srld	sold
srl	sr
srlyng	sang
srly	sly
srman	man
srmn	mn
srpnt	sr
srqyh	sr
srr	sr
srr	sr
sr	sr
sr	sr
sr	sr
srsta	srs
'srt	art
srtryd	sr
srvady	addy
srvary	bovary
srvmbc	sc
srvvd	sr
srvyc	sc
srvydyv	sr
srvys	s
srvy	sr
srya	rya
sryf	sr
sryf	sr
sryngtvn	bryn
sry	sr
sry	sr
sry	sr
sryt	sr
sryvr	sr
ssadry	sadr
ssany	san
ssdry	ss
ssyl	ss
starlvzn	stan
stfanvs	s
sthvrajan	sethurajan
stlayn	ayn
stlnd	nd
stlr	lr
stl	st
stmf	st
stnt	st
stratvn	straton
strytr	sr
st	st
stvfl	st
stvraman	samman
stv	st
styvnsvn	sn
svafvrd	rd
svagatv	agate
svamy	amy
svamy	amy
svank	shank
svan	san
svan	san
svanyk	k
svany	swany
svarmn	mn
svart	art
svaryngyn	karyn
svas	s
sva	siva
svayda	ayda
svbhandv	hand
svbvtka	atka
svcan	san
svdan	dan
svdan	dan
svdarmv	sardar
svdarsan	san
svdr	dr
svdyp	p
svdyptv	s
svdyr	sr
svdz	s
svfn	sn
svfr	fr
svfyh	h
svfyld	sold
svfy	s
svgn	sn
svgrlf	alf
svg	g
svha	shadha
svhas	sashas
svha	shadha
svhm	sm
svkk	k
svkla	la
svkvl	l
svkvmar	mar
svlar	solar
svlaymnyah	ayah
svldr	dr
svld	sold
svlfvr	sr
svlk	salk
svl	l
svl	l
svltan	stan
svlt	lt
svltz	oltz
svlvmvn	sn
svlv	s
svlvvy	ivy
svlvyr	sr
svlvy	ivy
svly	sly
svlys	s
svlytas	stas
svma	mama
svmasykar	kar
svmjy	s
svmn	mn
svmr	mr
svmrvyl	l
svmvy	ivy
svmykr	kr
svnar	ar
svna	na
svndaram	sundaram
svndrz	s
svngkrn	rn
svngr	sr
svngrvala	ala
svng	sang
svnja	sonja
svn	sn
svn	sn
svn	sn
svnsn	sn
svn	sn
svny	sony
svny	sony
svpn	sn
svpratyk	k
svpryv	s
svp	p
svrab	sarab
svrab	sarab
svraj	raj
svrana	rana
svrk	ark
svrl	l
svrnsn	sn
svrn	rn
svr	sr
svr	sr
svrs	s
svrsvn	sn
svrtl	tl
svrtn	sn
svrvaly	sally
svryndr	andr
svryn	bryn
svsal	sal
svsa	sana
sv	s
svsh	shuh
sv	s
svsn	sn
sv	s
sv	s
sv	s
svsya	a
svsyl	l
svtan	stan
svtfn	sn
svtn	sn
svtr	sr
svtr	sr
svts	s
svtv	s
svyak	slak
svyda	ayda
svydh	h
svyft	soft
svylr	lr
svylr	lr
svynglr	lr
svynrtvn	sn
svyn	sn
svyn	sn
svyr	sr
svytnky	sky
svytv	s
svyynk	sunk
svzalys	sallys
svzana	sana
svzanh	h
svza	zaza
svz	s
svzv	s
svzy	suzy
syandra	sandra
syang	sang
syang	sang
syanv	s
sybacr	cr
sybl	sybil
sybl	sybil
syblt	lt
sybly	sly
sybrt	st
syda	ayda
s'ydh	h
sydlr	lr
sydlr	lr
sydmn	mn
sydny	sydney
sydr	dr
s'yd	d
syd	d
syd	d
sydvr	sr
s'ydy	s
syfard	bard
sygl	l
sygl	l
sygltvn	sn
sygmn	mn
sygmn	mn
sygmn	mn
sygmvnd	nd
syg	g
sygs	s
syhan	shan
syhn	sn
syhsvbhvn	sn
syhy	s
syjh	h
syjkv	s
syjmn	mn
sykagv	s
sykar	kar
sykarv	harv
sykr	kr
syk	k
sykvlv	s
sykvra	ra
syky	sky
syla	layla
sylbrman	sylvan
sylbrmn	mn
syldn	sn
syldz	s
sylk	salk
syl	l
sylvan	sylvan
sylva	sylvan
sylvd	blvd
sylvnn	sylvan
sylvrbrg	sylvan
sylvrmn	sylvan
sylvr	sr
sylvrtvrn	sylvan
sylvrvd	blvd
sylv	sylvan
sylvvd	blvd
sylvya	sylvia
sylvya	sylvia
sylvy	sylvan
sylvyv	sylvan
sylyg	lyly
sylyman	lyman
sylymn	lymn
syly	lyly
syly	lyly
sylyt	lyly
sylzmn	mn
sylz	elz
sylz	elz
symal	sal
symard	simard
symayh	syme
symbab	siembab
symlr	lr
symnds	nds
symn	lymn
symn	lymn
symn	lymn
symn	lymn
symn	lymn
symnz	sanz
symplysyty	sly
symr	mr
symr	mr
syms	s
syms	s
symsyk	syme
symvdynz	sanz
symvna	na
symvnds	nds
symvnh	syme
symvnh	syme
symvn	sn
symvn	sn
symvnsn	sn
symvns	s
symvnz	sanz
symvnz	sanz
symyng	synge
symyngtvn	symington
symyn	sn
symyn	sn
symz	syme
symz	syme
syna	dyna
synan	banan
syna	dyna
synayn	ayn
syndlmn	mn
syndrh	rh
syngltvn	synge
syng	synge
synk	sunk
synklary	larry
synklayr	dayr
synklr	lr
synk	sunk
synr	sr
syn	sn
syn	sn
syn	sn
syn	sn
syn	sn
syn	sn
syn	sn
syntya	sync
synv	sync
synvy	sync
synybaldy	albany
synyg	sync
syny	sony
sypl	pl
syplvaydn	sylvan
syplvydn	sn
syplz	elz
sypmn	mn
sypn	sn
sypryanv	ryan
syp	p
syrafyn	sn
syran	syrian
syrant	anant
syra	syria
syray	ray
syrcnt	st
syr	sr
syrkvys	s
syrl	l
syrly	sly
syrr	sr
syr	sr
syr	sr
syr	sr
syrs	s
syrs	s
syrvka	syria
syrvn	sn
syrvs	s
syrvyz	s
syryf	f
syryl	sheryl
syrylv	sylvan
syryng	synge
sysaba	baba
sy	s
sy	s
sy	s
sy	s
sysk	sisk
syslvnz	sanz
syslv	slav
sys	s
systmz	st
sysz	s
sytaram	sitaram
syta	sita
sytay	tay
syth	myth
syth	myth
sytj	sytje
sytjy	sytje
sytlayv	slav
sytlr	lr
sytrah	sitrah
sytra	tra
sytrh	rh
syt	st
syt	st
syts	s
sytv	s
sytya	a
sytyh	h
syty	ty
sytyzn	sn
sytz	s
sytz	s
syvald	bald
syvalv	alva
syva	siva
syvayrdynglnt	synge
syvla	la
syvl	l
syvmn	mn
syvng	sang
syvnka	sanka
syvn	sn
syvnys	s
syvrdynglnt	synge
syvr	sr
syv	s
syv	s
syvsmnz	sanz
syvvd	d
syvyrdynglant	langland
syvy	ivy
syvy	ivy
syyvayrdynglnt	synge
syyvnyl	l
syznhym	sm
szarv	harv
tabvk	tabuk
tabyt	t
tac	ac
tadr	tad
tad	tad
taft	taft
taftz	taft
tafvn	ta
taglv	tagle
tahara	tahara
tahryha	ta
tahvn	ta
tajh	ta
taka	taka
takmn	tak
takr	tak
taksbry	tak
takv	tak
taky	tak
talan	tallan
talbrg	ta
talbvyz	ta
talkvt	t
talmayr	mayr
talmn	talman
talmy	talmy
taln	ln
talnv	ta
tals	als
talvann	galvan
talybah	talibah
talys	italys
tamana	tammana
tamara	tamara
tamas	tamas
tamatyvs	tamas
tamay	tay
tambrvs	tam
tamb	tam
tampas	tampas
tampkynz	tam
tamsn	tam
tamsvn	tam
tam	tam
tam	tam
tam	tam
tamynz	tam
tamy	tammy
tamz	tam
tanak	tanak
tana	ta
tang	tang
tang	tang
tanjs	tanis
tankn	tanzanian
tann	ann
tantvn	tanton
tanys	tammanys
tapa	ta
taplyn	taplin
tapr	apr
tapsyn	ta
taptany	tammany
tapyk	tak
tapyn	ta
tapyv	ta
tara	tara
tardl	tartar
tarkl	tartar
tark	tartar
tarml	tartar
tarn	tartar
tarq	tartar
tars	tartars
tarsvn	tartars
tar	tartar
tarvb	tartar
taryk	tartary
tasdylr	tas
taskr	tasker
tatam	tattam
tatary	tartary
tatbay	tatby
tath	th
tatj	tat
tatl	tl
tatl	tl
tatrvy	tat
tatsvrv	tat
tat	tat
tat	tat
tat	tat
tatyh	tat
tatyh	tat
tatyl	tat
tatz	tat
tavars	tartars
tavrnyny	tay
tavr	tatar
tav	av
taybvt	t
tayjmn	tay
taylbry	tay
taylmans	mans
taylmnz	tay
taylr	taylor
taylv	tay
taymn	tay
taynvr	tatar
tayray	tay
tayr	tatar
tayrvn	tay
tayry	tay
taysn	tay
taysvn	tay
tay	tay
tayt	t
tay	tay
tayty	tay
tayv	tay
tbt	t
tbvk	tb
tbyb	tb
tbyt	t
tdl	tl
tfylah	lylah
tfyla	layla
t'fylh	th
tglbrg	g
tgl	tl
thsyn	ths
th	th
thyrah	th
thyra	thara
thyrh	th
tjajh	th
tjatj	tjaatje
tks	ks
tk	k
tk	k
tk	k
tkyah	ayah
tkyh	th
tlandr	andr
tlbrt	t
tlbvys	tls
tlbvyz	tl
tlfr	fr
tlkvm	tl
tllv	tl
tlnt	t
tlr	lr
tl	tl
tlybah	babah
tlyba	ba
tlybh	th
tlyb	tb
tmbry	tm
tmplmn	mn
tmplr	lr
tmpltvn	tm
tmpst	t
tm	tm
tmyr	emyr
tnant	anant
tnaya	tenaya
tnbrvk	k
tnbv	t
tndyry	andy
tnkn	n
tnpv	t
tnts	ts
tnt	t
tnvr	r
tnvryv	t
tnykn	n
tnysan	san
tny	tiny
tpv	t
tqyh	th
trada	tra
traftvn	trafton
trafvrd	trafford
trah	tahirah
trajktnsys	trans
trakv	tra
tran	tran
tranytsa	tra
trap	trapp
trapyn	tran
trash	trash
trastr	traster
tra	tra
travajlya	tra
travn	tran
travzy	tra
trayktnsys	trans
traynth	th
trayntz	tra
traynvr	traynor
traystnsys	trans
traystnys	tracys
traysy	rattray
traz	taraz
trbry	tory
trd	rd
trfvrd	rd
trld	d
trldy	trudy
trl	tl
trlv	t
trmvyl	tl
trmynal	al
trnr	r
trnsh	trash
trns	rns
trn	rn
trntn	rn
trnt	t
trnyk	k
trsa	tra
trs	rs
trstvn	tran
trtjy	trey
trtjy	trey
trtnh	trinh
trtvan	tran
trtvn	tran
trvb	tb
trvby	toby
trvdl	tl
trvdsvn	tran
trvf	f
trvgtvn	tran
trvhykv	t
trvks	ks
trvl	tl
trvl	tl
trvlyngr	tyng
trvmbv	t
trvmytr	r
trvn	tran
trvp	p
trvrays	tracys
trvr	r
trvryk	k
trvrys	torys
trv	t
trvtr	r
trv	t
trvt	t
trvylygr	lyly
trvyryk	k
trvysdyl	tl
trvyth	th
trvytj	j
trvyt	t
trvyyjh	th
trybl	tl
trybl	tl
trydvy	tory
trygs	gs
tryjv	t
tryk	k
tryktnsys	torys
trykt	t
trymstar	tartar
trym	tm
tryndad	tad
trynd	nd
trynham	trainham
trynjh	th
trynkl	tl
trynth	th
tryntj	tryntje
trynt	t
trynvr	r
tryps	ps
tryq	q
trys	torys
trystnsys	torys
trystrm	tm
trysy	tory
trysy	tory
try	tory
try	tory
try	tory
try	tory
trytl	tl
trytl	tl
trytvry	tory
tryvlv	t
tryvrays	tracys
tryvr	r
tryvytz	titz
trzh	th
tskr	kr
tsla	tesla
tslr	lr
tsnr	ts
tsta	ta
ts	ts
tstr	ts
tsyma	mama
tsynk	ts
ttjy	ty
ttrad	tetrad
ttr	r
ttrv	t
ttrvyn	tran
tvama	camama
tvary	tartary
tvaycl	cl
tvb	tb
tvbvtys	tys
tvbyas	tas
tvbyn	ayn
tvdar	adar
tvd	d
tvfry	fry
tvfth	th
tvhla	la
tvkr	kr
tvk	k
tvkyv	t
tvlany	lanny
tvla	la
tvlay	tay
tvldv	t
tvlmn	mn
tvl	tl
tvlyn	lyn
tvly	lyly
tvly	lyly
tvly	lyly
tvlyvr	r
tvlyv	t
tvmany	many
tvmas	tamas
tvmas	tamas
tvmatyvs	tys
tvmbly	twombly
tvms	tms
tvm	tm
tvmy	ty
tvmy	ty
tvmy	ty
tvmytyvs	tys
tvmz	t
tvnar	tonar
tvnga	tonga
tvng	tang
tvng	tang
tvng	tang
tvnjs	js
tvnr	r
tvns	ns
tvn	n
tvnys	tys
tvnys	tys
tvnys	tys
tvny	tiny
tvrad	rad
tvrambr	br
tvraya	rayya
tvrbr	br
tvrda	torda
tvrkat	t
tvrkv	t
tvrldh	th
tvrmala	tormala
tvrmn	mn
tvrnbrg	tornberg
tvrnly	lyly
tvrnr	r
tvrn	rn
tvrn	rn
tvrntvn	rn
tvrp	p
tvrtl	tl
tvrtn	n
tvrtvn	n
tvrvf	f
tvrvp	p
tvrya	rya
tvryn	bryn
tvrysn	sn
tvry	tory
tvrz	t
tvsar	ar
tvskanv	kan
tvs	ts
tvsv	t
tvsyng	tyng
tvsynk	k
tv	t
tv	t
tvty	ty
tvvys	tys
tvyda	ayda
tvydy	ty
tvyh	th
tvyn	ayn
tvyt	t
tvyt	t
tvyydyl	tl
tvyyg	g
tvyyn	ayn
tybat	bat
tybl	tl
tybvt	t
tycavr	ty
tyd	ty
tyf	ty
tyfvrd	rd
tygv	ty
tyhan	han
'tyh	h
tyjath	th
tyjmn	mn
tylbry	ty
tyldn	ty
tylgnr	tyler
tylmans	tysmans
tylmns	mns
tylmnz	ty
tyln	ln
tylr	tyler
tylr	tyler
tylv	ty
tylvtsan	san
tylyng	tyng
tymbvl	tl
tymkv	ty
tymn	tymen
tymn	tymen
tym	tm
tymvnyn	tymen
tymvr	ty
tymyan	tymen
tymynz	ty
tymz	ty
tynant	anant
tyna	dyna
tyndal	tyndall
tyndal	tyndall
tyngly	ty
tyng	tyng
tyng	tyng
tynsl	tl
tynsly	ty
tyn	ty
tyn	ty
tyn	ty
tyny	ty
typal	paypal
typv	ty
tyrny	ty
tyrvks	tys
tyryh	th
tyry	ty
tyrza	tirza
tysmnz	tys
tys	tys
tysynjr	tynor
tysza	tisza
ty	ty
tytay	tay
tyth	th
tytmas	tamas
tyts	ts
tyt	t
tyt	t
tyty	ty
tyvga	ga
tyvmynn	lynn
tyvna	na
tyvnys	tys
tyvnys	tys
tyv	ty
tyyvln	ln
tyz	ty
vadaparty	vadaparty
vadh	va
vadry	vandry
vadzn	van
vafa	va
vafyah	ayah
vafya	va
vagl	val
vagnr	vagner
vagnr	vagner
vagn	van
vah	va
vajdyk	va
vakfyld	va
vakrdayn	vardan
vakvrn	van
valans	alans
valas	valhallas
valdmanyvna	mana
valdmnna	va
valdmnnyvyna	va
valdmnyvna	va
valdram	waldram
valdv	v
valdz	valdez
valh	val
valka	va
valknar	valkenaar
valmn	val
valntyjn	val
valntyn	val
valn	val
valryn	val
valtmn	val
valtn	val
valtr	val
valtrz	val
valtvn	val
valt	val
val	val
val	val
valvm	val
valvrt	val
valvr	val
valv	v
valvyn	val
val	val
valyhvr	val
valyngtn	allyn
valyngtvn	allyn
valyn	allyn
valys	vals
valys	vals
valy	val
valy	val
valy	val
valy	val
valyy	val
valz	val
vambvl	val
vanantvrp	vanantwerp
vananvrp	vanantwerp
vanatvrp	vanantwerp
vanbrn	van
vanbvrn	van
vandnbrq	van
vandn	van
vandrvyr	andr
vandrvyyr	andr
vandvsn	van
vandvzn	van
vandyk	vandyck
vandzn	van
vandzvn	van
vang	vang
vank	van
vankvrn	van
vankvrn	van
vanscvnhvn	van
vansk	van
vanskvnhvn	van
vansy	pansy
van	van
vanvlk	vanvleck
vanvrankn	vanvranken
vanvrnkn	vanvranken
van	van
vanzant	vanzandt
vanzndt	vanzandt
varbrg	vargo
varbrtvn	van
varbrvg	va
varbrvq	va
varbvrvg	va
varbvrv	v
vardy	hardy
vargas	vargas
vargv	v
varma	varma
varnr	ar
varnr	ar
varns	varnes
varn	van
varn	van
varny	varney
vartvn	van
varty	varty
varvl	varvel
varyans	aryans
varyants	variants
varyantz	yaryan
varyvr	ar
vasalv	v
vasky	sky
vaslv	v
vasm	sm
vasngtn	van
vasngtvn	van
vast	east
vast	east
vasvn	van
vas	as
vas	as
vasyk	va
vasym	va
vasyngtvn	van
vasyt	va
vatanab	van
vatanyb	van
vatkynz	va
vatrhavs	vs
vatrmn	van
vatrsvn	van
vatrz	va
vats	ats
vatv	v
vat	at
vavdray	ray
vavdry	vandry
vaya	vaya
vayb	va
vayby	va
vaydmn	van
vayd	va
vaygl	val
vayldr	dr
vayl	val
vaymn	van
vayngrv	v
vaynth	th
vayn	ayn
vaypkj	va
vaysmn	van
vays	fays
vaythavs	vs
vaythrn	van
vaythvrn	van
vaythvs	vs
vaytvrs	rs
vaytykr	kr
vaytykr	kr
vayzak	yzaak
vayz	va
vbr	br
vbstr	r
vb	b
vcnr	r
vdad	dada
vdbrg	g
vdlmvdy	v
vdlyn	lyn
vdmyr	emyr
vd	d
vfa	va
vfyah	ayah
vfyh	h
vfyyh	h
vgl	vogl
vgl	vogl
vgnr	r
vgnr	r
vhra	vohra
vjdan	dan
vjyha	va
vjyhh	h
vjyh	h
vkkya	va
vkrfas	as
vkrv	v
vk	k
vladak	ladak
vladan	vladan
vladv	vlad
vlam	lam
vlan	vladan
vla	la
vla	la
vldmn	mn
vldmnvna	amna
vldmn	mn
vldn	n
vld	veld
vlfsvn	n
vlkman	volkman
vlk	volk
vlk	volk
vlmjh	h
vlmn	mn
vlmth	th
vlmtj	j
vlmt	mt
vlnta	ta
vlntyjn	ln
vlntyn	ln
vlr	lr
vlsky	sky
vls	ls
vlsy	v
vltmr	mr
vltr	r
vltryng	tyng
vltry	fry
vlty	ty
vlvdyn	ayn
vlvsv	v
vlydh	h
vlyngtvn	lyn
vlynk	vonk
vlys	vs
vlys	vs
vlzl	l
vlz	volz
vlz	volz
vnabls	ls
vnantvrp	vanantwerp
vnascvnvn	n
vnbrn	rn
vnbvrn	rn
vncvnhvvn	n
vnc	c
vndazn	zn
vndlnd	nd
vndl	l
vndl	l
vndmn	mn
vndrfvrd	nd
vndrvr	andr
vndrvyr	andr
vndry	vandry
vndvsn	sn
vndvvsn	sn
vndvzn	zn
vndvzn	zn
vnd	nd
vndyk	k
vndzl	l
vng	vang
vnhf	hf
vnkata	venkata
vnkat	venkat
vnkrn	rn
vnkrn	rn
vnkvrn	rn
vnkvrn	rn
vnkv	v
vnkyvrn	rn
vnkyvrn	rn
vnlk	volk
vnntvrp	p
vnrnkn	rn
vnr	r
vnrypr	apr
vnskvnhvvn	n
vnsl	l
vns	ns
vnsvnhavn	han
vnsvnhvvn	n
vntrly	lyly
vntz	bentz
vn	n
vnvlk	volk
vn	n
vnvrankn	vanvranken
vn	n
vn	n
vn	n
vnyk	k
vnylk	volk
vnyngr	r
vnyrnkn	rn
vnzandt	vanzandt
vnzant	vanzandt
vnznd	nd
vnznt	t
vrbk	bk
vrbvrvf	f
vrcyk	k
vrdan	vardan
vrhvst	st
vrkmn	mn
vrlv	v
vrlynd	nd
vrlyng	tyng
vrmasrn	rn
vrmas	ermas
vrma	varma
vrmvln	ln
vrmvnt	t
vrmylyyvn	lyly
vrmyvln	ln
vrmz	v
vrngryn	bryn
vrnn	rn
vrnr	r
vrsvvn	n
vrvbl	l
vrvjh	h
vrvth	th
vrvvd	d
vrvvtj	j
vrvyj	j
vrylav	v
vrylv	v
vryty	ty
vry	fry
vsal	sal
vslyan	van
vsly	sly
vslz	volz
vsm	sm
vstal	vestal
vstfal	val
vstly	lyly
vstly	lyly
vstmvrlnd	nd
vstn	vs
vstrhlm	vs
vstrn	rn
vstrvldt	st
vstrvlt	lt
vstr	vs
vst	st
vstvn	vs
vstvr	vs
vst	st
vst	st
vs	vs
vsym	vs
vsyt	vs
vsy	vs
vsy	vs
vtmvr	r
vtr	r
vtr	r
vts	ts
vt	t
vvdard	bard
vvdbrn	rn
vvdd	d
vvdgyt	t
vvdhavs	vs
vvdn	n
vvdrv	v
vvdvard	edvard
vvd	d
vvglr	lr
vvgl	vogl
vvg	g
vvjak	vojak
vvk	k
vvlard	vlad
vvlard	vlad
vvlmn	mn
vvltrnyng	tyng
vvly	lyly
vvlz	volz
vvn	n
vvn	n
vvrdn	n
vvrylav	v
vvrylv	v
vvs	vs
vvtr	r
vyann	ann
vybh	h
vybkh	h
vybrnd	nd
vybvvv	v
vyb	yb
vyby	ivy
vycard	bard
vycvra	ra
vydad	dada
vydal	dal
vydal	dal
vyda	ayda
vydd	d
vydfang	vang
vydman	landman
vydmn	mn
vydmr	mr
vydry	vandry
vydvn	n
vyd	d
vydyr	cyr
vydy	ivy
vydyv	v
vyfal	val
vygand	anand
vygand	anand
vygjyn	ayn
vygly	lyly
vygmvr	r
vygn	n
vygrt	art
vygstvn	n
vygtvn	n
vyg	g
vygynz	v
vyjbrand	brand
vyjbrnd	nd
vyjdan	dan
vyjnand	anand
vyjnd	nd
vyjnnd	nd
vyjn	n
vykamp	lamp
vykas	vikas
vykavn	kan
vykfyld	veld
vykham	ham
vyklvnd	nd
vyknz	v
vykram	kram
vykrs	krs
vykrz	v
vyks	ks
vyks	ks
vyktvr	r
vyktvr	r
vyktym	m
vyk	k
vyk	k
vyk	k
vyk	k
vyladvt	vlad
vylard	villard
vylard	villard
vylaskv	v
vylas	laylas
vylatz	blatz
vyla	layla
vyla	layla
vylbr	br
vyldkat	at
vyldrmn	mn
vyldyng	tyng
vylfrd	rd
vylfrd	rd
vylhayt	hay
vylhlmas	velmas
vylhlmvs	vs
vylhlm	alm
vyljv	v
vylkaks	ks
vylkans	kansans
vylkas	vikas
vylkns	ns
vylkn	n
vylkrsvn	krs
vylkynsn	sn
vylkynsvn	ayn
vylkyn	ayn
vylkynz	v
vyllmvs	vs
vylmntjy	ivy
vylmr	mr
vylmtjy	ivy
vylmt	mt
vylmvr	r
vylmvt	t
vylmynth	myth
vylmyntjh	h
vylmyntj	j
vylmynt	t
vylmynyth	myth
vylnd	nd
vylnd	nd
vylnr	r
vylr	lr
vylr	lr
vylsvn	n
vyls	ls
vyl	l
vyl	l
vyl	l
vylyam	am
vylyamyna	alya
vylyany	lyly
vylyngham	ingham
vylyngz	lyly
vylyr	lyly
vyly	lyly
vyly	lyly
vyly	lyly
vylz	volz
vylz	volz
vymal	val
vyman	ayman
vyman	ayman
vymbrly	lyly
vymn	lymn
vymph	h
vympjh	h
vympj	j
vympjy	ivy
vymp	p
vympyj	j
vymr	mr
vynata	vinata
vynbrg	g
vyncstr	r
vyndn	ayn
vyndrz	v
vyndvm	m
vynd	nd
vynklman	elman
vynkl	akl
vynklz	volz
vynkv	v
vynlt	lt
vynnd	nd
vynn	lynn
vynrt	art
vynr	r
vynsnt	sns
vynsn	sn
vynsr	sr
vynstd	d
vynstrvm	m
vynstvk	k
vynstvn	ayn
vynsvn	ayn
vynth	th
vyntjh	h
vyntj	j
vyntjy	ivy
vyntrfyld	veld
vyntrmyvt	t
vyntrr	orr
vyntr	r
vyntrz	v
vyntvn	ayn
vynt	t
vyntz	bentz
vyn	ayn
vynvkr	kr
vyn	ayn
vynybl	l
vynyky	ivy
vynyngr	r
vynyngstd	d
vynyz	v
vynz	v
vypkjh	h
vypkj	j
vypkjy	ivy
vypk	k
vypyn	ayn
vyraf	viraf
vyrcval	val
vyrjyl	l
vyrjynya	va
vyrndra	andra
vyrn	rn
vyrsma	asma
vyrtann	ann
vyrt	art
vyr	cyr
vyr	cyr
vyr	cyr
vyryana	ana
vyrz	v
vysal	sal
vyska	va
vysl	l
vyspy	ivy
vysr	sr
vysr	sr
vystfal	val
vystvn	n
vyst	myst
vys	vs
vysvn	n
vysvn	n
vysy	ivy
vysyvs	vs
vytaka	taka
vytakr	kr
vytal	val
vytfyld	veld
vytkamb	kamb
vytkvs	vs
vytmr	mr
vytmvr	r
vytnbrg	g
vytn	n
vytn	n
vytsh	vish
vytsvn	n
vyt	t
vytvl	l
vytvr	r
vytvrya	rya
vytv	v
vyt	t
vyt	t
vyt	t
vytykr	kr
vytyk	k
vytyngtvn	tyng
vytz	v
vyva	va
vy	ivy
vyvks	ks
vyvk	k
vyvla	la
vyvr	r
vyvvr	r
vyvyanh	h
vyvyan	van
vyvyk	k
vy	ivy
vy	ivy
vy	ivy
vyyrs	rs
vyzbrand	brand
vyznand	anand
vyznry	fry
vyzn	zn
vyzrnr	zr
vyzvn	n
vzda	dada
vzyna	dyna
xaldah	albahah
xalydh	h
xan	xian
xay	day
xlyda	ayda
xlydh	h
xlylh	lyly
xrdl	l
yagla	yagla
yagr	yager
yakvb	yake
yakvlty	y
yakvtah	yakootah
yakvta	yalta
yamaha	yamaha
yamaha	yamaha
yamha	yamha
yamn	yan
yamynah	yaminah
yamyna	yamha
yangr	yang
yang	yang
yangy	yang
yansvn	yan
yanvvytz	yan
yan	yan
yanyv	yan
yanzk	yank
yap	yap
yargr	yasar
yarla	carla
yarman	yarman
yarvn	yaryan
yarvs	yaros
yaryan	yaryan
yasar	yasar
yasr	yasar
yasyn	yan
yasyrah	yasirah
yasyrh	rh
yasy	y
yats	ats
yav	av
yayn	ayn
ykvtah	ptah
ylnd	nd
ylyc	lyly
ylyf	lyly
ymha	yamha
ymn	lymn
ymynh	h
'yn	ayn
yrbry	y
yrmys	ys
ysra	ra
ysryh	ys
ysyrah	grah
ysyra	byra
ysyrh	rh
ytr	r
yvbyra	byra
yvfyngtvn	ayn
yvhans	anshans
yvkylv	v
yvk	k
yvlyn	lyn
yvmans	mans
yvmn	mn
yvmvra	ra
yvnal	al
yvnas	nas
yvngsap	yap
yvn	n
yvnsvn	n
yvn	n
yvnyza	zaza
yvranym	avram
yvrbanyk	bank
yvrk	york
yvrmv	v
yvryna	dyna
yvsf	f
yvstn	n
yvs	vs
yvsyv	v
yvsy	y
yvsy	y
yvzf	f
yvzr	zr
yyka	yeka
yyk	k
yytz	y
yytz	y
yzak	yzaak
yzk	k
yzyd	d
zabl	zabel
zabz	z
zacary	zachary
zafyna	zafina
zagar	zagar
zahd	zahid
zahyd	zahid
zakvb	zaki
zakvb	zaki
zakvmyntay	tay
zakyvs	vs
zak	zaki
zaky	laky
zalan	zalan
zamvr	zaza
zamyt	zammit
zangrl	zangerl
zan	zalan
zankh	zach
zanky	zand
zank	bank
zans	anshans
zant	anant
zapara	zapara
zara	zara
zarrytn	zara
zarvs	zaras
zarya	arya
zaryh	zach
zarytn	zara
zarytzn	zn
zatrvvd	zand
zaynah	zaynah
zayna	zaynah
zayra	zara
zayr	dayr
zaza	zaza
zfry	fry
zfyna	dyna
zfynh	h
zhra	zahra
zhra	zahra
zhra	zahra
zhyd	d
zhyrah	zahirah
zhyra	byra
zhyrh	rh
zjarytjn	zjarritjen
zjarytn	zn
zkh	h
zkyah	ayah
zkyh	h
zky	sky
zk	k
zk	k
zla	la
zlr	lr
zltj	j
zlykah	h
zlyxa	a
zmank	bank
zman	man
zmyran	bran
zmyt	t
zng	zang
znk	zn
zntnr	zn
znykh	zn
zn	zn
zpka	zepka
zra	ezra
zrya	rya
zryfa	zr
zryf	zr
zryh	zr
zrynk	zr
zry	zr
zvhans	anshans
zvhansn	anshan
zvka	a
zvld	zold
zvl	l
zvlmr	mr
zvly	lyly
zvlyka	a
zvntk	k
zvrynk	k
zvrysyka	a
zvtrvd	d
zvtrvvd	d
zvvayta	ta
zvvyta	ta
zvyta	ta
zvytrvvd	d
zvzf	f
zygmvnt	zygmunt
zylt	zyl
zyl	zyl
zymran	amran
zynah	nahnah
zyna	dyna
zynb	nb
zynh	h
zynsr	sr
zyra	byra
zyryly	lyly
zyr	zr
zytv	v
zyvrynk	k
zyvtrvd	d
zyzy	y
zza	zaza
zz	z
