AACTAY	actaeon
AALTJ	aaltje
AAMYNA	aamina
AARVN	aaron
ABA	aabar
ABAD	abad
ABADA	abad
ABADHBY	abad
ABAJA	carbajal
ABAR	aabar
ABCR	abcher
ABDJA	abidjan
ABDLRHMAN	abdalrahman
ABDVN	abdalmalik
ABH	abhay
ABHAY	abhay
ABHY	abhay
ABLA	ablation
ABL	ablation
ABL	ablation
ABLH	ablation
ABLHYD	ablation
ABLJ	ablation
ABLT	abeltje
ABLTJ	abeltje
ABLY	ablation
ABLYSN	blystone
ABND	abend
ABNR	abner
'ABR	abraham
ABR	abraham
ABRAHAM	abraham
ABRAHYM	abraham
ABRAHYM	abraham
ABRAM	abram
ABRAMSVN	abrams
ABRAPT	abraham
ABRAYT	abraham
ABRBAC	eberbach
ABRG	aberg
ABRG	aberg
ABRKRVMBY	abercrombie
ABRL	abraham
ABRLY	abraham
ABRMSKY	abrams
ABRT	abraham
ABRT	abraham
ABRVTR	abraham
ABRY	abery
ABRY	abery
ABRYN	bryn
ABRYNY	bryn
ABSTGARTN	obstgarten
ABST	abstract
ABSTRKT	abstract
ABT	abtine
ABTYN	abtine
ABV	aabar
ABVBA	abbas
ABVDBY	kidby
ABVDHABY	abudhabi
ABVHBYB	byblos
ABVLYN	allyn
ABVRYMH	abery
ABVT	aabar
ABVT	aabar
ABVTSMYT	smythe
ABYA	abyan
ABYAB	abyan
ABY	abyan
ABY	abyan
ABYAD	abyan
ABYAN	abyan
ABYD	abyan
ABY	abyan
ABYL	babylon
ABYLAK	babylon
ABYNA	abyan
ABYNGM	abyan
ABYNGN	abyan
ACDL	macdonald
AC	aachen
ACR	acropolis
ACRNAR	achernar
ACTY	abstract
ACTYH	abstract
ACY	confederacy
ACYLS	beryls
ACYSVN	confederacys
ACYT	confederacy
ADAB	adab
ADAM	adam
ADAMV	adam
ADANA	adana
ADAN	adan
ADANL	adan
ADARA	adar
ADB	bradbury
ADBRG	bradbury
ADGRYNGLND	adgeringelant
ADGRYNGLNT	adgeringelant
ADGYNGTVN	edgington
ADH	adhara
ADKAK	nadkarni
ADKK	adkins
ADKRYK	adkins
ADKVK	adkins
ADKYNZ	adkins
ADKYRK	adkins
ADLA	badlands
'ADL	adler
ADL	adler
ADLARDV	adelardo
ADLAYD	badlands
ADLAYD	badlands
ADLHYD	adelheid
ADLMA	adalma
ADL	adler
ADLR	adler
ADLSVN	adelson
ADLY	bradly
ADMVND	admiral
ADMVNDS	edmonds
ADMVNDZ	admiral
ADMVNZ	admiral
ADMYRALN	admiral
ADMYRALZ	admiral
ADMYSTVN	myst
ADNAMS	adnams
ADNAMZ	adnams
ADNBRAG	bragdon
ADNBRG	radenburgerabroek
ADNBRV	adnams
ADNBRVG	adnams
ADNBVRG	radenburgerabroek
ADRY	badry
ADRY	badry
ADRYANA	adriana
ADRYAN	adrian
ADRYANS	aryans
ADRYN	badry
ADRYNKLNT	badry
ADRYNS	badry
ADRYNY	badry
ADRYNY	badry
ADRYS	badry
ADSAL	edsall
ADST	bradstreet
ADSVN	adsett
ADT	amstadt
ADVARD	edvard
ADVARD	edvard
ADVARDSN	edvard
ADVART	edvard
ADVLF	adolf
ADVLFSVN	adolfs
ADVLF	adolf
ADVNCR	advent
ADVNL	advent
ADVNYS	advent
ADVSVMALY	adusumalli
ADVVART	havarti
ADY	brady
ADY	brady
ADY	brady
ADY	brady
ADY	brady
ADYH	brady
ADYK	brady
ADYKS	brady
'ADYL	brady
ADYL	brady
ADYLRD	adelardo
ADYNA	dyna
ADYNGTVN	addington
ADYNGTVN	addington
ADYS	gladys
ADYSAK	adisak
ADYSVN	gladys
ADYT	brady
AFA	afa
AFAF	afaf
AFRA	afra
AFRDYT	afra
AFRVDYT	afra
AFTAB	aftab
AFV	afa
AFVRYL	beryl
AFYCART	cartaxo
AFYF	afa
AFYGTN	addington
AFYNGTN	addington
AFYS	buffys
AFYSR	buffys
AFYVN	afa
AFZAL	afzal
AFZL	afzal
AGALY	agali
AGAS	agass
AGATY	agate
AGBRN	brno
AGBVRN	cogburn
AG	aconcagua
AGLSTVN	eaglestone
AGMN	aconcagua
AGMVZ	aconcagua
AGNDY	agndie
AGNV	ragnvald
AGNVYK	ragnvald
AGPYAN	abyan
AGR	agra
AGRAVALA	agrawala
AGRN	agra
AGRTN	agra
AGRTVN	agra
AGRYNGLANT	adgeringelant
AGRYNGLND	england
AGVLV	aconcagua
AGVR	aconcagua
AGVSTV	agostinelli
AGVSTYN	augustyn
AGVSTYNLY	augustyn
AGVSTYNY	augustyn
AGVYRV	aconcagua
AGVYV	aconcagua
AGYLA	aglaia
AGYL	argyle
AGYLSVN	argyle
AGYNST	against
AHAY	mahayana
AHLAND	highland
AHMAN	abdalrahman
AHMN	abdalrahman
AHRN	ahern
AHY	leahy
AHYH	leahy
AJ	ajax
AJAST	ojaste
AJAY	ajay
AJDA	majdal
AJLVS	ajlun
AJNT	kristijntje
AJRAYNGLND	england
AJYNGTVN	addington
AJYNTVN	chrescyntie
AKA	aka
AK	adisak
AKADMY	akademik
AKADMYK	akademik
AKAKS	kanakakorn
AKAPADY	accapadi
AKBRG	akbar
AKBVRN	akbar
AKDAG	akdag
AK	adisak
AKGAN	aganovic
AKL	akl
AKLAND	oakland
AKLND	oakland
AKLVF	akl
AKLY	akl
AKLY	akl
AKM	akman
AKMAN	akman
AKMANDNSYS	akman
AKMANDSYS	akman
AKMAN	akman
AKMNA	akman
AKMN	akman
AKMR	akman
AKMVNDNSYS	ekmundensis
AKMY	akman
AKN	preakness
AK	adisak
AKR	akrill
AKRM	akrill
AKRMAN	ackerman
AKRMN	akrill
AKRSAND	eckersand
AKRSLATV	ekerslato
AKRSLYTV	akers
AKRSTV	akers
AKRT	akrill
AKRVYD	ackroyd
AKRYL	conakry
AKS	aksu
AKSAYL	aksu
AKSDLM	aksu
AKSFRD	aksu
AKSFVRD	aksu
AKSFVRD	aksu
AKSKRYTYA	aksu
AKSLSVN	aksu
AKSLY	aksu
AKSS	adirondackss
AKSTRND	ekstrand
AKSTYN	augustyn
AKSV	aksu
AKSYL	aksu
AKTS	praktikum
AKTVN	praktikum
AKTVN	praktikum
AKTY	praktikum
AKTYV	praktikum
AKVAL	huckvale
AKVAYLA	bayla
AKVAYL	akiva
AKVDV	adisak
AKVKS	addicks
AKVNA	pakenas
AKVNR	adisak
AKVSTA	kazakhstan
AKY	kitakyushu
AKY	kitakyushu
AKYF	kitakyushu
AKYHYKV	kitakyushu
AKYLA	skylab
AKYLA	skylab
AKYLAH	akilah
AKYL	jekyll
AKYL	jekyll
AKYLH	jekyll
AKYLS	beryls
AKYM	kitakyushu
AKYN	kitakyushu
AKYTVMV	kitakyushu
AL'ADYN	aladdin
ALAHAYDYKYA	calahan
ALAHDVD	calahan
ALALDYN	alaaldin
AL	aali
ALAM	alamo
ALAMZ	alamo
ALANA	alana
ALANGKV	alan
ALAPATY	alapati
ALAQBH	alaqabah
ALARD	pappalardo
ALASR	alaska
ALASVRS	alaska
ALAVAY	blavatnik
ALAVY	galbavy
ALAYN	balaye
ALAYSDYR	malays
ALAYS	malays
ALBAHAH	albahah
ALBHA	albahah
ALBHAH	albahah
ALBLJH	alba
ALBR	albright
ALBRAYT	galbraith
ALBRT	albert
ALBRTYNY	albert
ALBRY	albright
ALBRYJ	albright
ALBVN	alba
ALBVZ	alba
ALBYNGR	albinger
ALDHAYD	aldhafra
ALDLHLD	aguinaldo
ALDN	aguinaldo
ALDN	aguinaldo
ALD	aguinaldo
ALDR	aldrich
ALDRD	aldrich
ALDRYC	aldrich
ALDRYDJ	aldrich
ALDRYG	aldrich
ALDRYG	aldrich
ALDRYJ	aldrich
ALDRYJ	aldrich
ALDRYJ	aldrich
ALDRYJH	aldrich
ALDYN	aguinaldo
ALDZ	aguinaldo
ALFA	alfaro
ALF	alf
ALFANSV	balfanz
ALFARV	alfaro
ALF	alf
ALFRD	alford
ALFRDV	alford
ALFRS	alfors
ALFRYNG	alfred
ALFVRD	alford
ALFVRD	alford
ALGADV	alegado
ALGARD	calgary
ALGAYN	algae
ALGRV	walgreen
ALGSAN	alagesan
ALGY	algae
ALGYNGTVN	addington
ALHDAD	baghdad
ALHDVD	alhambra
ALJ	aali
ALJH	aali
ALKAN	balkan
ALKBAH	albahah
ALKBR	albright
ALKBYR	valkyrie
ALKK	alkabeer
ALKMR	walkman
ALKMRH	walkman
ALKMRY	walkman
ALKR	alkabeer
ALKRTN	alkerton
ALKRTVN	alkerton
ALKS	alkabeer
ALKSANDR	alesandro
ALKSANDRVZ	alesandro
ALKSNDR	alesandro
ALKSY	alkabeer
ALKSYV	alkabeer
ALKVAB	alkabeer
ALKVK	alkabeer
ALKVR	alkabeer
ALKYNGTN	elkington
ALKYNGTVN	elkington
ALKYNTN	valkyrie
ALLADHKYAH	alladhiqiyah
ALLADHYKYAH	alladhiqiyah
ALLAHYGYAH	allah
ALLDHYKYAH	alladhiqiyah
ALLDYKYAH	allden
ALLHYQYH	adusumalli
ALM	abdalmalik
ALMAR	walmart
ALMAS	almas
ALMATVN	almaty
ALMGRN	almgren
ALMKVAST	almqvist
ALMKVYST	almqvist
ALMN	abdalmalik
ALMNTAJ	almintaqah
ALMR	abdalmalik
ALMRS	palmerston
ALMRVT	abdalmalik
ALMVD	abdalmalik
ALMVDYVAR	almudevar
ALMV	abdalmalik
ALMVMAN	elmoman
ALMVR	abdalmalik
ALMYNAKAH	almintaqah
ALMYNTAGAH	almintaqah
ALMYNTAKAH	almintaqah
ALMYNTAKVA	almintaqah
ALMYNTKH	almintaqah
ALMYRAL	palmyra
ALN	alnilam
ALN	alnilam
ALND	alnilam
ALNDR	balendra
ALN	alnilam
ALNVR	alnilam
ALNY	alnilam
ALPN	alpen
ALPRT	alpert
ALPVRT	alpert
AL'QBH	aali
ALRBK	abdalrahman
ALRD	abdalrahman
ALRTN	abdalrahman
ALRTVN	abdalrahman
ALRVY	abdalrahman
ALRY	dalrymple
ALRYGH	dalrymple
ALRYJ	dalrymple
ALSANDRY	alesandro
ALSAN	alesandro
ALSAN	alesandro
ALSAP	alsace
ALSAP	alsace
ALSAP	alsace
ALSNDRV	alesandro
ALSN	admirals
ALSN	admirals
ALSNR	admirals
ALSP	admirals
ALSP	admirals
ALSPD	admirals
ALSR	admirals
ALSTRVM	ahlstrom
ALSVN	admirals
ALSVN	admirals
ALSVN	admirals
ALSVP	admirals
ALSVP	admirals
ALSVRS	admirals
ALSVRT	admirals
ALSVZ	admirals
ALSY	calsyn
ALT	aaltje
ALTANYN	albany
ALT	aaltje
ALTAYR	alta
ALTMAN	altman
ALTMN	altman
ALTMN	altman
ALTRVAYD	aaltruide
ALTRVD	aaltruide
ALTRVYD	aaltruide
ALTRVYYD	aaltruide
ALTSVN	walts
ALTV	aaltje
ALTYR	aaltje
ALTZ	baltzell
ALVA	alva
ALVAN	galvan
ALVARV	alvarado
ALVARVS	alvarado
ALVARZ	alvarado
ALVAY	alva
ALVF	alva
ALVKAL	alukal
ALVK	alva
ALVLD	allden
ALVRS	alars
ALVSA	alesandro
ALVVD	alva
ALVVD	alva
ALVY	alva
ALVY	alva
ALVYN	allyn
ALVYN	allyn
ALVYN	allyn
ALVYN	allyn
ALVYN	allyn
ALVYS	ogilvys
ALVZ	alva
ALXZNA	alkhazna
'ALYA	alya
ALYA	alya
'ALY	alya
A'LY	alelyunas
ALY	alya
ALYA	alya
ALYA	alya
A'LYAH	aaliyah
ALYAH	aaliyah
ALY	alya
ALY	alya
ALY	alya
ALYAN	kalyan
ALYAS	alya
ALYASVN	alya
ALYBY	alya
ALY	alya
ALY	alya
ALYFAS	alfaro
'ALYH	alya
ALYJ	alya
ALYKS	alya
ALYLYVNAS	alelyunas
ALYMA	hollyman
AL'YN	allyn
ALYN	rosalyn
ALYN	rosalyn
ALYN	rosalyn
ALYN	rosalyn
ALYNGR	rosalyn
ALYNGTVN	alington
ALYNGTVN	alington
ALYN	rosalyn
ALYNYK	rosalyn
ALY	alya
ALYSA	alyson
ALYS	alyson
ALYS	alyson
ALYS	alyson
ALYSN	alyson
ALYSTVN	bialystok
ALYSTYR	bialystok
ALYSVN	alyson
ALYSVN	alyson
ALYSVN	alyson
ALYSVN	alyson
ALYSYA	alyson
ALYVA	alva
ALYVRYA	alya
ALYVT	alya
ALYVT	alya
ALYVY	alya
ALYYA	aliyyah
ALYZA	allyz
ALYZABT	abtine
ALYZ	allyz
ALYZR	allyz
ALZ	alzena
ALZNA	alzena
ALZN	alzena
ALZVRS	alzena
AMA	aissama
AMADVR	amadeus
AMAGYV	gamage
A'MAL	abdalmalik
AMAL	amal
AMAND	amand
AMANVAL	panvalkar
AMANV	alabaman
AMANVL	alabaman
AMANVYL	alabaman
AMANY	alabaman
AMANYVL	alabaman
AMARA	amara
AMARAL	amaral
AMARDYV	amardeo
AMARNT	amarnath
AMARYT	marytje
AMBAR	turambar
AMBASY	cochabamba
AMBLR	ambler
AMBRLY	alhambra
AMBRLY	alhambra
AMBRLYNG	alhambra
AMBRVSS	alhambra
AMBRVSVS	alhambra
AMBRVSYV	alhambra
AMBRVSYVS	alhambra
AMBVS	alhambra
AMBYJ	alhambra
AMDYV	hamdan
AMFN	camfield
AMLAK	amlak
AML	amlak
AMLK	amlak
AMLN	amlak
AMLYA	alya
AMNA	amna
AMN	amna
AMNVN	amna
AMPN	amparo
AMPRVR	amparo
AMPSVN	hampshire
AMPT	ampte
AMPTH	ampte
AMPY	amparo
AMRALD	amaral
AMR	amran
AMRJYNG	amran
AMRMAN	amerman
AMRVSYV	amran
AMRY	camry
AMRY	camry
AMRY	camry
AMRYKA	camry
AMRYKN	camry
AMRYKN	camry
AMRYTA	amritansh
AMS	abrahams
AMSTAT	amstadt
AMSTD	amstadt
AMSTR	amstadt
AMSY	abrahams
AMT	amtrak
AMTYSTA	amethysta
AMVNA	aamina
AMVNDSYZ	amundsen
AMVRVSV	aamina
AMVRY	amery
AMVS	aamina
AMY	amy
AMY	amy
AMYH	amy
AMYHAY	abhay
AMYKVS	lamykin
AMYLY	amy
AMYLY	amy
AMYLYYV	amy
AMYNA	aamina
AMYNA	aamina
AMYNH	amenhotep
AMYRA	myra
AMYR	amy
AMYR	amy
AMYT	amy
AMYTAVA	amitava
AMYT	amy
AMYT	amy
AMYVT	amy
AMYVT	amy
AMYZVTA	amy
ANAGRAM	anagram
ANAKYN	anakin
ANALVG	analects
ANANDA	ananda
ANAND	anand
AN	abdalrahman
ANANSA	buchanans
ANANT	anant
ANAS	adrianas
ANASTASYA	anastasia
ANATVLY	anatoly
ANATY	anathea
ANAY	anay
ANAYLYN	anay
ANAYZA	anay
ANAZ	adana
ANAZA	nazahah
ANBAR	anbar
ANBR	anbar
ANBV	anbar
ANCY	clancy
ANDAMZ	andaman
AND	alejandra
AND	alejandra
ANDNS	brandens
ANDRA	alejandra
ANDR	alejandra
ANDR	alejandra
ANDRBRG	anderberg
ANDRBVRG	anderberg
ANDRBY	alejandra
ANDR	alejandra
ANDR	alejandra
ANDRR	alejandra
ANDRS	alejandra
ANDRS	alejandra
ANDRSN	alejandra
ANDRSN	alejandra
ANDRSVN	alejandra
ANDRVS	alejandra
ANDRVZ	alejandra
ANDRYA	landry
ANDRY	landry
ANDRY	landry
ANDRYAS	alejandras
ANDRYS	landrys
ANDRYS	landrys
ANDRYS	landrys
ANDRYSN	landrys
ANDRYSN	landrys
ANDRYVZ	landry
ANDRYYA	landry
ANDRYZ	landry
ANDSVRS	armands
ANDSVRT	armands
ANDSVVRT	armands
ANDVLSN	andolsen
ANDYSL	andys
ANDYYVRANS	aldebarans
ANFANT	enfant
ANFYLD	blumenfeld
ANGBRTSN	bongarts
ANGH	anghe
ANGLAND	langland
ANGLANDR	langland
ANGLASMA	angelas
ANGLHARD	engelhardt
ANGLHLM	angle
ANGLHVRN	angle
ANGLND	langland
ANGLS	angels
ANGLS	angels
ANGLSMA	engelsma
ANGLSVN	angels
ANGLTH	angle
ANGLTJ	angle
ANGLTJH	angle
ANGLYNA	angelina
ANGLYS	angle
ANGLZ	angle
ANGRSVL	jahangirs
ANGVLV	angara
ANH	anhold
ANHLD	anhold
ANJBRTSVN	alemberts
ANJL	banjarmasin
ANJLJY	banjarmasin
ANJLS	banjarmasin
ANJLT	banjarmasin
ANJLTJA	aaltje
ANJLV	banjarmasin
ANJLYNA	alelyunas
ANJLYS	allyson
ANJLYSYA	allyson
ANJY	banjarmasin
ANJYLYNY	marylynn
ANKNY	ankara
ANKR	ankara
ANKRLY	ankara
ANKSTAD	afghanistan
ANKVRN	anckorn
ANPYNGKV	angkor
ANQ	barranquilla
ANQH	barranquilla
ANRAH	abdalrahman
ANR	granroth
ANRYK	freemasonry
ANRYKV	freemasonry
ANRYKYV	freemasonry
ANRYKYYVZ	freemasonry
ANSAR	arkansan
ANSKAMB	cybanski
ANSL	ansley
ANSLM	anselm
ANSLMV	anselm
ANSLY	ansley
ANSLYN	ansley
ANSPAC	anspach
ANSR	abidjans
ANSTYTV	blanstan
ANSY	pansy
ANSY	pansy
ANSYH	pansy
ANSYKR	pansy
ANTAL	antal
ANTANAYTYS	antanaitis
ANTARAMYAN	antaramian
ANT	adgeringelant
ANTH	anantha
ANTNA	antanaitis
ANTRAPY	antaramian
ANTRV	antrosio
ANTRVSYV	antevs
ANTRYKYN	gantry
ANTSTL	anthistle
ANTSYTL	brants
ANTVN	adgeringelant
ANTVN	adgeringelant
ANTVN	adgeringelant
ANTVNVGLV	antonoglou
ANTVNVVYC	adgeringelant
ANTVNY	antony
ANTVNY	antony
ANTVNY	antony
ANTVNYS	antonys
ANTVNYS	antonys
ANTVNYV	antony
ANTVNYVS	antony
ANTVS	antevs
ANTY	blantyre
ANTYLA	antila
ANTYPDS	blantyre
ANTYSTL	anthistle
ANTYSTLH	anthistle
ANV	anvers
ANV	anvers
ANVAR	invar
ANVCYN	francyntie
ANV	anvers
ANV	anvers
ANVJYT	anvers
ANVKVL	anvers
ANVN	anvers
ANVPAM	anupam
ANVP	anvers
ANVR	vanvranken
ANVR	vanvranken
ANVR	vanvranken
ANVRS	anvers
ANVS	anvers
ANVS	anvers
ANVTYYADYS	gladys
ANVVY	anvers
ANYART	enyart
ANYJMA	albany
ANYL	albany
ANYL	albany
ANYL	albany
ANYMA	ganymede
ANYNG	albany
ANYSA	albanys
ANYS	albanys
ANYSH	albanys
ANYSTYN	albanys
ANYVRSRY	albany
ANYVS	albany
ANYYV	albany
ANZALVNY	anzalone
ANZLVAR	anzlovar
ANZYNGR	americanizing
APCRC	apocrypha
AP	acapulco
APL	apletree
APL	apletree
APLBAY	alba
APLBRG	albright
APLBY	apletree
APLBY	apletree
APLMN	apletree
APLNDS	laplands
APLYBY	apletree
APLYBY	apletree
APLYN	allyn
APNDYS	andys
APRAYT	capra
APRLY	apr
APRSVN	aprs
APRYL	apr
APSTN	capstick
APSTVN	capstick
APSTYN	augustyn
APSYLVN	pennsylvania
APVNTH	anantha
APVRVA	apoorva
APYDAL	abdalmalik
APYSTYN	augustyn
AQBAL	iqbal
ARAM	antaramian
ARAND	maranda
ARAN	aldebaran
ARARKH	ararat
ARAS	adharas
ARAS	adharas
ARASMVS	adharas
ARAY	karayel
ARAYZ	karayel
ARBANAS	arbanas
ARBR	barbra
ARBVR	arbanas
ARBYD	darby
ARBY	darby
ARBYL	darby
ARBY	darby
ARCAL	arcadia
ARCALH	arcadia
ARC	antarctic
ARCARD	arcadia
ARCDALY	archdale
ARCDL	antarctic
ARCDYL	antarctic
ARCR	barcroft
ARCYBALD	archibald
ARDALYC	ardalich
ARDMN	beardmore
ARDN	bringardner
ARDRZ	abelard
ARDYS	lombardys
AR	aabar
ARFANAKYS	orfanakis
ARFVRD	barford
ARFYVS	barff
ARGAN	gargantua
ARGAN	gargantua
ARGAR	margaret
ARHARD	carhart
ARKARD	arkansan
ARKDYL	ark
ARKTYKY	arktiki
ARLAYJ	barclay
ARL	arlene
ARL	arlene
ARL	arlene
ARLT	carlton
ARLY	baggarly
ARLYJ	baggarly
ARLYNDH	charlyn
ARLYNG	charlyn
ARMAND	armand
ARM	arm
ARMASTRANG	armstrong
ARMATV	armato
ARMNY	arm
ARMRY	arm
ARMSRVNG	armstrong
ARMSTRANG	armstrong
ARMVNTRVT	armontrout
ARMVR	arm
ARMYN	arm
ARMYTAJ	armitage
ARMYT	arm
ARMYTAZ	armitage
ARN	amarnath
ARNAT	amarnath
ARND	spaarndam
ARNDT	arendt
ARNFYLD	arnfield
ARNH	arnhem
ARNLD	arnold
ARNST	quarnstrom
ARNT	amarnath
ARNT	amarnath
ARNT	amarnath
ARNTS	barents
ARNVLD	arnold
ARNVT	amarnath
ARNVT	amarnath
ARP	arpin
ARPYN	arpin
ARS	adars
ARSKAT	carskadon
ARSKAYN	carskadon
ARSNALT	arsenault
ARSY	adars
ARSYD	adars
ARSYKR	adars
ARTL	bartle
ARTR	chartres
ARTRS	carters
ARTRZ	chartres
ARTVT	aphichart
ARTYS	martys
ARTYZ	hegarty
ARVAL	carvallo
ARVMA	aramaic
ARVN	arvesen
ARVNACALAM	arunachalam
ARVNAH	arunah
ARVND	arend
ARVNN	arvesen
ARVRKH	arkhangelsk
ARVSN	arvesen
ARVYNG	arvesen
ARVYVLA	arvesen
ARYA	arya
ARYA	arya
ARY	anniversary
ARYC	anniversary
ARYFA	anniversary
ARYJ	anniversary
ARYKA	masaryk
ARYKA	masaryk
ARYK	masaryk
ARYK	masaryk
ARYKSN	masaryk
ARYKSVN	masaryk
ARYKSVN	masaryk
ARYKSVN	masaryk
ARYN	catharyn
ARYNGTN	catharyn
ARYS	barbarys
ARYS	barbarys
ARYS	barbarys
ARYSTVTL	aristotle
ARYZ	anniversary
ARYZ	anniversary
ARZAT	arzate
ARZ	arzate
ASAKVL	hasakah
ASBL	asbell
ASBRN	asbrink
ASBRYNK	asbrink
ASBVRN	asbell
ASCAFYLD	athabasca
ASCAGN	mascagni
ASCRVVYC	ascella
ASCVFYLD	ascella
ASCVYLAR	duchaylard
ASCYPLVDN	ascella
ASCYPLVYDN	ascella
ASCYPN	ascella
ASDS	tasdeler
ASFAR	alfaro
ASFYLD	rumsfeld
ASGVRYAN	aryan
ASKADZ	alaska
ASKAGN	alaska
ASKAHAN	skahan
ASKAJN	alaska
ASKALANT	atalanta
ASKAL	alaska
ASKALYK	alaska
ASKALY	alaska
ASKANL	alaskan
ASKANYL	alaskan
ASKARP	baskar
ASKARS	baskar
ASKARTSYS	skartsis
ASKARY	baskar
ASK	alaska
ASKATV	saskatchewan
ASKATYA	saskatchewan
ASKATY	saskatchewan
ASKAVN	alaska
ASKAYA	kamskaya
ASKAYLR	alaska
ASKAY	alaska
ASKAYT	alaska
ASKLDSVN	eskeldson
ASKLTN	alaska
ASKLTVN	alaska
ASKLVYR	alaska
ASKNL	alaska
ASKNS	alaskans
ASKP	alaska
ASKRAB	krab
ASKRANTVN	alaskan
ASKRAYZ	airay
ASKRNTN	alaska
ASKRNTVN	alaska
ASKRVYC	baskerville
ASKRYBLYNG	marylynn
ASKRYBNR	alaska
ASKRYC	alaska
ASKRY	alaska
ASKRYS	conakrys
ASKRYV	alaska
ASKVAYRL	alaska
ASKVAYR	alaska
ASKVFYLD	alaska
ASKVGAN	aganovic
ASKVLY	alaska
ASKVLYNG	alaska
ASKVLYN	alaska
ASKVLY	alaska
ASKVLYZ	alaska
ASKV	alaska
ASKVRR	alaska
ASKV	alaska
ASKVTVNY	alaska
ASKVYLR	alaska
ASKVYVYL	alaska
ASKYBA	ladasky
ASKYLS	ladasky
ASKYNR	ladasky
ASKYN	ladasky
ASKYN	ladasky
ASKYPLADN	ladasky
ASKYPLVYDN	ladasky
ASKYPN	ladasky
ASKYP	ladasky
ASKYPY	ladasky
ASKYRS	ladasky
ASKY	ladasky
ASKYTR	ladasky
ASLANKARD	slankard
ASLAN	ameslan
ASLAN	ameslan
ASLAN	ameslan
ASLATKYN	slatkin
ASLATKYN	slatkin
ASLATR	bellatrix
ASLATRY	bellatrix
ASLATVBR	ekerslato
ASLAVK	saslav
ASLAVMYZ	saslav
ASLAVNBRG	slavenburg
ASLAVYN	saslav
ASLAYK	saslav
ASLBVTNN	basle
ASLD	basle
ASLMN	basle
ASLNGZVALD	osvaldo
ASLP	basle
ASLR	basle
ASLS	basels
ASLSYNG	calsyn
ASLTN	basle
ASLTR	aaltruide
ASLVAN	galvan
ASLVKAM	basle
ASLVKA	basle
ASLVMN	basle
ASLVN	basle
ASLVN	basle
ASLVP	basle
ASLY	basle
ASLYGRZ	basle
ASLYMAN	hollyman
ASLYNY	roslyn
ASLYPR	basle
ASLYP	basle
ASLYTY	basle
ASLYVPAS	agrippas
ASLYV	basle
ASMA	asma
ASMADJ	smadja
ASMAL	kasmalkar
ASMALY	kasmalkar
ASMART	asmara
ASMAYT	asma
ASMDLY	asma
ASMLN	asma
ASMVKY	asma
ASMVLYK	asma
ASMVLYN	allyn
ASMVR	asma
ASMVT	asma
ASMYD	asma
ASMYKLA	smikla
ASMYL	smyley
ASMYLY	smyley
ASMYRNV	myrna
ASMYT	smythe
ASMYTSVN	smythe
ASMYTVYK	smythe
ASMYTZ	smythe
ASMYTZ	smythe
ASNAG	hasna
ASNAYDR	hasna
ASNDN	casandra
ASNL	casner
ASNL	casner
ASNLYNG	allyn
ASNR	casner
ASNVDN	casner
ASNVFYLD	casner
ASNVGRS	anvers
ASNV	casner
ASNYD	snyder
ASNYL	casner
ASNYSL	albanys
ASPANGLR	spangler
ASPARDAM	camelopardalis
ASPARKS	sparks
ASPARNDAM	spaarndam
ASPAR	caspar
ASPARV	caspar
ASPARZA	esparza
ASPATAFVRA	spatafora
ASPAT	caspar
ASPATSVVD	caspar
ASPATZ	spatz
ASPAVLDYNG	spaulding
ASPAYDR	caspar
ASPAYDRZ	caspar
ASPAYK	caspar
ASPAYKS	caspar
ASPAYNYNG	caspar
ASPAYRZ	caspar
ASPAYZ	caspar
ASPLMN	aspell
ASPLYD	aspell
ASPLYNTR	splinter
ASPNSR	aspens
ASPNS	aspens
ASPRAG	sprag
ASPR	kasprzak
ASPRVT	kasprzak
ASPRYBRY	kasprzak
ASPRY	kasprzak
ASPVLARYC	hilary
ASPVLARYX	hilary
ASPVR	aspell
ASPVRY	aspell
ASPVSTA	lovstad
ASPVSYTV	aspell
ASPVTYS	almatys
ASPYDN	aspell
ASPYLMN	aspell
ASPYNAK	spinak
ASPYNDRYFT	spindrift
ASPYN	aspell
ASPYRAS	diasporas
ASPYR	aspell
ASPYR	aspell
ASPYRV	aspell
ASPYRV	aspell
ASPYRYNG	aspell
ASPYRZ	kasprzak
ASPYRZ	kasprzak
ASPYSAK	spisak
ASPYSYK	aspell
ASPYT	aspell
ASPYTZR	aspell
ASPYVAK	spivak
ASPZYTV	aspell
ASRAT	basra
ASRAYYL	basra
ASRMN	basra
ASTABRT	astarte
ASTABZ	rastaban
ASTAD	amstadt
ASTAD	amstadt
ASTAFL	rastafarian
ASTAFVRD	rastafarian
ASTAG	anastacia
ASTAJANV	stajano
ASTAKMN	anastacia
ASTAKR	anastacia
ASTAKSLAJR	alnitaks
ASTAKS	alnitaks
ASTAKY	anastacia
ASTAKY	anastacia
ASTALKH	masalkhi
ASTAMPR	stamper
ASTAM	anastacia
ASTANGYR	astana
ASTANVL	astana
ASTAPLYC	staples
ASTARBAK	astarte
ASTARGS	astarte
ASTARGYL	argyle
ASTARK	astarte
ASTARKYP	astarte
ASTARKY	astarte
ASTAR	astarte
ASTAR	astarte
ASTARTLD	astarte
ASTART	astarte
ASTARTZ	astarte
ASTARYNGR	astarte
ASTARZ	astarte
ASTAS	anastasia
ASTATM	aisenstat
ASTATRZ	aisenstat
ASTATZMN	aisenstat
ASTAYLZ	anastacia
ASTAYNLS	anastacia
ASTAYNMN	anastacia
ASTAYN	anastacia
ASTAYR	anastacia
ASTBAY	austbanen
ASTCNYK	anastacia
ASTDLR	anastacia
ASTDMN	anastacia
ASTDYNA	dyna
ASTFANS	sebastians
ASTFAN	astana
ASTFAN	astana
ASTFANVS	astana
ASTFANV	astana
ASTFANZ	astana
ASTFN	anastacia
ASTFNSVN	afghanistans
ASTGN	anastacia
ASTK	anastacia
ASTLR	astley
ASTLY	astley
ASTLYK	astley
ASTLY	astley
ASTNFRD	castner
ASTNFVRD	castner
ASTNFVRT	castner
ASTNKAMB	castner
ASTNSL	castner
ASTNSRAD	castner
ASTN	castner
ASTNTJY	castner
ASTPKN	anastacia
ASTPK	anastacia
ASTRABRYJ	astrakhan
ASTRADR	astrakhan
ASTRAKMN	astrakhan
ASTRAK	astrakhan
ASTRANDR	ekstrand
ASTRAP	astrakhan
ASTR	astrakhan
ASTRASYM	astrakhan
ASTRAVB	astrakhan
ASTRLYNG	astrakhan
ASTRMLR	astrakhan
ASTRN	astrakhan
ASTRND	astrakhan
ASTRN	astrakhan
ASTRVK	astrakhan
ASTRVM	astrakhan
ASTRVS	astrakhan
ASTRVSTRAP	tristram
ASTRYAN	stroyan
ASTRYBL	astrakhan
ASTRYD	strydom
ASTRYDM	strydom
ASTRYDR	strydom
ASTRYM	astrakhan
ASTRYN	astrakhan
ASTRYNGR	armstrong
ASTRYNJR	astrakhan
ASTRYN	astrakhan
ASTRYNY	astrakhan
ASTRYR	astrakhan
ASTRY	astrakhan
ASTRYTY	astrakhan
ASTS	belfasts
ASTVARD	bastard
ASTVART	astarte
ASTVBRYJ	anastacia
ASTVDVLA	anastacia
ASTVFL	anastacia
ASTVKLAS	stoklas
ASTVK	anastacia
ASTVK	anastacia
ASTVKVL	anastacia
ASTVKY	anastacia
ASTVLK	anastacia
ASTVLR	anastacia
ASTVL	anastacia
ASTVN	anastacia
ASTVNBRAYJ	bray
ASTVNSN	afghanistans
ASTVN	anastacia
ASTVN	anastacia
ASTVR	anastacia
ASTVRGA	castergine
ASTVRLYR	anastacia
ASTVRMZ	anastacia
ASTVRR	austvorren
ASTVRYM	anastacia
ASTVRY	anastacia
ASTVRY	anastacia
ASTV	anastacia
ASTVVAL	stovall
ASTVY	anastacia
ASTYANSN	sebastians
ASTYBL	grasty
ASTYBR	grasty
ASTYD	grasty
ASTYGBRG	grasty
ASTYGMN	grasty
ASTYGRS	grasty
ASTYG	grasty
ASTYJH	grasty
ASTYK	grasty
ASTYKLMN	grasty
ASTYLR	grasty
ASTYL	grasty
ASTYL	grasty
ASTYL	grasty
ASTYLY	grasty
ASTYLZ	grasty
ASTYN	augustyn
ASTYNBRG	augustyn
ASTYNSN	augustyn
ASTYN	augustyn
ASTYN	augustyn
ASTYNSVN	augustyn
ASTYNTH	christyntie
ASTYNTJH	christyntie
ASTYNTJ	christyntie
ASTYNZ	augustyn
ASTYPLZ	elastoplast
ASTYP	grasty
ASTYRN	eastern
ASTYRNZ	eastern
ASTYSY	chasitys
ASTYSY	chasitys
ASTYT	grasty
ASTYVDNT	grasty
ASTYVN	grasty
ASTYVNSVN	grasty
ASTYVS	grasty
ASTYVZ	grasty
ASVALAP	aswalap
ASVALD	osvaldo
ASVANAY	anay
ASVK	jasvinder
ASVLT	jasvinder
ASVRS	jasvinder
ASVSKY	dostoevsky
ASVYSR	caseys
ASYA	creasy
ASY	creasy
'ASYF	creasy
ASYF	creasy
ASYMYLYT	bayly
ATANSYV	powhatans
ATA	atacama
ATA	atacama
ATARAS	ataras
ATH	abernathy
ATJH	daatje
ATKA	atka
ATKYNSN	atkins
ATKYNSVN	atkins
ATKYNZ	atka
ATKYNZ	atka
ATL	atlanta
ATLS	nahuatls
ATMSFR	atems
ATMZ	atman
AT	abbate
ATRAM	atram
ATR	alcatraz
ATRTN	alcatraz
ATRY	katryntje
ATRYSPS	coventrys
ATRZ	alcatraz
ATTLY	attlee
ATV	latvia
ATVATR	akhmatova
ATVD	latvia
ATV	latvia
ATVL	latvia
ATVL	latvia
ATV	latvia
ATV	latvia
ATVSAN	latvian
ATVS	latvia
ATVSY	latvia
ATVVD	latvia
ATVVL	latvia
ATVYL	latvia
ATYA	matyas
ATY	almaty
ATYG	almaty
ATYLRD	almaty
ATYLRDH	almaty
ATYLYV	almaty
ATYNGR	tyng
ATYNY	almaty
ATYNZVN	almaty
ATYS	almatys
ATYVL	almaty
ATYYA	aliyyah
AVACA	academy
AVAD	theravada
AVADYA	theravada
AVALD	avalon
AVAN	havana
AVANZ	havana
AVASTY	avas
AVBAJA	carbajal
AVBRAYAN	laxminarayan
AVBRDVRFR	havard
AVBRHVLZ	oberholz
AVBRHYM	hyman
AVBR	abraham
AVBRTAS	albertas
AVBRY	avery
AVBRY	avery
AVBYD	abby
AVBYNGM	bynon
AVCARD	bacardi
AVCAR	bacar
AVCLND	abend
AVCZ	almoravid
AVDDY	addy
AVDKRYK	chavda
AVDKYRK	chavda
AVDL	chavda
AVDLY	bradly
AVDRA	alejandra
AVDRGV	chavda
AVDVAK	aviva
AVDVN	chavda
AVDV	chavda
AVDYVM	chavda
AVFNR	almoravid
AVFYNGTVN	addington
AVGAR	angara
AVGBVRN	cogburn
AVGLT	bonavoglia
AVGNH	avignon
AVGNYV	avignon
AVGVR	almoravid
AVGVRY	abery
AVGVST	lovstad
AVGVSTV	austvollen
AVGVSTYN	augustyn
AVGYNH	aitkenhead
AVHALVRAN	alvarado
AVHRMN	braverman
AVJN	almoravid
AVKLND	auckland
AVKLY	brooklyn
AVKR	ackroyd
AVKRAYN	rayner
AVKR	ackroyd
AVKSLY	reykjaviks
AVKSTVN	austvollen
AVKSVL	reykjaviks
AVKT	almoravid
AVKTS	blavatsky
AVKTZ	savetz
AVKYNZ	parkyn
AVKYTS	kyte
AVLAFSVN	olafs
AVLA	avila
AVL	jouravlev
AVLAYVVLA	avila
AVLD	jouravlev
AVLDKVRN	goldkamp
AVLDRAYT	waldram
AVLDRYJ	aldrich
AVLDZ	jouravlev
AVLMN	jouravlev
AVL	jouravlev
AVLSN	elsner
AVLSN	elsner
AVLSVN	jouravlev
AVLSVN	jouravlev
AVLVSTAD	lovstad
AVLYMA	hollyman
AVLYNG	allyn
AVLY	jouravlev
AVLY	jouravlev
AVLYVYH	jouravlev
AVLYVYR	jouravlev
AVMAKY	bamako
AVMBRGR	alhambra
AVMGA	avogadro
AVMLAS	avilas
AVMR	almoravid
AVNAT	abernathy
AVN	avniel
AVNAYZA	anay
AVNAYZ	anay
AVNGLYSTA	amethysta
AVNG	avniel
AVNSTY	against
AVNSVN	avins
AVNVSKV	avniel
AVNYL	avniel
AVNYL	avniel
AVNZ	avniel
AVQVAQ	aviva
AVRAHAM	avraham
AVRAM	avram
AVRAYL	avraham
AVRAYS	avraham
AVRAYZ	avraham
AVRAYZ	avraham
AVRBN	avraham
AVRCARD	bacardi
AVRDALN	ardalich
AVRFYVS	avraham
AVRGAN	gargantua
AVRHAN	avraham
AVRHAN	avraham
AVRHART	carhart
AVRHRT	avraham
AVRHV	avraham
AVRKLYVN	aurkleven
AVRKNY	avraham
AVRLANDV	borland
AVRL	avraham
AVRLYNZ	charlyn
AVRMA	braverman
AVRM	avraham
AVRMSPVRDN	ormesporden
AVRN	avernus
AVRNVPN	avernus
AVR	avraham
AVRSBRG	eversberg
AVRSLR	aversa
AVRTS	alemberts
AVRTYZ	avraham
AVRVM	avraham
AVRV	avraham
AVRVYL	avraham
AVRY	avery
AVRYGA	avery
AVRYK	avery
AVRYL	avery
AVRYL	avery
AVRYNTS	katryntje
AVRYS	averys
AVRYS	averys
AVRYS	averys
AVRY	avery
AVRYVLY	avery
AVRYVN	avery
AVRYVRDAN	bigourdan
AVRYZ	avery
AVSAL	absalom
AVSBVRN	avs
AVSBVRN	avs
AVSLANDR	auslander
AVSLYNA	roslyn
AVSN	avs
AVSN	avs
AVSNZ	avs
AVSTBANN	austbanen
AVSTHAMARN	austhamaren
AVSTLYC	priestly
AVSTNDVRP	oostendorp
AVSTRANDR	ekstrand
AVSTRNDR	ekstrand
AVSTVLYN	allyn
AVSTVRYN	austvollen
AVSTYN	augustyn
AVSYVN	avs
AVSYZ	avs
AVTAGVRV	armitage
AVTA	kavita
AVTH	abbotsmith
AVTJH	aaltje
AVTJ	aaltje
AVTLV	almoravid
AVTLV	almoravid
AVT	almoravid
AVT	almoravid
AVTRY	avery
AVTVLYNY	allyn
AVTV	almoravid
AVTYS	almatys
AVVLYV	stavely
AVVRDAL	ardalich
AVVRPK	perpk
AVYAN	abyan
AVYARS	iyars
AVYCAY	avichay
AVYK	davy
AVYNAS	avinash
AVYNG	davy
AVYNZ	davy
AVYRSA	aversa
AVYS	chevys
AVYSNA	cessna
AVYVA	aviva
AVYVN	davy
AVZBRN	brno
AVZGVR	almoravid
AVZMN	agamemnon
AVZVNYS	albanys
AYALA	ayala
AYBAC	baback
AYBAR	aabar
AYBL	byblos
AYBYRVNK	byra
AYCAS	africas
AYCBVRN	ayckbourn
AYCYRV	ayckbourn
AYDA	ayda
AYDA	ayda
AYDAN	ayda
AYDMN	ayda
AYDNBVRG	haydn
AYD	ayda
AYDS	ayda
AYDVAYSVZ	amways
AYDVRY	ayda
AYDYD	ayda
AYDY	ayda
AY	abhay
AYF	mayfair
AYFJH	mayfair
AYFJ	mayfair
AYFVFL	mayfair
AYFV	mayfair
AYGAN	aganovic
AYGLASTVN	glastonbury
AYGLSTVN	ahlstrom
AYGLV	abhay
AYGLY	bayly
AYGRT	abhay
AYGRTVN	abhay
AYGV	abhay
AYGVR	abhay
AYJH	abhay
AYJLSTVN	ahlstrom
AYJVYN	kevyn
AYK	abhay
AYKAM	eckam
AYKARVS	karvinen
AYKBRN	ayckbourn
AYKBVRN	ayckbourn
AYKH	abhay
AYKLVZAN	azana
AYKN	abhay
AYKVK	abhay
AYLANA	alana
AYLAN	bayla
AYLKA	alkabeer
AYLMYN	ayling
AYLPV	ayling
AYLR	ayling
AYLSA	ailsa
AYLTH	althea
AYLVARD	aylward
AYLVR	ayling
AYLVT	ayling
AYLVT	ayling
AYLVYZA	ayling
AYLYA	bayly
AYLYDYV	bayly
AYLYN	bayly
AYLYN	bayly
AYLYN	bayly
AYLYNG	ayling
AYLYN	bayly
AYLYS	bayly
AYLYS	bayly
AYLZ	ayling
AYM	ayman
AYMAN	ayman
AYMAN	ayman
AYMANTZ	ayman
AYMAR	aymara
'AYMN	ayman
AYMN	ayman
AYMN	ayman
AYMRY	ayman
AYMVN	ayman
AYMY	ayman
AYNAC	maynard
AYN	ayn
AYNA	maynard
AYNANA	antananarivo
AYNAN	maynard
AYNARYNV	maynard
AYNAT	maynard
AYN	ayn
AYNAYN	maynard
AYNC	ayn
AYNDALYS	kodalys
AYNDAYRSN	ayrshire
AYNDRA	alejandra
AYNDRAJYT	indrajit
AYNDRANYL	chandran
AYNDRLY	alejandra
AYNDSVRS	lynds
AYNDVY	ayn
AYNGALZ	bangalore
AYNG	ayn
AYNG	ayn
AYNG	ayn
AYNGLD	angle
AYNGLF	angle
AYNGL	angle
AYNGLS	angels
AYNGLYS	allyson
AYNGLYS	allyson
AYNGMAR	ingmar
AYNGMAR	ingmar
AYNGRAHAM	ingraham
AYNGRAM	ingram
AYNGRM	ayn
AYNGRSVL	ayn
AYNGRYA	arya
AYNGRYD	ayn
AYNGRYSL	chrysler
AYNGRYSVL	hungarys
AYNGVAR	ingvar
AYNGYJD	ayn
AYNHV	ayn
AYNJH	ayn
AYNJJNRY	ayn
AYNKH	ayn
AYNKVGNYTA	ayn
AYNLY	ayn
AYNMN	ayn
AYNR	ayn
AYNS	ayn
AYNS	ayn
AYNSR	ayn
AYNT	paynter
AYNTAYR	paynter
AYNT	paynter
AYNTH	cynthia
AYNTJ	eyntje
AYNTJH	eyntje
AYNTLSAT	intelsat
AYNTRNT	paynter
AYNTRNT	paynter
AYNVKSN	ayn
AYNVN	ayn
AYNVSNT	ayn
AYNYSA	albanys
AYNZ	ayn
AYNZHNRY	inzhenery
AYNZ	ayn
AYNZ	ayn
AYPRSVN	aprs
AYPRT	cyprian
AYR	ayres
AYRARDY	bayard
AYRAY	mayra
AYRBYD	ayres
AYRD	ayres
AYRDV	ayres
AYR	ayres
AYR	ayres
AYRLAYNZ	gourlay
AYRL	ayres
AYRLND	ayres
AYRNST	bernstein
AYRNVT	ayres
AYRP	ayres
AYRS	ayrshire
AYRVN	ayres
AYRVN	ayres
AYRVNSVN	ayres
AYRVVD	ayres
AYRVYNG	ayres
AYRVYN	ayres
AYRVYN	ayres
AYRVYYN	ayres
AYRY	ayres
AYRYK	ayres
AYRYS	averys
AYRYZARY	anniversary
AYRZ	ayres
'AYSA	magsaysay
AYSA	magsaysay
'AYSA	magsaysay
AYSA	magsaysay
AYS	amways
AYSA	magsaysay
AYSAK	magsaysay
AYSAK	magsaysay
AYSAKS	isakson
AYSAMA	aissama
AYSAN	maysan
AYSASK	magsaysay
AYSBL	amways
AYSFALZ	horsfall
'AYSH	butaysh
AYSH	butaysh
'AYSH	butaysh
AYSH	butaysh
AYS	amways
AYSKANDR	iskander
AYSK	amways
AYSLT	amways
AYSLYK	slyke
AYSMAN	tysmans
AYSMN	amways
AYSNSTAT	aisenstat
AYSPVRT	amways
AYSRAT	israt
AYSRT	amways
AYSRT	amways
AYSTBRN	eastburn
AYSTLND	bystander
AYSTMAS	christmas
AYSTMN	mayston
AYSTMVS	mayston
AYSTRAGV	abstract
AYSTRBRVK	easterbrook
AYSTR	mayston
AYSTR	mayston
AYSTVVD	mayston
AYSTVY	mayston
AYSTYK	mayston
AYSTYN	augustyn
AYSVN	amways
AYSVN	amways
AYSY	amways
AYSYZAKY	amways
AYT	clayton
AYT	clayton
AYTAMAR	itamar
AYTCV	clayton
AYTCVN	clayton
AYTH	ghayth
AYTH	ghayth
AYTJ	clayton
AYTJ	clayton
AYTJY	clayton
AYTKN	clayton
AYTR	clayton
AYTSN	clayton
AYVA	kayvon
AYVALD	osvaldo
AYVANZ	vanzandt
AYVAR	almudevar
AYVAYNG	ayn
AYVGNH	kayvon
AYV	kayvon
AYVJNH	kayvon
AYVLYN	allyn
AYVND	kayvon
AYVNS	haydns
AYVRS	ayers
AYVRSVN	ayers
AYVRY	kayvon
AYVS	kayvon
AYVS	kayvon
AYVSTYS	dustys
AYVSV	kayvon
AYVSYN	calsyn
AYVTYK	kayvon
AYVYN	kayvon
AYZAK	byzantine
AYZAKSVN	aksu
AYZCYL	cyliax
AYZDY	abhay
AYZ	abhay
AYZL	abhay
AYZMN	ryzman
AYZRVDA	ayurveda
AYZV	abhay
AZAD	azad
AZALYA	alya
AZALY	azalea
AZANA	azana
AZAR	balthazar
AZBVRN	abdulaziz
AZCYL	cyliax
AZHR	azhar
AZLA	azlan
AZLN	azlan
AZR	abdulaziz
AZVR	ghazvanid
AZYCL	cyclades
BAABAR	baabar
BAAFJ	baabar
BABA	baba
BABA	baba
BABAH	babah
BABAR	babar
BABAR	babar
BAB	baba
BAB	baba
BAB	baba
BABK	baba
BABK	baba
BABL	ablation
BABR	abraham
BABT	abtine
BABV	baba
BABVRAV	baburao
BABVSKYN	dostoevsky
BABY	babylon
BABY	babylon
BABY	babylon
BABYKV	babylon
BABYRL	babylon
BABYTZ	babitz
BACALTR	bacall
BACARAC	bacharach
BACAS	athabascas
BAC	baback
BACLDR	baldred
BAD	abad
BAD	abad
BADKK	abad
BADKVK	abad
BADLVC	badlands
BADMN	abad
BADNYK	abad
BADR	badr
BADRMN	baderman
BADRYK	badry
BADVYN	abad
BADVYYN	abad
BADY	abad
BADYG	abad
BADYN	abad
BADYN	abad
BADYNGTN	baldington
BADYNGTVN	baldington
BADYVN	abad
BADZ	abad
BADZYAK	abad
BAFL	baffin
BAFY	baffin
BAFY	baffin
BAGA	bagade
BAGAM	agamemnon
BAGARLY	baggarly
BAGAY	bagade
BAGDAN	baghdad
BAGHAM	baugham
BAGLY	bagley
BAGLY	bagley
BAGM	babbage
BAGSAV	bagshawe
BAGVLY	babbage
BAGYD	babbage
BAGZ	babbage
BAGZ	babbage
BAHYH	alaqabah
BAJVA	bajic
BAJYK	bajic
BAKAR	akar
BAKAS	backas
BAKAYA	bakaya
BAKLY	akl
BAKNR	babak
BAKR	akrill
BAKR	akrill
BAKSKA	bakshee
BAKSR	bakshee
BAKSY	bakshee
BAKVM	babak
BAKVS	babak
BAKY	babak
BAKYR	babak
BALAK	balanchine
BALANDR	badlands
BALANS	alans
BALARD	balarie
BALARY	balarie
BALAS	balash
BALAST	balash
BAL	anibal
BAL	anibal
BALBYR	balbir
BALCVNAS	balchunas
BALD	archibald
BALDRD	baldred
BALDVR	archibald
BALDYNGTN	baldington
BALDYNGTVN	baldington
BALFNZ	balfanz
BALGA	algae
BALHAM	balham
BALKA	balkan
BALKVSKY	tsiolkovsky
BALMA	balma
BALMASDA	balmaseda
BALMR	balma
BALNDRA	balendra
BALNY	albany
BALSAM	balsam
BALSARA	balsam
BALSK	anibals
BALSLY	balsley
BALSVN	anibals
BALTAKS	baltais
BALTAYS	baltais
BALTAZAR	balthazar
BALTZL	baltzell
BALV	alva
BALY	alya
BALYGA	baliga
BALYK	alya
BALYN	rosalyn
BALYN	rosalyn
BALYSTYK	bialystok
BALYT	alya
BAMBRGR	alhambra
BAMN	alabama
BAMSV	bamse
BANA	arbanas
BANABYV	barnaby
BAN	albania
BAN	albania
BAND	bandali
BANDD	bandali
BANDYRDY	bandy
BANDZ	bandali
BANGARTZ	angara
BANG	bang
BANGRZ	bang
BANKLR	bankler
BANKRAFT	kraft
BANKRVFT	bancroft
BANKS	banks
BANKVALA	bankwalla
BANL	albania
BANR	albania
BANTVN	banting
BANTY	banting
BANTYNG	banting
BANY	albany
BANY	albany
BANY	albany
BANYTA	albany
BANYTV	albany
BANYVRA	albany
BAP	anabaptist
BAPTYSTA	baptista
BAPTYST	anabaptist
BARAKVTA	barakah
BARAS	barash
BARASV	barash
BARAT	barath
BARBAGALV	barbagallo
BAR	aabar
BARBAS	barbas
BARBR	barbra
BARBVRAK	barborak
BARBVR	barb
BARBY	barb
BARD	bard
BARDVLVMZ	bard
BARDYK	lombardy
BARF	barff
BARFRD	barford
BARFVRD	barford
BARFYT	barff
BARG	bargh
BARGS	bargh
BARGVS	bargh
BARH	aabar
BARJYL	aabar
BARKALV	barkah
BARKASFYLD	barkah
BARKAY	barkah
BARK	bark
BARKLY	barkley
BARKRAFT	kraft
BARKR	bark
BARKSDYLY	barksdale
BARKSFYLD	barksfield
BARKVLV	bark
BARKVS	bark
BARLAS	barlas
BARL	barlas
BARL	barlas
BARLV	barlas
BARNABY	barnaby
BARNAM	barnabas
BARNARD	barnard
BARNAS	barnas
BARN	barn
BARND	barend
BARNSA	barnshaw
BARNSAV	barnshaw
BARNSV	barnshaw
BARNT	barents
BARNY	barn
BARNYK	barn
BARQARD	barnard
BARS	babars
BARSY	babars
BARTA	barta
BART	bart
BART	bart
BARTHVLVMYVS	barth
BARTK	bart
BARTKVR	bart
BARTL	bartle
BARTL	bartle
BARTLMAS	bartelmus
BARTLMVS	bartelmus
BARTLT	bartelt
BARTLT	bartelt
BARTLY	bartle
BARTMVS	bart
BARTN	bart
BARTN	bart
BARTVK	bart
BARTVLVMVS	bart
BARTVLVMYVS	bart
BARTVLYNY	bart
BARTVN	bart
BARTVNYKV	bart
BARTY	bart
BARTY	bart
BARTYH	bart
BARTYS	martys
BARTZ	bartz
BARVA	carvajal
BARVC	aabar
BARVN	aabar
BARVN	aabar
BARVNS	aldebarans
BARVNYA	aabar
BARVZ	aabar
BARYAKS	mubaraks
BARY	barbary
BARY	barbary
BARY	barbary
BARY	barbary
BARYNGR	barbary
BARYNGTN	barbary
BARYNGTVN	barbary
BARYS	barbarys
BASA	mombasa
BAS	abbas
BAS	abbas
BASKAR	baskar
BASKRVYL	baskerville
BASKY	baskar
BASL	basle
BASMA	basma
BASN	abbas
BASR	basra
BASSA	bassam
BASSN	bass
BASTARD	bastard
BAST	bastard
BASTYK	bastard
BASTYLVS	bastard
BASTYN	augustyn
BASTYN	augustyn
BASTYN	augustyn
BASTYVN	bastard
BASVAL	osvaldo
BASV	abbas
BASV	abbas
BASVM	abbas
BASYL	abbas
BASYLYKA	bayly
BASYLYSK	basilisk
BASYLYVS	bayly
BASYN	abbas
BATALS	atalanta
BATAN	atanacio
BAT	abbate
BATL	abbate
BATLR	abbate
BATNAT	patna
BATN	abbate
BATRA	batra
BATRBY	batra
BATRS	batra
BATRSS	barsse
BATRST	bathurst
BATRVRS	batra
BATRYS	barbarys
BATRZ	batra
BATY	abbate
BATYL	abbate
BATYNG	tyng
BAVA	bavaria
BAV	bavaria
BAVCMP	bavaria
BAVDN	bavaria
BAVDN	bavaria
BAVDVYYN	bavaria
BAVDYN	bandy
BAVDYN	bandy
BAVDYSYN	lombardys
BAVGMN	bavaria
BAVKAM	avram
BAVKVS	bavaria
BAVM	bavaria
BAVMGARTNR	baumgartner
BAVPRS	aprs
BAVRY	avery
BAVS	avs
BAVYZ	galbavy
BAXVM	baxter
BAYARD	bayard
BAY	bayard
BAYDA	bayda
BAYDN	bayda
BAYFYLD	bayard
BAYKRASTAF	rastafarian
BAYKRZTAF	bayard
BAYLA	bayla
BAYLS	bayla
BAYLY	bayly
BAYLYNGSLY	bayly
BAYLYNGTVN	bayly
BAYLYV	bayly
BAYLZ	bayla
BAYNVN	ayn
BAYPRT	baupres
BAYR	bayreuth
BAYRD	bayard
BAYRN	bayern
BAYRN	bayern
BAYRTAY	barta
BAYRTYH	bayreuth
BAYRVN	bayreuth
BAYSVT	bayse
BAYZ	bayard
BAZBY	babylon
BAZBY	babylon
BAZT	aztec
BBKAK	kaki
BBYT	abby
BCLDR	aldrich
BCLR	abcher
BDAL	abdalmalik
'BDALH	abdalmalik
'BDALLH	abdalmalik
'BDALRHMAN	abdalrahman
'BDALRHMAN	abdalrahman
'BDALRHMN	abdalrahman
'BDALRHMN	abdalrahman
'BDAL'ZYR	abdalmalik
'BDAL'ZYZ	abdalmalik
'BDHBY	abby
BDKK	abdalmalik
BDKVK	abdalmalik
'BDL	abdalmalik
BDLAK	abdulaziz
BDL	abdalmalik
BDLVC	abdalmalik
'BDL'ZYZ	abdalmalik
BDMY	abdalmalik
BDNAR	bednar
BDRK	abdalmalik
BDRYK	badry
'BDVAL'ZYZ	lindvall
'BDVL	abdalmalik
'BDVLRHMN	abdalrahman
BDYN	dyna
BDYRA	bdira
BDYR	abdalmalik
BFJ	baefje
BGDAD	baghdad
BGLY	gillogly
BGNVLD	ragnvald
BGVYL	aeschylus
BGYR	argyle
BHAMND	bahamonde
BHARA	mahabharata
BHNAM	behnam
BHRV	abhay
BHST	kazakhstan
BHYJA	abernathy
BJLY	ajlun
BKA	afrikaans
BKAR	akar
BK	bk
BK	bk
BK	bk
BKDVR	advent
BKHVRST	backhurst
BKMN	agamemnon
BKMN	agamemnon
BKMYR	chernomyrdin
BKR	ackroyd
BKR	ackroyd
BKR	ackroyd
BKR	ackroyd
BKS	bks
BKT	arktiki
BKVA	huckvale
BKVF	bk
BKVK	bk
BKVY	bk
BKVYT	bk
BKVYYR	aliyyah
BKY	becky
BKY	becky
BKYNGSAL	beckingsale
BKYNGSL	billingsley
BKYNGSYL	armstrongs
BKYR	kyrgyzstan
BKYS	beckys
BLA	ablation
BLAC	blachford
BLAF	ablation
BLAFS	olafs
BLAHA	blaha
BLAK	blake
BLAKSVM	blacks
BLALAK	blal
BLAL	blal
BLAL	blal
BLAM	ablation
BLAMKH	ablation
BLAMY	bellamy
BLANCARD	blanchard
BLANCH	blanchard
BLANSDAN	blanstan
BLANSDN	blanstan
BLANSTAN	blanstan
BLANZDVN	blanca
BLAS	blas
BLASDN	blas
BLASK	blask
BLASR	blas
BLASY	blas
BLASYVS	blas
BLAVADNYK	blavatnik
BLAVYZ	blavatnik
BLAYT	clayton
BLAZ	blaz
BLAZK	blaz
BLAZKYYVZ	blaz
BL	ablation
BLDN	ablation
BLDRD	aldrich
BLDVYJN	ablation
BLDVYN	goldwyn
BLDVYYN	ablation
BLDYNG	baldington
BLDYNGTVN	baldington
BLGA	algae
BLKA	alkabeer
BLK	ablation
BLKLND	blokland
BLKLY	blokland
BLKMN	volkman
BLKMN	volkman
BLKSVM	milks
BLKSYR	assyria
BLKVL	ablation
BLNK	blank
BLNKHVRN	blenkhorn
BLNKV	blank
BLNKY	belenky
BLS	abduls
BLTBRG	blattberg
BLTRAV	beltrao
BLV	blvd
BLVC	blvd
BLVHM	blohm
BLVKSVM	blvd
BLVM	blvd
BLVMBRG	alhambra
BLVMN	blvd
BLVMNFLD	blumenfeld
BLVNSDVM	blunsdon
BLVNSDVN	blunsdon
BLVNZDM	blvd
BLVRNJ	blvd
BLVSKVM	blask
BLVYN	blvd
BLVZ	blvd
BLVZVM	blvd
BLYK	blystone
BLYK	blystone
BLYN	allyn
BLYN	allyn
BLYNDA	lynda
BLYNGASLY	kanchenjungas
BLYNGTN	addington
BLYNKV	allyn
BLYNKV	allyn
BLYNKVV	allyn
BLYR	blystone
BLYSTVN	blystone
BLYTA	blyth
BLYVYS	blystone
BLYZ	allyz
BNAKSY	aksu
BNAMAR	benamar
BNAN	anand
BNARY	grabnar
BN	abner
BNDANG	ujungpandang
BNDASTVN	amandas
BNDK	abend
BNDLY	bradly
BNDR	alejandra
BNDRVB	alejandra
BNDY	andy
BNG	abner
BNG	abner
BNG	abner
BNGT	addington
BNH	abner
BNJYMAN	ayman
BNKR	nkrumah
BNKR	nkrumah
BNKS	armonks
BNR	abner
BNS	abelsons
BNSN	abelsons
BNSN	abelsons
BNSVN	brownsville
BNT	abner
BNT	abner
BNT	abner
BNTLY	gently
BNTN	zentner
BNTN	zentner
BNTV	abner
BNTVN	abner
BNTZ	bentz
BNTZ	bentz
BNYA	bunyan
BNYAMYN	amy
BNYFASYVS	belfast
BNYN	conyne
BNZ	abner
BNZN	abner
BQYR	assyria
BRABANT	brabant
BRABY	araby
BRACMN	brachman
BRAD	brad
BRAD	brad
BRADLY	bradly
BRADR	brad
BRADRTN	brad
BRADRTVN	brad
BRADSAV	brads
BRADY	brady
BRADYS	bradlys
BRAFVRD	bradford
BRAGHAM	abraham
BRAHAM	abraham
BRAHYM	abraham
BRAK	brake
BRAKLY	bradly
BRAKNY	brackney
BRAMBAV	korambath
BRAM	abram
BRAMR	abram
BRAN	bran
BRAN	bran
BRAN	bran
BRANDL	braendle
BRANDY	brandy
BRANN	brannen
BRANSAV	brans
BRANSDVN	brans
BRANSKVMB	brans
BRANSVYK	brans
BRANT	brant
BRANT	brant
BRARDY	berardi
BRASARD	brassard
BRASAYR	barbras
BRASRZ	barbras
BRASYRZ	barbras
BRAT	brat
BRATLT	bratlie
BRATR	brat
BRATYNA	bratina
BRAVN	braverman
BRAVN	braverman
BRAVNFYLD	braverman
BRAVNR	braverman
BRAVNYNG	braverman
BRAVTVN	braverman
BRAVV	braverman
BRAVYC	braverman
BRAYAN	laxminarayan
BRAY	bray
BRAYD	bray
BRAYN	bray
BRAYNKLR	bray
BRAYR	bray
BRAYS	brays
BRAYS	brays
BRAYSLAV	bratislava
BRAYSVN	brays
BRAYT	bray
BRAYTN	bray
BRAYTVN	bray
BRAYTVYT	bray
BRAZVN	brazelton
BR	abraham
BRBVR	abraham
BRCA	arcadia
BRCR	abercrombie
BRD	abelard
BRD	abelard
BRDLY	bradly
BRDLY	bradly
BRDLY	bradly
BRDN	bringardner
BRDN	bringardner
BRDN	bringardner
BRDSANG	birdsong
BRDSAV	alfords
BRDY	brady
BRDYK	brady
BRDYT	brady
BRFVRD	barford
BRGANTY	briganti
BRGARD	asgard
BRGAYLV	gayle
BRG	aberg
BRG	aberg
BRGDAN	gdansk
BRGLAND	england
BRGL	berglund
BRGMN	bergman
BRGR	hargreaves
BRGS	bergson
BRGS	bergson
BRGSVN	bergson
BRGYVT	argyle
BRHAN	burhan
BRJ	abraham
BRKAH	barkah
BRKASPYR	farkas
BRKAT	arkansan
BRKAT	arkansan
BRK	abraham
BRK	abraham
BRK	abraham
BRKLY	aurkleven
BRKSFYLD	barksfield
BRKT	arktiki
BRKVL	abraham
BRKVVYC	abraham
BRKY	gorky
BRLACR	delacroix
BRL	abraham
BRLND	borland
BRLSVN	burls
BRLV	abraham
BRLYN	charlyn
BRLYNG	charlyn
BRLYNG	charlyn
BRML	bromley
BRMN	abraham
BRMN	abraham
BRNADVS	bernadette
BRNAL	bernal
BRNAN	bernanke
BRNARD	barnard
BRNARD	barnard
BRNARDV	barnard
BRNARDY	barnard
BRNARDYN	barnard
BRNARDZ	barnard
BRNCAVD	leoncavallo
BRNC	branch
BRNCLY	branch
BRNDAN	brendan
BRND	bernd
BRND	bernd
BRND	bernd
BRNDL	brendler
BRNDL	brendler
BRNDS	amerinds
BRNDVN	bernd
BRNDY	brandy
BRNDY	brandy
BRNDYS	brandys
BRNHARD	bernhard
BRNHART	barnhart
BRNHR	arnhem
BRNR	brno
BRNSAV	ainsaar
BRNSV	barnshaw
BRNT	bernt
BRNT	bernt
BRNT	bernt
BRNV	brno
BRNVL	brno
BRNY	brno
BRNY	brno
BRNYR	brno
BRNZ	brno
BRQ	abraham
BRSAV	narsavage
BRS	brs
BRSFVRD	horsford
BRSLAV	berislav
BRSLR	breslau
BRSMN	brs
BRSVN	brs
BRSY	brs
BRT	abraham
BRTLSVN	bartle
BRTN	baumgartner
BRTRAND	bertrand
BRTR	bertram
BRTS	alemberts
BRTVN	dubrovnik
BRTVN	dubrovnik
BRTVN	dubrovnik
BRTY	bruty
BRTY	bruty
BRTYH	bruty
BRVANHAT	manhattan
BRVARK	harvard
BRVDA	ayurveda
BRVD	abraham
BRVDFYLD	bradford
BRVDHAST	buddhas
BRVDLY	bradly
BRVDR	abraham
BRVDRTVN	abraham
BRVHL	brohl
BRVKAV	brokaw
BRVK	abraham
BRVK	abraham
BRVK	abraham
BRVK	abraham
BRVKN	abraham
BRVKNR	abraham
BRVKR	abraham
BRVKS	abraham
BRVKSL	stockslager
BRVKVL	abraham
BRVKZ	abraham
BRVMBRG	bromberg
BRVMBRGR	bromberg
BRVMFYLD	brumfield
BRVMLY	bromley
BRVMYJ	abraham
BRVNL	dubrovnik
BRVNR	dubrovnik
BRVNVYYN	dubrovnik
BRVNYYV	cerveny
BRVR	abraham
BRVSRD	harvard
BRVSTR	abstract
BRVSYAV	pogosyan
BRVTY	bruty
BRVTZMN	brutzman
BRVVR	abraham
BRVYK	abraham
BRVYLV	pennsylvania
BRVYN	bruyn
BRVYNS	boleyns
BRVYNYNG	bruyn
BRVYR	abraham
BRVYR	abraham
BRVZ	abraham
BRXARD	abelard
BRYAN	bryan
BRYAN	bryan
BRYANT	bryant
BRY	bryan
BRY	bryan
BRY	bryan
BRY	bryan
BRYBR	bryan
BRY	bryan
BRY	bryan
BRYDLAV	rydland
BRYDVL	bryde
BRYDY	bryde
BRYDYNG	bryde
BRYGVY	bryguy
BRYJ	bryan
BRYJ	bryan
BRYJMN	bryan
BRYKASPYR	kasparov
BRYKSPYR	breakspear
BRYL	beryl
BRYM	barrymore
BRYMR	barrymore
BRYMSTVN	brimstone
BRYN	bryn
BRYN	bryn
BRYNDAN	brendan
BRYND	bryn
BRYNDL	brendler
BRYNGARDNR	bringardner
BRYNGTN	bryn
BRYNGTVN	bryn
BRYNK	bryn
BRYNKMN	brinkman
BRYNR	bryn
BRYNSN	bryn
BRYR	bryan
BRYR	bryan
BRYS	bryson
BRYS	bryson
BRYSBYN	bryson
BRYSBYN	bryson
BRYSNV	bryson
BRYSTVL	bryson
BRYSYNDA	brisinda
BRYTA	brita
BRYT	bryan
BRYTLYNG	marylynn
BRYTV	bryan
BRYTVN	bryan
BRYTYS	almatys
BRYVN	bryan
BRYVNY	bryony
BRYVR	bryan
BRYVRY	bryan
BRYYKPR	bryan
BRYYTVN	bryan
BRYZA	bryan
BRZA	arzate
BSAK	absalom
BSAM	absalom
BS	absalom
BSBRYS	bryson
BSKT	korzybski
BSKV	korzybski
BSL	herbsleb
BSMA	asma
BSMY	smyley
BST	abstract
BSVAL	osvaldo
BSVL	absalom
BSVN	absalom
BSYL	pennsylvania
BSYM	syme
BSYRA	syracuse
BSYT	forsyth
BTAN	afghanistan
BTCLDR	aldrich
BTHVN	abbotsmith
BTL	abtine
BTMN	abtine
BTRYS	coventrys
BTSY	betsy
BTVL	abtine
BTY	abtine
BTY	abtine
BTYG	stygian
BTYYV	abtine
BTZA	betza
BVALY	alya
BVAS	akhmatovas
BVAY	solovay
BVAY	solovay
BVAYVYN	kayvon
BV	gelbvieh
BVBY	abby
BVBYS	abbys
BVCA	academy
BVCA	academy
BVC	gelbvieh
BVCGA	mcgavin
BVDA	chavda
BVDA	chavda
BVDAPATY	bodapati
BVDAR	adar
BVD	blvd
BVD	blvd
BVD	blvd
'BVDHABY	abudhabi
BVDLA	badlands
BVDN	adnams
BVDN	adnams
BVDNMYLR	mylar
BVDRA	alejandra
BVDRV	adri
BVDV	advent
BVDVR	advent
BVDVYN	kevyn
BVDY	addy
BVDYVN	addy
BVDYVYN	kevyn
BVFALV	alva
BVGARD	asgard
BVGHAM	baugham
BVGS	ags
BVHL	ahlstrom
BVHR	ahriman
BVJY	gelbvieh
BVKL	ackley
BVKL	ackley
BVKLY	brooklyn
BVKR	ackroyd
BVKSY	addicks
BVKVN	avniel
BVLA	kevlar
BVLARD	abelard
BVL	devlin
BVLDN	adnams
BVLDT	boldt
BVLDVYJN	advent
BVLDZR	aguinaldo
BVLF	adolf
BVLN	alnilam
BVLR	abdalrahman
BVLR	abdalrahman
BVLTAN	beltane
BVLTN	keltner
BVLTVN	aaltje
BVLV	alva
BVLVC	alva
BVLVS	pavlovs
BVLVYJN	ogilvy
BVLYNG	allyn
BVMBR	alhambra
BVMBRGR	alhambra
BVM	gelbvieh
BVMGARDNR	bumgardner
BVMHARD	bomhard
BVMN	agamemnon
BVNANDR	alejandra
BVNAR	achernar
BVNAVGLYA	bonavoglia
BVN	avniel
BVN	avniel
BVNGARD	bongard
BVNSTRA	boonstra
BVNTN	zentner
BVNVMV	anvers
BVNVNV	anvers
BVNY	lyubovny
BVNYFASS	fassbinder
BVNYFASYVS	belfast
BVNYFKYVS	lyubovny
BVNYFYSS	abyssinia
BVNYN	conyne
BVNYTZ	lyubovny
BVQAM	qamar
BVRA	avraham
BVRAD	alvarado
BVRAP	arapaho
BVRASCY	buraschi
BVR	avraham
BVRCRT	abercrombie
BVRDR	cordrey
BVRDYK	cordy
BVRGA	borgailo
BVRG	aberg
BVRGV	aberg
BVRGYVYS	argyle
BVRJYA	najya
BVRKVAL	huckvale
BVRKVL	ark
BVRKVYL	aeschylus
BVRKY	gorky
BVRL	adderley
BVRL	adderley
BVRLN	adderley
BVRM	ackerman
BVRML	ackerman
BVRMN	ackerman
BVRSL	ekerslato
BVRST	amherst
BVRSYR	assyria
BVRVS	antevs
BVRYJ	abery
BVRYL	beryl
BVRYLLV	beryl
BVRYS	averys
BVRYVN	abery
BVRYZ	ryzman
BVRZ	arzate
BVSA	absalom
BVSAL	absalom
BVSART	bossart
BVSARV	amritsar
BVSAYSN	magsaysay
BVS	antevs
BVS	antevs
BVS	antevs
BVS	antevs
BVS	antevs
BVS	antevs
BVSCA	athabasca
BVSCGA	boschga
BVSGA	asgard
BVSKA	alaska
BVSK	dnepropetrovsk
BVSLY	roslyn
BVSNL	ainley
BVSNY	chesny
BVSTAK	bostak
BVSTAMNT	bustamante
BVST	lovstad
BVSTRAM	tristram
BVSTRVM	abstract
BVSTVN	austvollen
BVSTYK	augustyn
BVSVAL	osvaldo
BVSVL	antevs
BVSVM	antevs
BVSVN	antevs
BVSVR	antevs
BVSVYSN	chevys
BVSY	antevs
BVSY	antevs
BVSYK	psyko
BVSYSN	bekesys
BVSYVYSN	chevys
BVTARY	secretary
BVTAYS	butaysh
BVT	gelbvieh
BVT	gelbvieh
BVTCR	abercrombie
BVTLR	abdalrahman
BVTRL	aaltruide
BVTRS	pyotrs
BVTSYH	betsy
BVTVN	austvollen
BVTZ	adametz
BVVDVYN	kevyn
BVVN	avniel
BVVY	chevy
BVXNY	albany
BVY	chevy
BVYKV	boyko
BVYLN	aeschylus
BVYR	assyria
BVYRKVYL	aeschylus
BVYS	chevys
BVYS	chevys
BVYSVYKS	chevys
BVYSYV	chevys
BVYVN	avniel
BVYZY	allyz
BVZANCYV	clancy
BVZ	gelbvieh
BVZKART	crockart
BVZMAN	boltzmann
BVZVA	ghazvanid
BVZVAL	avalon
BVZVVA	akhmatova
BVZVVYL	aeschylus
BVZYDAR	adar
BVZYD	ackroyd
BYAKV	abyan
BYAN	abyan
BYANG	abyan
BYANGTAY	byungtae
BYATLYNG	gatling
BYAVYS	abyan
BY	abby
BYBL	byblos
BYBR	byblos
BYCAM	atacama
BYC	abby
BYCLY	clyde
BYCMP	abby
BYCYNGSYL	armstrongs
BYCZ	abby
BYDA	ayda
BYDL	rydland
'BYD	abby
BYDV	abby
BYDVL	abby
BYDY	abby
BYF	byfield
BYFJH	byfield
BYFRAST	fraser
BYG	bygden
BYGLHL	bygden
BYGND	agndie
BYGNVALD	ragnvald
BYGV	bygden
BYGVRDAN	bigourdan
BYGZ	bygden
BYHAN	beyhan
BYHYV	hyvonen
BYJ	abby
BYJH	abby
BYKA	abby
BYKARD	kardal
BYK	abby
BYK	abby
BYK	abby
BYK	abby
BYKLY	brooklyn
BYKN	abby
BYKNST	against
BYKRASTAF	rastafarian
BYKRASTAFY	rastafarian
BYKRASTF	grasteinen
BYKRASTYF	grasty
BYKR	abby
BYKRSTF	amherst
BYKRTN	baumgartner
BYKSLR	stockslager
BYKVL	abby
BYKVN	abby
BYLAL	babylon
BYLANY	billany
BYL	babylon
BYL	babylon
BYL	babylon
BYLHAR	bilhar
BYLKY	babylon
BYLNGTVN	byungtae
BYLR	babylon
BYLR	babylon
BYLR	babylon
BYLS	chernobyls
BYLV	babylon
BYLYKVK	babylon
BYLYNGASLAY	kanchenjungas
BYLYNG	marylynn
BYLYNGSLY	billingsley
BYLYNGTVN	marylynn
BYLYNGZ	marylynn
BYLYNSKY	babylons
BYLYR	babylon
BYLZ	babylon
BYLZYBAB	baba
BYMN	lymn
BYMYNG	jacomyntie
BYN	bynon
BYN	bynon
BYN	bynon
BYN	bynon
BYNDMN	bynon
BYNFNG	bienfang
BYNG	bynon
BYNH	bynon
BYNJN	bynon
BYNMDART	bainmedart
BYNQAM	bynon
BYNR	bynon
BYNS	dobyns
BYNS	dobyns
BYNVD	bynon
BYNVY	bynon
BYNY	bynon
BYNY	bynon
BYNY	bynon
BYNYYVN	bynon
BYNZ	bynon
BYNZ	bynon
BYNZ	bynon
BYPYN	pynchon
BYRA	byra
BYR	byra
BYR	byra
BYR	byra
BYR	byra
BYR	byra
BYRBK	byra
BYRC	byra
BYRD	byrd
BYRD	byrd
BYRDMR	byrd
BYRDN	byrd
BYRFYS	buffys
BYRG	byra
BYRGL	berglund
BYRK	byra
BYRLA	barlas
BYRMN	byra
BYRNBVYM	byrne
BYRN	byrne
BYRNH	byrne
BYRNS	byrne
BYRTAY	alberta
BYRT	byra
BYRTRYK	bertram
BYRTYH	byra
BYRTYH	byra
BYRVT	byra
BYRYC	bryce
BYRYGANTY	blantyre
BYRYNG	bryn
BYRZ	byra
BYSAYV	magsaysay
BYS	abbys
BYSH	kuibyshev
BYSKMP	abbys
BYSL	abbys
BYSLY	abbys
BYSMARK	bismark
BYSM	abbys
BYSR	abbys
BYSTANDR	bystander
BYST	bystander
BYST	bystander
BYSYN	abbys
BYTANKRT	bystander
BYTARD	bastard
BYT	presbyterian
BYT	presbyterian
BYTMN	clytemnestra
BYTN	presbyterian
BYTRAYS	brays
BYTRYK	coventry
BYTZ	presbyterian
BYVAN	abyan
BYV	abby
BYVCAMP	basecamp
BYVCMP	abby
BYVDVYN	kevyn
BYVFYZ	abby
BYVGAM	agamemnon
BYVKMP	abby
BYVKRAFT	kraft
BYVLY	abby
BYVLYV	abby
BYVMNT	abby
BYVMVNT	abby
BYVNGS	byungse
BYVR	abby
BYVRLY	baggarly
BYVRZ	abby
BYVSH	kuibyshev
BYVTL	abby
BYVYS	chevys
BYVZVYL	abby
BYYVCMP	abby
BYYVNYK	lyubovny
BYZ	byzantine
BYZR	byzantine
BYZVANAT	devanathan
BYZVAS	akhmatovas
BYZVYL	byzantine
BYZYR	byzantine
BZVA	ghazvanid
CAGN	cagney
CAKV	cakebread
CALK	alkabeer
CAMBRLAYN	cambrian
CAMPLYN	basecamp
CAND	candace
CANDRAN	chandran
CANDR	alejandra
CANDVNYA	candace
CANSY	africans
CANY	canyon
CAPLA	kaplan
CAPL	acapulco
CAPMN	acapulco
CAPRA	capra
CAPYN	acapulco
CARD	bacardi
CARLTN	carlton
CARLTVN	carlton
CARLVT	carl
CARLY	carly
CARLYH	carly
CARLYN	carly
CARLZ	carl
CARNG	carangelo
CARTVN	cartaxo
CARYK	cary
CAS	africas
CASMZ	africas
CASTYN	augustyn
CATANY	catanzaro
CAV	cavasin
CAVDA	chavda
CAVHAN	hovhaness
CAVN	avniel
CAVVYN	cavasin
CAVVYV	cavasin
CAVZ	cavasin
CAY	biscay
CAYKN	biscay
CAYLD	ayling
CAYLDZ	ayling
CAYZ	biscay
CH	aachen
CKRD	ackroyd
CLATVN	latvia
CLYVS	clyde
CLYYAN	abyan
CMALY	chemaly
CMBRLYN	charlyn
CMBRZ	alhambra
CMBZY	abercrombie
CNADR	adri
CN	macneil
CND	abend
CNDLR	braendle
CNSLVR	ansley
CNTH	anantha
CNY	albany
CPDY	addy
CPZ	leipzig
CRAG	accra
CRASKAYNT	nebraska
CRBL	kuperblum
CRC	abercrombie
CRCYL	crecy
CRPY	abercrombie
CRSKYNAY	gursky
CRVBYNY	bynon
CRVYC	abercrombie
CRY	apocrypha
CRY	apocrypha
CRYL	apocrypha
CRYSKYNTY	crystal
CRYSTAL	crystal
CRYSYNTH	crystal
CSBRV	asbrink
CS	acs
CSNY	chesny
CSNY	chesny
CSTR	abstract
CTAL	actaeon
CT	abstract
CTVYN	kevyn
CVA	akhmatova
CVA	akhmatova
CV	macvoy
CV	macvoy
CV	macvoy
CV	macvoy
CV	macvoy
CVDHARY	choudhary
CVKRY	conakry
CVKSY	addicks
CVLKA	alkabeer
CVN	avniel
CVNPYG	pygmalion
CVRN	abernathy
CVSAK	adisak
CVVANAK	chovanak
CVY	chevy
CVY	chevy
CVYLR	abdalrahman
CYA	aaliyah
CYA	aaliyah
CYAKY	kayak
CYANG	guiyang
CYBANSKY	cybanski
CY	alcyone
CY	alcyone
CYCSTR	abstract
CYK	alcyone
CYK	alcyone
CYK	alcyone
CYKN	alcyone
CYKRY	conakry
CYKY	alcyone
CYKZ	alcyone
CYLDZ	cyliax
CYLT	cyliax
CYLTH	althea
CYLTJ	heyltje
CYLTJH	heyltje
CYLY	bayly
CYLYJH	bayly
CYLYNGVRS	marylynn
CYLYNGVRT	marylynn
CYM	cymbeline
CYN	chrescyntie
CYN	chrescyntie
CYNN	brynner
CYNV	chrescyntie
CYP	cyprian
CYP	cyprian
CYPLVYDN	cyprian
CYPMN	cyprian
CYPN	cyprian
CYRAG	cyrano
CYRAK	cyrano
CYSM	clancys
CYSMN	clancys
CYSTY	amethysta
CYSVLM	clancys
CYTA	maytag
CYTAM	altamira
CYTAN	afghanistan
CYT	scythia
CYT	scythia
CYTRDY	chitrady
CYTVVD	scythia
CYTVYN	kevyn
CYTYK	scythia
CYV	alcyone
CYV	alcyone
CYZVBA	aabar
CYZV	alcyone
CYZVRV	alcyone
DABAC	ahmadabad
DABAS	ahmadabad
DABL	ablation
DABNY	dabney
DABS	absalom
DABSVN	absalom
DABVS	adab
DABVYS	abbys
DABYL	babylon
DABYNSKY	bilinsky
DABYNSN	dobyns
DABYNSVN	dobyns
DABYNZ	abyan
DADA	dada
DAD	baghdad
DADGYVN	adgeringelant
DADH	adhara
DADK	adkins
DADLY	bradly
DADS	baghdads
D'A	a
DADV	advent
DADYR	dady
DAF	qaddafi
DAGAN	dagan
DAGAN	dagan
DAG	akdag
DAG	akdag
DAG	akdag
DAGLY	dagley
DAGN	dagnall
DAGR	agra
DAGRTY	agra
DAGRZ	agra
DAGVAC	akdag
DAGZ	akdag
DAHAK	dahar
DAHAML	abraham
DAHN	dahar
DAHRTY	flaherty
DAHVD	dahar
DAHVK	dahar
DAJ	hidajat
DAJ	hidajat
DAJYVN	hidajat
DAKAS	dakar
DAK	dakar
DAK	dakar
DAK	dakar
DAKHVRN	akhmatova
DAKLVZ	akl
DAKMN	akman
DAKN	dakar
DAKRYNG	conakry
DAKS	adirondacks
DAKS	adirondacks
DAKTRZ	dakar
DAKV	dakar
DAKVRS	dakars
DAKYNG	dakar
DAKYNZ	dakar
DAKZ	dakar
DALAJR	guadalajara
DALAN	alan
DALAS	alaska
DALAYR	mandalay
DALBK	dalbec
DALBRGR	albright
DALBYR	dalbec
DAL	abdalmalik
DAL	abdalmalik
DAL	abdalmalik
DALFR	alfred
DALMN	abdalmalik
DALMS	abdalmalik
DALMYYA	abdalmalik
DALNZ	abdalmalik
DALRS	abdalrahman
DALRYMPL	dalrymple
DALTVN	dalton
DALY	daly
DALY	daly
DALY	daly
DALY	daly
DALYNAR	daly
DALYNGR	daly
DAMAR	amara
DAMBL	ambler
DAMLR	abdalrahman
DAMPLTVN	champlain
DAMVN	adam
DAMVNTT	adam
DAMYAN	andaman
DAMYANV	andaman
DAMYLA	mylar
DAMYNGS	adam
DAMYNY	adam
DAMYNYKAS	tanganyikas
DAMYTRV	adam
DAMYVN	adam
DANA	adana
DANALD	danald
DANA	adana
DANAVAN	adana
DAN	adan
DANDAS	amandas
DAN	adan
DAN	adan
DAN	adan
DANDY	andy
DANFRD	cranford
DANFY	adan
DANG	dangel
DANG	dangel
DANGTAY	byungtae
DANGVY	dangel
DANGYV	dangel
DANGYVN	dangel
DANHAM	denham
DANH	adan
DANJL	adan
DANKAN	ankara
DANKV	danko
DANKV	danko
DANKY	danko
DANLVP	adan
DANLY	adan
DANNBARGR	danenbarger
DANNLY	dannie
DANR	adan
DANSMVR	adans
DANSTR	adans
DANSY	adans
DANSYNG	adans
DANTN	dante
DANVAN	jordanian
DANY	adan
DANY	adan
DANYDYN	adan
DANYL	adan
DANYL	adan
DANYL	adan
DANYLSVN	daryls
DANYLV	transylvania
DANYLZ	adan
DANYS	albanys
DANYYLS	adan
DANZ	danz
DAPAY	bodapati
DAPNYK	bodapati
DAPRK	apr
DAPRRY	darryl
DAPRY	apr
DARANG	carangelo
DARA	edara
DARBY	darby
DAR	adar
DARHAM	parham
DARL	darla
DARLY	baggarly
DARLYNGTN	darlington
DARNAL	darnall
DARNL	darnall
DARNL	darnall
DART	bainmedart
DARV	darvon
DARVN	darvon
DARYGVS	daryl
DARYL	daryl
DAS	adas
DAS	adas
DASN	adas
DASVN	adas
DASYNG	synge
DASYVK	adas
DAT	datri
DATH	abernathy
DATJH	daatje
DATRY	datri
DATSVN	arafats
DATVN	datri
DATVYT	datri
DATY	almaty
DATY	almaty
DAVAD	davao
DAVARK	bavaria
DAVBR	cadaver
DAVD	cadaver
DAVD	cadaver
DAVD	cadaver
DAV	cadaver
DAV	cadaver
DAV	cadaver
DAVKNYZ	cadaver
DAVKYNZ	cadaver
DAVN	avniel
DAVNPRT	davenport
DAVNY	avniel
DAVNYNG	avniel
DAVNYNG	avniel
DAVRS	adars
DAVRYN	avery
DAVSAN	alagesan
DAVS	avs
DAVSN	avs
DAVSVN	avs
DAVT	cadaver
DAVVD	cadaver
DAVVD	cadaver
DAYAL	ayala
DAYAN	hadaya
DAYAN	hadaya
DAYANYSYA	albanys
DAYANYSYS	albanys
DAYAZ	hadaya
DAYBALA	ayala
DAYBL	byblos
DAYCYNC	ayckbourn
DAY	day
DAY	day
DAYDRYC	hudaydah
DAY	day
DAYK	day
DAYKSVN	adirondacks
DAYKY	day
DAYKYNK	day
DAYKYNZ	day
DAYLAYGAN	bayla
DAYLVN	ayling
DAYMND	raymond
DAYN	ayn
DAYN	ayn
DAYR	dayr
DAYRDRYK	dayr
DAYR	dayr
DAYRKTVR	dayr
DAYRT	dayr
DAYS	domesdays
DAYT	dayton
DAYVD	day
DAYVRJH	day
DAYVRJH	day
DAYVRT	day
DAYVRTH	alsworth
DAYVRTJ	day
DAYVRTJ	day
DAYVRYA	arya
DAYVVN	day
DAYVYN	davy
DBATVNYA	latonya
DBLR	abdalrahman
DBYT	kidby
DDFYLD	addams
DDJN	goddijn
DDRYK	badry
DDY	addy
DFRVY	godfrey
DGLY	gillogly
DGRAF	degraff
DGRF	lindgren
DGRLVND	borland
DGVTARDY	bastard
DHA	abudhabi
DHAMAR	dhamar
DHNR	abudhabi
DHNRT	dehnert
DHVK	abudhabi
DJAMYLA	djamila
DJLY	abidjan
DKAN	afrikaner
DKK	adkins
DKLRK	abdalrahman
DKR	ackroyd
DKSTR	dijkstra
DKYAH	aaliyah
DKY	adkins
DK	adkins
DLAL	badlands
DLANY	badlands
DL	adler
DLH	adelheid
DLMAN	allman
DLNY	nadolny
DLRD	abdalrahman
DLRYV	dalrymple
DLTN	keltner
DLTVVYA	divya
DLVRA	alvarado
DLVRYZ	calvary
DLVYS	ogilvys
DLY	bradly
DLYKATNY	delikatny
DLYS	bradlys
DLYSYV	bradlys
DMA	bodman
DMA	bodman
DMKAK	kaki
DMKH	admiral
DML	admiral
DMLR	abdalrahman
DMN	admiral
DMPSTR	dempster
DMR	admiral
DMRZ	admiral
DMSQ	abrahams
DMYLA	mylar
DMYNYSVS	albanys
DMYS	amys
DNALD	aguinaldo
DNAQY	adnams
DNAVLT	adnams
DN	adnams
DNDLR	braendle
DN	adnams
DNDRYJ	landry
DNG	addington
DNHAM	denham
DNJVR	adnams
DNKVALTR	aaltruide
DNKYND	belenky
DNL	adnams
DNMN	adnams
DNNL	adnams
DNRYJ	freemasonry
DNSR	haydns
DNTVN	accenture
DNV	adnams
DNVKS	addicks
DNYH	kolodny
DNYL	kolodny
DNYLZ	kolodny
DNYNG	conyne
DNYS	albanys
DNYSVN	albanys
DRABK	drabek
DRADR	drader
DRAGAN	dragan
DRAGANYS	dragan
DRAGN	chandragupta
DRAGR	chandragupta
DRAKMN	badrak
DRAL	dralle
DRALT	dralle
DRAMATYS	dramatis
DRAM	dramamine
DRAP	draper
DRAPR	draper
DRAST	alejandras
DRATMN	dratman
DRATY	dratman
DRAVN	dravidian
DRAVR	dravidian
DRAYNH	rayner
DRAYR	airay
DRBS	herbsleb
DRBY	darby
DRCMN	abercrombie
DRDH	fordham
DRG	aberg
DRGVMYR	chernomyrdin
DRGVN	aberg
DRGVNS	bergens
DRK	adri
DRKSL	barksdale
DRMVT	ackerman
DRNAL	bernal
DRNK	drinks
DRNTR	afrocentrism
DRSNR	sadrs
DRTCN	dortchen
DRTH	alsworth
DRV	adri
DRV	adri
DRVDYNG	druding
DRVDYS	andys
DRVMAND	amand
DRVMR	adri
DRVNY	cerveny
DRVNYS	albanys
DRVR	adri
DRVT	adri
DRVYK	adri
DRVYT	adri
DRVZN	adri
DRYDJY	dryden
DRYFVS	badry
DRYJR	badry
DRYK	badry
DRYK	badry
DRYM	badry
DRYMR	badry
DRYMZ	badry
DRYNKS	drinks
DRYNZ	badry
DRYR	badry
DRYRY	badry
DRYS	landrys
DRYSKVL	landrys
DRYSKYL	landrys
DRYV	badry
DRYV	badry
DRYVT	badry
DRYXA	badry
DS	adsett
DSL	beardsley
DSMVLYNZ	allyn
DSMVND	desmond
DSMYT	smythe
DSNVYRZ	adsett
DSRAZYRS	alcatraz
DSRVZYRZ	zyrtec
DSTLY	priestly
DSVTV	adsett
DTLFS	adolfs
DTMN	aernoudt
DTRYJ	coventry
DTS	earnhardts
DTVYLR	abdalrahman
DVA	edvard
DVAK	czechoslovakia
DVALYBAY	lindvall
DVAN	bevan
DVANYR	albany
DVAR	edvard
DVARTH	arthers
DVAYKYNK	edvard
DVBAY	bayard
DVBRATZ	dobbratz
DVBRYDJ	bryde
DVBRYKYN	bryan
DVBRYZ	bryan
DVBSVN	absalom
DVBVYS	chevys
DVBYNSVN	dobyns
DVBYNYN	bynon
DVBYR	byra
DVCARM	carmela
DVCAYLARD	duchaylard
DVCT	abstract
DVCYNC	chrescyntie
DVDA	chavda
DVDAMANY	andaman
DVD	advent
DVDGVN	adgeringelant
DVDJ	abidjan
DVDL	adler
DVDLY	bradly
DV	advent
DV	advent
DVFVR	advent
DVGAN	aganovic
DVGAN	aganovic
DVG	advent
DVGYVN	advent
DVHA	hovhaness
DVHH	advent
DVHRTY	daugherty
DVHVR	advent
DVHYRST	amethysta
DVJN	advent
DVK	advent
DVK	advent
DVLAN	adgeringelant
DVL	advent
DVLKYA	milky
DVLMAN	allman
DVLR	abdalrahman
DVLY	advent
DVLYN	allyn
DVMBA	bombay
DVM	advent
DVM	advent
DVMN	advent
DVMNYKV	advent
DVMYKV	gromyko
DVMYKZ	gromyko
DVMYNGV	ingvar
DVMYNYKAS	tanganyikas
DVMYNYK	jacomyntie
DVMYNYK	jacomyntie
DVMYNYKS	jacomyntie
DVMYNYKYVS	jacomyntie
DVMYNYN	conyne
DVMYNYVS	jacomyntie
DVNACY	anacin
DVNA	dvina
DVNALD	aguinaldo
DVNAT	abernathy
DVNATV	abernathy
DVNATY	abernathy
DVNAY	anay
DVN	advent
DVN	advent
DVNG	addington
DVNHAM	denham
DVNKN	keinknen
DVNLY	heinly
DVNPK	advent
DVNPYK	advent
DVNS	abelsons
DVNTSK	advents
DVNVAN	bevan
DVNYNY	conyne
DVNYS	albanys
DVPALM	depalm
DVPLR	abdalrahman
DVPLT	aaltje
DVPRY	pryor
DVPYVYS	chevys
DVRA	avraham
DVRAND	aurand
DVRAND	aurand
DVRAN	kevran
DVRAN	kevran
DVRAPT	anabaptist
DVRAS	accras
DVRASY	accras
DVRATH	barath
DVRATY	navratilova
DVRAVKS	almoravid
DVRAYA	laxminarayan
DVRAZYV	alcatraz
DVRCAK	arcadia
DVRCN	abercrombie
DVRDAL	ardalich
DVRFMAN	dorfman
DVRHAM	avraham
DVRKN	bjerknes
DVRKYN	parkyn
DVRL	adderley
DVRLD	adderley
DVRMA	ackerman
DVRND	bernd
DVRND	bernd
DVRN	abernathy
DVRN	abernathy
DVRRANS	terrans
DVRST	amherst
DVRSY	forsyth
DVRSY	forsyth
DVRTCN	dortchen
DVRT	advent
DVRTH	alsworth
DVRTJ	dievertje
DVRTJH	dievertje
DVRTVN	advent
DVRTY	daugherty
DVRTY	daugherty
DVRVC	advent
DVRVTY	advent
DVRVYN	kevyn
DVRY	abery
DVRYNDA	lynda
DVRYS	averys
DVRYS	averys
DVRYSVMY	averys
DVS	advent
DVSKV	dnepropetrovsk
DVSN	advent
DVSTALYK	christal
DVSTY	augustyn
DVTA	acosta
DVVAYKYNK	parkyn
DVVL	advent
DVY	advent
DVYKYNK	parkyn
DVYKYNK	parkyn
DVYN	kevyn
DVYNDR	alejandra
DVYNY	kevyn
DVYNYNG	conyne
DVYR	advent
DVYSR	chevys
DVYT	advent
DVYTV	advent
DVYVYR	advent
DVYYKYNK	parkyn
DVZAT	americanization
DVZYYR	advent
DYAB	chelyabinsk
DYA	pandya
DYA	pandya
DYALA	ayala
DYAMANTARAS	diamantaras
DYAMDY	dynamite
DYAMVND	amand
DYANA	guyana
DYAN	abyan
DYAZ	pandya
DYBAT	dyballa
DYBATH	bathsheba
DYBATVNYA	dyballa
DYB	dyballa
DYBL	byblos
DYBT	dyballa
DYBTVNYA	bunyan
DYBV	dyballa
DYBYT	dyballa
DYCYR	cyr
DYDA	ayda
DY	addy
DY	addy
DY	addy
DYDRYSZ	landrys
DYDRYX	badry
DYDYRYCS	bryce
DYGAN	aganovic
DYGAZMN	flygare
DYGH	addy
DYGNARV	ragnar
DYGRAF	degraff
DYGRF	addy
DYGRV	addy
DYGV	addy
DYGVYD	ackroyd
DYKANYNK	afrikaner
DYKAVTY	dykes
DYK	dykes
DYK	dykes
DYKL	dykes
DYKNS	dykins
DYKNZ	dykes
DYKNZ	dykes
DYKSAY	dykes
DYKS	dykes
DYKSN	dykes
DYKSTRA	dijkstra
DYKSVN	dykes
DYKSVN	dykes
DYKV	dykes
DYKV	dykes
DYKY	dykes
DYKY	dykes
DYKYNZ	dykes
'DYL	dylan
DYLAN	dylan
DYLAYR	dylan
DYL	dylan
DYLMA	abdalmalik
DYLN	dylan
DYLNY	dylan
DYLR	dylan
DYLVRS	baylors
DYLY	bayly
DYLY	bayly
DYLYNGR	marylynn
DYLYNGTN	marylynn
DYLYP	bayly
DYLYP	bayly
DYLYV	bayly
DYMAD	ahmad
DYMA	ayman
DYMA	ayman
DYMARS	aymara
DYMARST	marston
DYMARYP	dimaryp
DYMAS	alabamas
DYMASK	maskell
DYM	dymond
DYMN	dymond
DYMRS	dyers
DYMSAK	adisak
DYMVK	dymond
DYMYNG	dymond
DYMYTAR	anntar
DYMYTRY	coventry
DYMYTRYS	coventrys
DYMYTRYV	coventry
DYMYTRYV	coventry
DYMYTRYVS	coventry
DYNA	dyna
DYNA	dyna
DYNA	dyna
DYNAMYT	dynamite
DYNBYM	dyna
DYN	dyna
DYN	dyna
DYN	dyna
DYNG	dyna
DYNGLV	angle
DYNGSVR	slangsvold
DYNGY	dingyi
DYNGY	dingyi
DYNL	dyna
DYNLR	dyna
DYNN	brynner
DYNPYK	dyna
DYNR	dyna
DYNS	boleyns
DYNS	boleyns
DYNSMVR	boleyns
DYNT	chrescyntie
DYNV	dyna
DYNY	dyna
DYNYNGR	congregationalist
DYPAK	dipak
DYPAYVLA	ayala
DYPAYVLV	kayvon
DYPBVY	addy
DYPLD	addy
DYPRSYV	aprs
DYPRTR	bertram
DYPYTRV	pyotr
DYR	addy
DYR	addy
DYR	addy
DYRDRK	byrd
DYRDRYK	badry
DYRK	addy
DYRK	addy
DYRKS	barksdale
DYRVKV	addy
DYRVRTJ	dievertje
DYSANTV	desanto
DYSAV	rysavy
DYSAY	magsaysay
DYS	andys
DYSGY	andys
DYSMVND	andys
DYSNT	andys
DYSTL	amethysta
DYTJY	marytje
DYTMAR	dietmar
DYTR	aaltruide
DYTVRZ	addy
DYTVTALA	atalanta
DYVA	sunnyvale
DYVAKARVNY	divakaruni
DYVANATAN	devanathan
DYVAN	bevan
DYVAR	almudevar
DYVAYN	ayn
DYVAYN	ayn
DYVAYZR	solovay
DYVHA	hovhaness
DYVN	addy
DYVNH	addy
DYVNPK	addy
DYVNYDA	ayda
DYVRT	addy
DYVRT	addy
DYVRTH	alsworth
DYVRTJ	dievertje
DYVRTJH	dievertje
DYVRTJH	dievertje
DYVVSR	addy
DYVYA	divya
DYVY	addy
DYVYD	ackroyd
DYVYD	ackroyd
DYVYD	ackroyd
DYVY	addy
DYVYDSVN	loyds
DYVYDYAN	abyan
DYVYLDH	aldhafra
DYVYS	chevys
DYVYSN	chevys
DYVYSVN	chevys
DYVYT	addy
DYYALA	ayala
DYZNY	addy
DYZR	addy
DYZVN	addy
DZ	budziak
DZGAGNH	desgagne
FABLR	ablation
FABRH	fabre
FABRV	fabre
FABRYS	bryson
FABYANV	abyan
FACS	acs
FAD	fadil
FADL	fadl
FADNBRG	radenburgerabroek
FADVR	advent
FADYLA	dylan
FADYL	brady
'FAF	afaf
FAGAN	fagan
FAGANS	fagans
FAJN	afa
FAJYVAR	almudevar
FAKS	mirfaks
FALCVK	falchuk
FALK	falk
FALKNR	falk
FALKRSVN	falk
FALKV	falk
FALKVNR	falk
FALN	alnilam
FALSAM	balsam
FALTAK	alta
FALTLS	faultless
FALTVN	aaltje
FALVN	alva
FALY	alya
FALYVT	alya
FALZ	alzena
FAMYVS	amy
FANDRYC	fandrich
FANG	bienfang
FANGVS	bienfang
FANTS	brants
FARA	faraday
FARAG	farag
FARAGV	farag
FARAT	ararat
FARKAS	farkas
FARL	farley
FARLY	baggarly
FARMR	farmer
FARSBRG	eversberg
FARST	carstens
FARTK	alfaro
FARVANYA	farwaniyah
FARVANYAH	farwaniyah
FARVGYA	alfaro
FARVK	alfaro
FARVK	alfaro
FARVQ	alfaro
FARVZ	alfaro
FARYD	alfaro
FARY	alfaro
FARYHA	fariha
FARYVR	alfaro
FASBRG	asbrink
FAS	belfast
FAS	belfast
FASL	basle
FATYMA	fatima
FATYS	almatys
FAVAZ	gavazzeni
FAVL	jouravlev
FAVNS	avins
FAVNS	avins
FAVST	avesta
FAVST	avesta
FAVST	avesta
FAVST	avesta
FAVZYA	safavid
FAVZY	safavid
FAVZYYA	fawziyya
FAXRY	colfax
FAYF	beaufays
FAYK	beaufays
FAYLS	ayling
FAYN	fayne
FAYNK	fayne
FAYNLY	fayne
FAYNRTY	fayne
FAYNSTVN	fayne
FAYNTVN	fayne
FAYRBANK	fairbank
FAYRVZ	ayres
FAYT	beaufays
FAYYZ	ayyubid
FAYZA	beaufays
FAYZ	beaufays
FAYZ	beaufays
FAYZL	beaufays
FAZA	azad
FAZ	fazio
FAZL	azlan
FAZYA	fazio
FAZY	fazio
FAZY	fazio
FBRV	abraham
FCNR	breckenridge
FDL	adler
FDR	adri
FDR	adri
FDRL	adderley
FDRMN	ackerman
FDVR	advent
FDYLA	dylan
FDYL	dylan
FHD	archdale
FHT	aechtie
FK	kafka
FLAGLLY	flaglelee
FLAHRTY	flaherty
FLAKYGR	laky
FLARDYNGA	flardinga
FLAT	flat
FLAT	flat
FLAVKA	alaska
FLAY	balaye
FLAYGYR	balaye
FLAYS	barclays
FLDMAN	feldman
FLDMAR	feldmar
FLDMN	feldman
FLDR	aldrich
FLDSPAR	feldspar
FLJ	aeroflot
FLK	aeroflot
FLKYNZ	flynn
FLMR	abdalmalik
FLSTY	ahlstrom
FLTH	althea
FLTJ	aaltje
FLTJH	aaltje
FLTYV	kelty
FLVCH	fluche
FLVDYN	blvd
FLVRA	alvarado
FLVR	aeroflot
FLVR	aeroflot
FLVRK	aeroflot
FLVRNS	alvins
FLVRS	elvers
FLVRY	calvary
FLVRYN	bryn
FLVRZ	aeroflot
FLVT	aeroflot
FLVVRZ	aeroflot
FLVYD	floyd
FLYJH	butterfly
FLYKS	butterfly
FLYKYNGR	butterfly
FLYM	butterfly
FLYMYNG	butterfly
FLYNDRZ	flynn
FLYNT	flynn
FLYNY	flynn
FLYSZ	allyson
FLYVRY	butterfly
FLYZARDV	felizardo
FMMTH	ramthun
FMT	amtrak
FMTJ	wellemtje
FMYA	myanmar
FNCARC	encarta
FNDR	alejandra
FN	elfner
FN	elfner
FNG	addington
FNGR	congregationalist
FNR	breckenridge
FNSKY	bilinsky
FNTVN	accenture
FNTYMAN	ayman
FNVYK	anvers
FNY	albany
FNYS	albanys
FRA	afra
FRAGVRGYA	fragen
FRAM	frame
FRAMSAN	framson
FRAMSVN	framson
FRANDSN	frandsen
FRAN	fran
FRANGAKYS	frangakis
FRANKL	franklin
FRANKL	franklin
FRANKLYN	franklin
FRANKV	frank
FRANKV	frank
FRANKVY	frank
FRANKVYS	frank
FRANKVYZ	frank
FRANS	frans
FRANSR	frans
FRANSSYDTJ	franscyntje
FRANSVYZ	frans
FRANSYKA	frans
FRANSYNTAY	franscyntje
FRANSYNTH	franscyntje
FRANSYNTJH	franscyntje
FRANSYNTY	franscyntje
FRANSYNTYH	franscyntje
FRANSYNTZ	franscyntje
FRANSYSKA	fransiska
FRANSYSKA	fransiska
FRANSYSKAS	fransiska
FRANSYSKVS	fransiska
FRANSYSYVS	frannys
FRANTYSK	frannys
FRANTZN	frantzen
FRAQ	mafraq
FRARY	tipperary
FRASR	fraser
FRAST	fraser
FRASTY	grasty
FRAYDA	ayda
FRAYDMAN	ayman
FRAYDMN	maffray
FRAYDY	maffray
FRAY	maffray
FRAYGRSA	maffray
FRAYTGRSA	fritgersa
FRAZR	frazer
FRAZYR	frazer
FRAZYYR	frazer
FRDA	alfreda
FRDAYNND	friday
FRD	abelard
FRDKYN	fradkin
FRDRKYNG	frederking
FRDRYK	badry
FRDRYK	badry
FRDRYK	badry
FRDRYK	badry
FRDRYKV	badry
FRDT	bernhardt
FRDYA	cordy
FRDY	cordy
FRDY	cordy
FRDYG	cordy
FRG	aberg
FRGT	aberg
FRGVSN	walpurgisnacht
FRH	aelfric
FRJ	aelfric
FRJN	aelfric
FRLANG	borland
FRLY	baggarly
FRM	ackerman
FRNANDS	fernandes
FRNANDV	fernandes
FRNANDZ	fernandes
FRNASYSKAS	alaskas
FRNASYSKAZ	annapurnas
FRNC	france
FRNK	frank
FRNK	frank
FRNKH	blenkhorn
FRNKL	franklin
FRNKL	franklin
FRNKLYN	brooklyn
FRNKSVN	franks
FRNKVYS	chevys
FRNKVYZ	frank
FRNSAYNT	franscyntje
FRNS	barnshaw
FRNSNYT	barnshaw
FRNSNYT	barnshaw
FRNSVYS	guernseys
FRNSYNTY	franscyntje
FRNSYSKA	fransiska
FRNSYSKA	fransiska
FRNZL	anzlovar
FRQ	aelfric
FRR	aelfric
FRSR	frs
FRTYK	daugherty
FRVANYAH	cervantes
FRVANYH	cervantes
FRVK	aelfric
FRVK	aelfric
FRVMYN	jacomyntie
FRVNYAH	aaliyah
FRVZ	aelfric
FRYBRG	charybdis
FRYDA	alfreda
FRYDBRGR	rydberg
FRYD	bryde
FRYDGYR	bryde
FRYDH	bryde
FRYDL	rydland
FRYDMAR	feldmar
FRYDMN	bryde
FRYDMN	bryde
FRYDRYK	badry
FRYDYN	bryde
FRY	fry
FRY	fry
FRYHA	apocrypha
FRYKS	fry
FRYLND	maryland
FRYLYNG	marylynn
FRYLYNGR	marylynn
FRYLZ	beryl
FRYMAL	abdalmalik
FRYMVT	barrymore
FRYNGTVN	addington
FRYNK	bryn
FRYNK	bryn
FRYR	fry
FRYR	fry
FRYRMAT	armato
FRYS	jeffrys
FRYS	jeffrys
FRYS	jeffrys
FRYTAG	maytag
FRYTAS	acostas
FRYT	fry
FRYTGRSA	fritgersa
FRYTN	fry
FRYTS	frits
FRYTV	fry
FRYTVL	fry
FRYTZYVS	fritz
FRYVALD	osvaldo
FRYVVGL	fry
FRYZ	fry
FRYZR	fry
FRYZR	fry
FSDAL	barksdale
FST	hofstadter
FSYG	kosygin
FTC	aftab
FTCN	aftab
FTRA	abstract
FTR	aaltruide
FVD	blvd
FVJY	najya
FVJYTA	maytag
FVJYVKA	afrikaans
FVKV	huckvale
FVLDZ	aguinaldo
FVLGAM	gilgamesh
FVLKANYS	albanys
FVLK	alkabeer
FVLKS	milks
FVLMN	abdalmalik
FVLN	alnilam
FVLR	abdalrahman
FVLR	abdalrahman
FVLY	alelyunas
FVMRTVN	albert
FVNDAL	andalusia
FVNDV	lendvai
FVNGN	brobdingnag
FVNG	addington
FVNKY	belenky
FVNTNVT	zentner
FVN	avniel
FVNYVK	lyubovny
FVRBS	herbsleb
FVRBZ	anderberg
FVRD	abelard
FVRDHAM	fordham
FVRDSANDN	furdesanden
FVRJY	arjuna
FVRK	ark
FVRLANG	borland
FVRMN	ackerman
FVRMN	ackerman
FVRNR	abernathy
FVRNY	czerny
FVRNY	czerny
FVRNYR	czerny
FVRR	aguirre
FVRRV	aguirre
FVRSAYT	anniversary
FVRSAYT	anniversary
FVRSBLAM	forsblom
FVRSBRG	eversberg
FVRS	abners
FVRSYL	forsyth
FVRT	albert
FVRTS	alemberts
FVRY	abery
FVSNG	addington
FVT	yevtushenko
FVTRR	aaltruide
FVTS	abbotsmith
FVTYNVS	augustyn
FVY	chevy
FVYS	chevys
FVYY	aliyyah
FVZARD	felizardo
FVZY	fuzzy
FVZYH	beyhan
FXRYA	arya
FXRY	abery
FXRYYA	aliyyah
FXYR	alexy
FYABAN	brabant
FYAKSY	aksu
FYASKVNARV	askanas
FYBR	abraham
FYDALGV	fidalgo
FYDL	rydland
FYDLR	rydland
FYDVR	ackroyd
'FYF	buffy
FYGARD	asgard
FYGVRA	avraham
FYHAN	beyhan
FYK	boyko
FYKS	addicks
FYLAKS	lakshmi
FYL	aeschylus
FYLK	schuylkill
FYLPAT	alapati
FYL	aeschylus
FYL	aeschylus
FYLPS	alps
FYLR	abdalrahman
FYLVS	pennsylvania
FYLVZ	pennsylvania
FYLYAS	alya
FYLY	bayly
FYLYP	bayly
FYLYPS	bayly
FYLYPS	bayly
FYLZ	aeschylus
FYMTJH	wellemtje
FYMYJH	academy
FYNAN	anand
FYNAN	anand
FYNC	lynch
FYN	allyn
FYN	allyn
FYNK	allyn
FYNKL	bankler
FYNLY	heinly
FYNLY	heinly
FYNLY	heinly
FYNSTAD	finstad
FYNY	albany
FYNYN	conyne
FYNYS	albanys
FY	buffy
FYPS	gypsies
FYRBNKS	fairbanks
FYRBRYN	bryn
FYR	assyria
FYRHRST	fairhurst
FYRMA	ackerman
FYRN	byrne
FYRVDR	adri
FYRVK	apoorva
FYRVZ	apoorva
FYRVZ	apoorva
FYSBYN	buffys
FYS	buffys
FYS	buffys
FYSK	buffys
FYSR	buffys
FYTA	maytag
FYTC	aitcho
FYTZJRALD	emerald
FYTZVL	adametz
FYVR	avraham
FYVSTL	anthistle
FYZA	byzantine
FYZ	allyz
FYZH	allyz
FYZL	allyz
FZYA	aaliyah
GABA	gaba
GABARA	gabara
GABBL	scrabble
GABLR	gable
GABRYLH	gabriel
GABRYLH	gabriel
GABRYYLSVN	gabriel
GABVR	gaba
GABYN	abyan
GACR	gacrux
GADBRY	gadbury
GADBT	gadbois
GADBVRY	gadbury
GADBVYS	gadbois
GADFRVYD	alegado
GADFRY	alegado
GADGL	adgeringelant
GADMN	admiral
GADRV	avogadro
GADSN	gadsden
GADSVARD	edvard
GADVYN	advent
GADY	sagady
GADYJN	sagady
GADYL	sagady
GAF	gaffin
GAF	gaffin
GAFNY	fafnir
GAFRAN	afra
GAFYN	gaffin
GAGNH	desgagne
GAHRTY	gaherty
GAJNH	abigail
GAJR	abigail
GALA	galahad
GALAGHR	gallagher
GALAGR	alagesan
GALAHAD	galahad
GALAN	alan
GALANT	atalanta
GALATYN	galatea
GALAVY	galbavy
GALBAVAY	galbavy
GALC	agali
GALDN	mcdougald
GAL	agali
GAL	agali
GAL	agali
GAL	agali
GALJ	agali
GALKV	galko
GALN	agali
GALP	galpin
GALPYN	galpin
GALT	aaltje
GALV	galvan
GALVLA	galila
GALVSN	galvan
GALVVY	galvan
GALVY	galvan
GALYBRT	galbraith
GALY	agali
GALY	agali
GALY	agali
GALY	agali
GALYLA	galila
GALYLH	agali
GALYLH	agali
GALYTY	agali
GALYVN	agali
GALYZYA	agali
GAMAK	bamako
GAMAL	gamal
GAMBYNV	gambia
GAML	agamemnon
GAML	agamemnon
GAMRV	agamemnon
GAMRVS	agamemnon
GAMVN	agamemnon
GAMYJ	agamemnon
GAMYSH	amys
GANAPATY	ganapathy
GANAR	antananarivo
GANATRA	ganatra
GANAVAN	canaan
GANDLC	chandler
GANDRSVN	michiganders
GANDRZYK	alejandra
GANDVRP	gandhi
GANDY	gandy
GAN	aganovic
GANG	gang
GANG	gang
GANGVLY	gang
GANL	aganovic
GANRVS	zyuganovs
GANS	fagans
GANSVN	evansville
GANTRAM	antaramian
GANTR	gantry
GANTR	gantry
GANTR	gantry
GANTRP	gantry
GANTRT	gantert
GANTVRP	briganti
GANTVRPH	briganti
GANTY	blantyre
GANVN	aganovic
GANVYL	aganovic
GANYR	ganymede
GANYSAN	ganesan
GANZAK	ganzak
GANZALZ	anzalone
GAPTA	anabaptist
GAPYSTY	amethysta
GARADVAN	alvarado
GARAFALV	arafat
GARANS	aldebarans
GARBH	garbe
GARBY	darby
GARDNR	bringardner
GARDYNR	asgard
GARFYLD	garfield
GARFYNKL	garfinkel
GARLYK	baggarly
GARMZ	garms
GARN	garner
GARNR	garner
GARNT	garner
GARNY	garner
GARSKY	carskadon
GARSS	barsse
GARSVL	garshol
GARSYA	garshol
GART	baumgartner
GARTMN	gartmann
GARTRYJ	baumgartner
GARTYN	hegarty
GARVD	garvey
GARVFALV	garofalo
GARVLA	arvola
GARVTV	garvey
GARYK	calgary
GARYK	calgary
GARYS	calgarys
GARYTV	calgary
GASARD	asgard
GAS	agass
GASKAT	saskatchewan
GASKVN	gaskin
GASKVYN	gaskin
GASKVYYN	gaskin
GASKYN	gaskin
GASKYNZ	gaskin
GASLR	agass
GASLR	agass
GASLYK	slyke
GASLYNG	roslyn
GASPAR	gaspar
GASPR	gaspar
GASTA	antofagasta
GASTAVS	antofagasta
GASTAVVS	antofagasta
GASTLAV	eastlake
GASTLV	gastli
GASTYLV	antofagasta
GASTYN	antofagasta
GASTYNYV	antofagasta
GASVL	agass
GASY	malagasy
GASYK	malagasy
GASYNK	malagasy
GATA	yamagata
GAT	agate
GAT	agate
GATHARD	agatha
GATKVMB	agate
GATLYB	gatlin
GATLY	gatlin
GATLYN	gatlin
GATMN	agate
GATMN	agate
GATRYJ	gantry
GATSF	gatsby
GATS	gatsby
GATS	gatsby
GATVYN	agate
GATYS	almatys
GATYZ	agate
GATZ	gatz
GATZVYLR	gatz
GAVAZNY	gavazzeni
GAV	gavazzeni
GAVRD	asgard
GAVR	avraham
GAVTYR	blantyre
GAVYNDAN	breanndan
GAVYND	cavendish
GAVYN	davy
GAYA	gaya
GAYAT	gaya
GAYBS	bugay
GAYDA	gayda
GAYDRY	gayda
GAYDVAL	gayda
GAYDV	gayda
GAYGL	bugay
GAY	bugay
GAYLR	gayle
GAYLVN	gayle
GAYMN	gayman
GAYMVND	gayman
GAYNL	gaynell
GAYNVR	gaynell
GAYNVR	gaynell
GAYR	ayres
GAYT	bugay
GAYVN	bugay
GAYYTZ	ayyubid
GAZK	gaza
GAZMN	gaza
GBY	abby
GDARD	dardanelles
GDBRY	bradbury
GDK	adkins
GDRALT	dralle
GDR	yggdrasil
GDYRA	byra
GDYRH	addy
GDYR	addy
GDYS	andys
GF	bigfoot
GFRAN	fran
GLAS	douglas
GLASKV	alaska
GLASYR	douglas
GLASYYR	douglas
GLATZ	glatz
GLAYR	aglaia
GLDASTYYN	esmeraldas
GLDBRG	goldberg
GLDBRGR	goldberg
GLDFSMAN	geldefsman
GLDFSMN	geldefsman
GLDFVT	goldfoot
GLD	aglaia
GLDKMP	goldkamp
GLDMN	feldman
GLDR	aldrich
GLDYNG	baldington
GLDZMN	agamemnon
GLDZVRSY	forsyth
GLF	adolf
GL	aglaia
GLNDVRF	glandorf
GLN	aglaia
GLRYK	dalrymple
GLS	abduls
GLSYRZ	assyria
GLTR	aaltruide
GLVB	aglaia
GLVJ	aglaia
GLVRYA	arya
GLVVY	aglaia
GLYB	gillogly
GLYC	alyce
GLYCMN	alyce
GLYK	gillogly
GLYKSMN	gillogly
GLYN	glynn
GLYNZ	glynn
GLYSVN	allyson
GLYVS	gillogly
GLYZR	allyz
GMBL	ambler
GMG	almgren
GML	amlak
GML	amlak
GMYJ	pigmy
GNAGY	gnagy
GNKS	armonks
GNVSYS	bekesys
GNYSYLDA	albanys
GNZALS	anzalone
GNZALS	anzalone
GNZALZ	anzalone
GNZALZ	anzalone
GNZ	agndie
GPH	adolph
GPJ	gepje
GRAB	graben
GRABNAR	grabnar
GRABN	grabnar
GRABYNR	araby
GRAD	belgrade
GRAF	degraff
GRAFT	graft
GRAG	agra
GRAGTY	geraghty
GRAHAM	graham
GRAHAM	graham
GRAH	grah
GRAHRNA	grahorna
GRALYN	gralian
GRAMSS	gramsas
GRANBRGR	gran
GRANDASTRVM	grandmaster
GRAND	grand
GRAN	gran
GRANTAM	grantham
GRANT	grant
GRANVYN	granvin
GRANYT	gran
GRANZYV	granzeau
GRARDYN	berardi
GRASKYN	allegras
GRASR	allegras
GRATR	grater
GRAV	graves
GRAV	graves
GRAV	graves
GRAV	graves
GRAYM	gray
GRAYNGR	grainger
GRAYSLDYZ	brays
GRAYSYLD	brays
GRAYVAS	gray
GRAYY	gray
GRAYYNGR	gray
GRAYYV	gray
GRBS	herbsleb
GRBYAH	gharbiyah
GRBYH	darby
GRDAN	bigourdan
GRDN	bringardner
GRDNR	bringardner
GRDY	cordy
GRFYT	agra
GRG	aberg
GRG	aberg
GRG	aberg
GRGVR	aberg
GRGVR	aberg
GRHARD	erhard
GRHART	carhart
GRHART	carhart
GRJVAYSN	amways
GRKV	agra
GRL	adderley
GRLY	baggarly
GRLYK	baggarly
GRMAK	mirmak
GRMBAN	gremban
GRM	ackerman
GRNANDR	fernandes
GRND	bernd
GRNDMSTR	grandmaster
GRNDYDYR	grundy
GRN	abernathy
GRNGR	charng
GRNJR	abernathy
GRNJR	abernathy
GRNLY	granli
GRNSYNG	grensing
GRNT	bernt
GRNVYL	granvin
GRNYCR	ternyck
GRNY	czerny
GRQTY	agra
GRSAPH	gersappe
GRSDVRF	gersdorf
GRS	abners
GRS	abners
GRSLDYS	andys
GRSR	witwatersrand
GRSTL	gerstl
GRSTY	grasty
GRSTYNN	augustyn
GRTA	alberta
GRTCN	dortchen
GRT	agra
GRT	agra
GRTRVD	bertram
GRTRVYD	geertruyd
GRVBY	abby
GRV	agra
GRVGVRY	gregory
GRVHVL	agra
GRVLAYT	clayton
GRVLYT	blyth
GRVM	agra
GRVNR	granroth
GRVNVALD	ragnvald
GRVNYNK	cerveny
GRVS	agra
GRVSJVHAN	grossjohann
GRVSK	dnepropetrovsk
GRVSR	agra
GRVSY	agra
GRVT	agra
GRVT	agra
GRVTHAVS	grothause
GRVVR	agra
GRVVY	agra
GRVYNCM	kevyn
GRVYN	kevyn
GRVYNLND	finland
GRVYNVLD	groenveld
GRYBH	charybdis
GRYBL	byblos
GRYBYH	charybdis
GRYF	abery
GRYF	abery
GRYFR	abery
GRYFR	abery
GRYFR	abery
GRYFY	abery
GRYFYS	buffys
GRYFYTS	abbotsmith
GRYFYTZ	abery
GRYG	bryguy
GRY	abery
GRYGR	bryguy
GRYGVR	bryguy
GRYKV	masaryk
GRYLK	beryl
GRYLNBK	beryl
GRYNBRG	grunberger
GRYNDLY	grindley
GRYNG	bryn
GRYNGH	anghe
GRYN	bryn
GRYNGR	bryn
GRYNHAM	grinham
GRYNJ	bryn
GRYNJR	bryn
GRYNSVN	cathryns
GRYNVALD	ragnvald
GRYNV	bryn
GRYNVP	bryn
GRYNVVD	bryn
GRYNYAS	chaitanyas
GRYNYJ	bryn
GRYPNKRL	apocrypha
GRYR	abery
GRYSAYLD	magsaysay
GRYS	averys
GRYSLD	chrysler
GRYSLDYS	chrysler
GRYSMVR	averys
GRYSR	averys
GRYST	chrystal
GRYSVALD	osvaldo
GRYSVLD	averys
GRYSVN	averys
GRYSYLD	averys
GRYSYLDH	aldhafra
GRYT	marytje
GRYTS	maigrets
GRYTZ	gretzky
GRYTZN	gretzky
GRYTZVN	gretzky
GRYVL	abery
GRYVLYT	blyth
GRYVNVD	abery
GRYYN	marylynn
GRYYNVALD	ragnvald
GRYZLY	grizzly
GRYZVN	ryzman
GSAN	alagesan
GS	ags
GSKVYN	kevyn
GSKVYNH	kevyn
GSKYN	moussorgsky
GSKYNS	moussorgsky
GSKYNZ	moussorgsky
GSTAVVS	gustav
GST	clugston
GSTL	anthistle
GTYS	almatys
GVADA	nevada
GVANG	evangelina
GVAN	bevan
GVAN	bevan
GVANYAV	chaitanya
GVARD	edvard
GVBL	ablation
GVBYN	bynon
GVCAN	african
GVDA	chavda
GVDA	chavda
GVDA	chavda
GVDAL	abdalmalik
GVDARD	dardanelles
GVDATA	gudata
GVDAT	chavda
GVDAYNAF	maynard
GVD	blvd
GVDGR	lindgren
GVDHV	abudhabi
GVDL	adler
GVDMAN	bodman
GVDMN	admiral
GVDNAF	adnams
GVDRAM	dramamine
GVDRAN	chandran
GVDRV	adri
GVDRV	adri
GVDRYC	badry
GVDSN	adsett
GVDSVN	adsett
GVDVYN	kevyn
GVDVYN	kevyn
GVDYNG	dyna
GVDYN	dyna
GVDYR	addy
GVDYVAYN	ayn
GVDYVYN	kevyn
GVGAN	aganovic
GVGR	agra
GVGVAN	bevan
GVHD	archdale
GVH	hovhaness
GVHYN	hynes
GVKYANV	abyan
GVLAND	auckland
GVLAN	adgeringelant
GVLDYNG	baldington
GVL	devlin
GVLSBY	busby
GVLT	aaltje
GVLVMB	abercrombie
GVLY	alelyunas
GVMZ	hamza
GVMZ	hamza
GVNAR	achernar
GVNNA	anna
GVNTVRP	enterprise
GVNVT	anvers
GVNY	lyubovny
GVNZALS	anzalone
GVNZALS	anzalone
GVNZALV	anzalone
GVNZALZ	anzalone
GVPALA	apalachicola
GVPALAN	gopalan
GVPTA	brahmagupta
GVPTH	abbotsmith
GVPVL	devlin
GVPYNAT	abernathy
GVRALAVALA	kalevala
GVRAL	admiral
GVRALP	guralp
GVRAN	kevran
GVRAPARTAP	gurupartap
GVRASPY	rasputin
GVRAV	almoravid
GVRBRG	anderberg
GVRDF	abelard
GVRD	abelard
GVRD	abelard
GVRDN	bringardner
GVRDYN	cordy
GVRGAN	gargantua
GVRGANZ	ganzak
GVR	avraham
GVR	avraham
GVRKY	gorky
GVRL	adderley
GVRLY	baggarly
GVRM	ackerman
GVRMT	ackerman
GVRNAL	bernal
GVRNY	czerny
GVRTVN	albert
GVRV	apoorva
GVRVSAMY	gurusamy
GVRVYTZ	adametz
GVRY	abery
GVRYK	masaryk
GVRYNCM	bryn
GVRYNDR	rynders
GVRYNG	bryn
GVRYNMN	bryn
GVRYS	averys
GVSF	antevs
GVS	antevs
GVSTAV	gustav
GVSTAVS	gustavs
GVSTAVVS	gustav
GVSTLV	anthistle
GVSVL	antevs
GVSVYL	aeschylus
GVSY	antevs
GVTHARD	gotthard
GVTJS	aaltje
GVTLYB	gently
GVTY	almaty
GVTYK	almaty
GVVDGR	lindgren
GVVDYNG	dyna
GVVRD	abelard
GVVVSYS	bekesys
GVVYNDR	alejandra
GVYAT	divya
GVYDV	ackroyd
GVY	chevy
GVYKARYS	barbarys
GVYLAM	alamo
GVYL	aeschylus
GVYL	aeschylus
GVYL	aeschylus
GVYLRMV	abdalrahman
GVYN	kevyn
GVYN	kevyn
GVYVDA	chavda
GVYYDV	ackroyd
GVYYJR	aliyyah
GVYYLYM	bayly
GVYYN	aliyyah
GVZVYTZ	adametz
GYANASY	guyanas
GYAT	guyatt
GYBSN	korzybski
GYBSVN	korzybski
GYBVNY	lyubovny
GYBVNZ	alfonzo
GYBVR	argyle
GYDRY	badry
GYDV	ackroyd
GYDVN	ackroyd
GYDZ	ackroyd
GYFT	aftab
GY	argyle
GYGR	agra
GYJSBRTAS	albertas
GYJSBRTVS	gijsbertus
GYLAGLY	flaglelee
GYLAM	alamo
GYLAM	alamo
GYLBAY	alba
GYLBRT	albert
GYLFRD	aelfric
GYLFVRD	alford
GYL	argyle
GYL	argyle
GYL	argyle
GYL	argyle
GYLMN	argyle
GYLMN	argyle
GYLMR	argyle
GYLN	argyle
GYLNR	argyle
GYLPYN	argyle
GYLR	argyle
GYLRM	argyle
GYLRMV	argyle
GYLRVY	argyle
GYLRY	argyle
GYLSPAY	anspach
GYLSPY	argyle
GYLT	argyle
GYLVT	argyle
GYLYAM	alya
GYLY	argyle
GYLY	argyle
GYLYS	allyson
GYLYS	allyson
GYLYTA	argyle
GYLYZ	allyz
GYLYZ	allyz
GYML	gymer
GYMNV	gymer
GYMNZ	gymer
GYN	allyn
GYNKZ	allyn
GYNSBRG	arensburger
GYNTN	chrescyntie
GYNTVN	chrescyntie
GYPJH	egypt
GYPN	egypt
GYRARD	berardi
GYR	argyle
GYR	argyle
GYRHART	carhart
GYRTRVYD	geertruyd
GYRTSN	alemberts
GYRVLAYT	clayton
GYRVLYT	blyth
GYSBRTVS	asbrink
GYS	egyptologys
GYSH	baryshnikov
GYSYLDA	aldan
GYTARD	bastard
GYT	argyle
GYT	argyle
GYTGY	argyle
GYTLMN	clytemnestra
GYTLYN	allyn
GYTN	argyle
GYTNYK	delikatny
GYTS	egypts
GYTVMR	amran
GYTVND	abend
GYVF	argyle
GYVLYTY	blyth
GYVN	argyle
GYVVANY	albany
GYVVN	argyle
GYVYN	kevyn
GYVZ	argyle
GYYANKVLA	mayank
GYZAV	brazzaville
HABA	allahabad
HABRDR	aberdeen
HABR	abraham
HABR	abraham
HABRKAM	abram
HABRLC	haberlach
HABRMN	haberman
HABRT	habert
HABS	ahabs
HABVRA	habura
HABVRG	aberg
HABYN	abudhabi
HABZ	abudhabi
HACHALTR	arunachalam
HACYNSVN	jaclyns
HACYNZ	catharyn
HACYSVN	confederacys
HADGZ	adgeringelant
HADLND	hadland
HADLSTVN	hadland
HADLY	bradly
HADRAMAT	hadramawt
HADRAMAVT	hadramawt
HADSN	almohads
HADSVN	almohads
HADSVN	almohads
HADVBA	advent
HADYA	hadaya
HADY	almohad
HADYL	almohad
HAFBK	aldhafra
HAFMN	aldhafra
HAFMN	aldhafra
HAFMN	aldhafra
HAFNYLYNG	marylynn
HAFR	aldhafra
HAFSAH	hafsah
HAFS	hafs
HAGA	chagall
HAGAN	hagan
HAGARD	hagar
HAGARD	hagar
HAGDAL	magdaleentje
HAG	carthage
HAGKYNZ	carthage
HAGLR	hagland
HAGLYN	charlyn
HAGMN	carthage
HAGMN	carthage
HAGN	agndie
HAGR	agra
HAGS	ags
HAGSVN	ags
HAGTN	carthage
HAGYN	carthage
HAHTAHA	chattahoochee
HAJ	haj
HAJKYNZ	haj
HAJR	haj
HAJRZ	haj
HAJS	haj
HAJYR	haj
HAJZ	haj
HAKABAY	dhaka
HAKDT	akdag
HAK	aniakchak
HAK	aniakchak
HAKLY	hakluyt
HAKNYS	epiphanys
HAKSA	aniakchaks
HAKSAV	aniakchaks
HAKS	aniakchaks
HAKSL	aniakchaks
HAKSV	aniakchaks
HAKVLYNN	flynn
HAKVYL	aniakchak
HAKY	shakya
HAKYNG	shakya
HALAM	arunachalam
HALAN	nihalani
HALAT	halat
HALDR	haldre
HALFLDR	alfeld
HALGR	shaligram
HAL	arunachalam
HAL	arunachalam
HALKDYS	chalk
HALK	chalk
HALKNR	chalk
HALM	halm
HALMN	halm
HALND	alnilam
HALN	alnilam
HALPYN	halpin
HALR	abdalrahman
HALR	abdalrahman
HALRT	abdalrahman
HALSTD	halsted
HALST	halsted
HALTGRN	alternately
HALTSYNGR	buchalter
HALTVN	buchalter
HALTZ	baltzell
HALVB	alva
HALYBRTVN	mahaly
HALYDY	mahaly
HALYFYLD	mahaly
HALY	mahaly
HALY	mahaly
HALYMN	lymn
HALYVL	mahaly
HALZR	alzena
HAMACY	hamachi
HAMAH	hamah
HAMANS	hamans
HAMANZ	haman
HAMARKVYYST	austhamaren
HAMBYG	alhambra
HAMBYJ	alhambra
HAMD	hamdan
HAMFRY	abraham
HAMFRYZ	abraham
HAMFRYZ	abraham
HAMH	hamhung
HAML	hamlet
HAML	hamlet
HAMMANZ	hammans
HAMNS	hamans
HAMPRYVN	beauchamp
HAMPSAYR	hampshire
HAMPSYR	hampshire
HAMPTVN	hampton
HAMR	hamra
HAMSAYR	ramsay
HAMVND	bahamonde
HAMVNDZ	bahamonde
HAMY	abraham
HAMYL	abraham
HAMYLTN	hamilton
HAMYLTVN	hamilton
HANAFVRD	hannaford
HANA	bacchanalia
HANBVT	dushanbe
HANDL	chandler
HANDRSVN	chandra
HANG	arkhangelsk
HANGRFVRD	arkhangelsk
HAN	afghan
HANKH	cruikshank
HANKLR	bankler
HANKZ	cruikshank
HANSAKR	lufthansa
HANSN	afghans
HANSN	afghans
HANSR	afghans
HANSVN	afghans
HANSVN	afghans
HANT	ashanti
HANTYNGTVN	shantung
HANV	afghan
HANYA	bethany
HANYFA	bethany
HANY	bethany
HANYH	bethany
HANYMN	bethany
HAPKARFT	shankar
HAPKRAFT	kraft
HAPKRFT	chapela
HAPKYNZ	chapela
HAPR	apr
HAPSVN	hapsburg
HARALD	harald
HARALDSN	haraldsen
HARARY	harare
HARATZ	haratz
HARBD	charbray
HARBR	charbray
HARBR	charbray
HARBR	charbray
HARBRN	charbray
HARBRYJ	charbray
HARBVD	charbray
HARBVR	charbray
HARBYG	charbray
HARBYJ	charbray
HARDN	alphard
HARDYMN	hardy
HARDYNG	harding
HARDYN	hardy
HARDYSVN	hardy
HARGRAVZ	hargreaves
HAR	adhara
HARKL	barkley
HARKR	harkcom
HARKVM	harkcom
HARKYN	parkyn
HARKYNZ	parkyn
HARLD	charlemagne
HARLD	charlemagne
HARL	charlemagne
HARLND	harland
HARLN	charlemagne
HARLV	charlemagne
HARMAN	harman
HARMANVS	harman
HARMN	bodhidharma
HARMNVS	bodhidharma
HARMVTV	bodhidharma
HARMZ	bodhidharma
HARNR	charng
HARP	charpentier
HARPR	charpentier
HARPVLD	harpold
HARR	charrick
HARRYG	harry
HARSA	barsai
HARS	chandrasekhars
HARS	chandrasekhars
HARTAG	aphichart
HARTAH	aphichart
HARTFYLD	hartfield
HART	aphichart
HART	aphichart
HARTL	hartlep
HARTLP	hartlep
HARTLY	hartlep
HARTMN	hartman
HARTR	chartres
HARTVL	aphichart
HARTVYL	aphichart
HARTYGAN	hartigan
HARVARD	harvard
HARV	harv
HARVHYSA	haruhisa
HARVLD	harald
HARVL	harv
HARVN	harv
HARVN	harv
HARVNY	harv
HARVY	harv
HARYCN	catharyn
HARYHARAN	hariharan
HARYKN	catharyn
HARYNKAR	catharyn
HARYS	zacharys
HARYSVN	zacharys
HARYV	catharyn
HARYZ	catharyn
HASAKAH	hasakah
HASAL	casals
HASBRVK	hasbro
HASBY	hasbro
HAS	agathas
HAS	agathas
HASKAL	alaska
HASK	haskel
HASKL	haskel
HASKL	haskel
HASKYNZ	haskel
HASLVM	haslum
HASMN	chasms
HAST	chastain
HASTTLR	chastain
HASTVN	chastain
HASTYNGZ	hastings
HASYK	agathas
HATAP	chatane
HATCSVN	hatcher
HATCYNSVN	hatcher
HATCYNZ	hatcher
HATCYSVN	hatcher
HAT	chatane
HATLNDNSYS	holtlandensis
HATLY	alternately
HATM	hatmaker
HATMYKR	hatmaker
HATR	hatrell
HATRL	hatrell
HATVN	chatane
HATVN	chatane
HATVRY	cathryn
HAVARD	havard
HAVDVN	chavda
HAVGTAYLYNG	ayling
HAV	chavda
HAV	chavda
HAV	chavda
HAVK	chavda
HAVK	chavda
HAVKR	chavda
HAVKYN	chavda
HAVKYNZ	chavda
HAVL	chavda
HAVLY	charlyn
HAVLZ	chavda
HAVN	avniel
HAVN	avniel
HAVS	avs
HAVSR	avs
HAVTVN	chavda
HAVTYLYNG	marylynn
HAVTYN	augustyn
HAVVLA	havola
HAVVNN	chavda
HAVY	chavda
HAVYS	cathays
HAYBRD	abhay
HAYBZ	abhay
HAYC	abhay
HAYDAR	ayda
HAYD	hayden
HAYDMN	hayden
HAYDN	haydn
HAYGDAN	gdansk
HAYKY	abhay
HAYLND	duchaylard
HAYLT	duchaylard
HAYLVRD	duchaylard
HAYLY	bayly
HAYM	abhay
HAYNGH	haynes
HAYN	haynes
HAYN	haynes
HAYNLY	haynes
HAYNS	haydns
HAYNS	haydns
HAYNY	haynes
HAYNZ	haynes
HAYNZ	haynes
HAYPLY	abhay
HAYR	abhay
HAYRVNYMVS	abhay
HAYSLVP	cathays
HAYSVN	cathays
HAYTR	ghayth
HAYTS	ghayth
HAYTZ	ghayth
HAYVARD	duchaylard
HAYVKYNSVN	abhay
HAYVKZ	abhay
HAYVL	abhay
HAYZ	abhay
HAYZ	abhay
HAZN	alkhazna
HBNTVN	abner
HBRN	brno
HBRVQ	thoroughbred
HBVRN	mashburn
HBYBA	byblos
HBYBH	byblos
HDAD	baghdad
HDAK	archdale
HDAVY	davy
HDAYA	hadaya
HDAYA	hadaya
HDAYDAH	hudaydah
HD	archdale
HDLND	badlands
HDLND	badlands
HDLVND	badlands
HDLY	bradly
HDRAMAVT	dramamine
HDRAMVT	dramamine
HDRMAT	armato
HDRYK	badry
HDSA	edsall
HDS	fahds
HDYA	pandya
HDYDA	ayda
HDYDH	abudhabi
HDYH	addy
HDYL	dylan
HDYN	dyna
HFRVN	aelfric
HFSA	hafsah
HFSAH	hafsah
HFS	hfs
HFSH	hfs
HGARTY	hegarty
HGLND	berglund
HGTYLYNG	marylynn
HGY	argyle
HGY	argyle
HGYR	argyle
HHMN	abdalrahman
HJR	gujranwala
HJRY	abery
HK	ashkenazim
HKR	ackroyd
HKR	ackroyd
HKSAV	kesavan
HKSV	addicks
HKT	arktiki
HKTVR	arktiki
HKYM	ashkenazim
HKYNG	parkyn
HKZN	alkhazna
HLAB	alabama
HLAL	bilal
HLAN	coghlan
HLAVYN	hlavenka
HLB	ahlstrom
HLBLYNG	helbling
HLBYG	bygden
HLBYNG	albinger
HLD	aguinaldo
HLDN	adnams
HLFMN	helfman
HLGA	algae
HL	ahlstrom
HLKANT	balkan
HLK	ahlstrom
HLLR	allred
HLMN	kuhlmann
HLMN	kuhlmann
HLMNSTAYN	aisenstat
HLMR	kuhlmann
HLMZ	kuhlmann
HLMZ	kuhlmann
HLNA	elnath
HLND	highland
HLNDR	alejandra
HLN	ahlstrom
HLN	ahlstrom
HLR	abdalrahman
HLSTRVM	ahlstrom
HLT	aaltje
HLTLANDNSYS	holtlandensis
HLTLNDNSYS	holtlandensis
HLTVN	aaltje
HLV	ahlstrom
HLVJ	ahlstrom
HLVM	ahlstrom
HLY	ahlstrom
HLY	ahlstrom
HLYNDN	leelynde
HLYVL	ahlstrom
HLZGNG	holzgang
HLZMN	holzman
HMAH	abdalrahman
HMAM	abdalrahman
HMANS	brahmans
HMANZ	abdalrahman
HMAR	abdalrahman
HMBAYJ	bombay
HMBYJ	abby
HMDAN	hamdan
HMD	abdalrahman
HMH	abdalrahman
HML	abdalrahman
HMP	abdalrahman
HMPSAYR	sayre
HMPSR	dempsey
HMRA	amran
HMR	abdalrahman
HMR	abdalrahman
HMR	abdalrahman
HMSTD	amstadt
HMSYRH	assyria
HMYD	abdalrahman
HMYLTN	heyltje
HMYLTVN	heyltje
HMZA	hamza
HMZ	abdalrahman
HMZH	abdalrahman
HNA	behnam
HNA	behnam
HNAN	anand
HNCLYF	clyde
HND	abend
HNDL	braendle
HNDRSN	alcindors
HNDRSVN	alcindors
HNDRYCVZ	landry
HNDRYCY	landry
HNDRYKA	landry
HNDRYKAS	landry
HNDRYK	landry
HNDRYKH	landry
HNDRYKJ	hendrikje
HNDRYKJH	hendrikje
HNDRYKS	hendriks
HNDRYKS	hendriks
HNDRYKS	hendriks
HNDRYKSH	hendriks
HNDRYKSN	hendriks
HNDRYKSVN	hendriks
HNDRYKVS	landry
HNDRYKY	landry
HNDY	andy
HNDZ	wendzel
HN	baryshnikov
HN	baryshnikov
HNJ	banjarmasin
HNJY	banjarmasin
HNKL	bankler
HNKS	armonks
HNL	ainley
HNLY	heinly
HNNFNT	enfant
HNRYK	freemasonry
HNRYT	freemasonry
HNSLY	ansley
HNSN	icahns
HNT	accenture
HNTH	anantha
HNTJ	ariaantje
HNTJH	ariaantje
HNTYG	blantyre
HNYA	chechnya
HNYFA	boukhny
HNYFH	boukhny
HNYGAN	aganovic
HNYG	boukhny
HNY	boukhny
HNY	boukhny
HNYJ	boukhny
HNYK	boukhny
HNYNGSN	kingsnorth
HNY	boukhny
HNZ	alfonzo
HPKRAFT	kraft
HPLR	abdalrahman
HQYR	assyria
HRABY	araby
HRAK	amtrak
HRAN	cochran
HRANYKY	cochran
HRAYZYNG	airay
HRBAYJ	arbanas
HRBRT	barbra
HRBVRT	herbart
HRBYJ	darby
HRDASFYLD	kordas
HRD	abelard
HRD	abelard
HRDSFYLD	herdsfield
HRDZFYLD	abelard
HR	ahriman
HRLAYNDYZ	borland
HRLNDYS	andys
HRLVY	ehrlich
HRLYNDYS	andys
HRMAN	fuhrmann
HRMAN	fuhrmann
HRMAN	fuhrmann
HRMAN	fuhrmann
HRMANS	ahrimans
HRMN	fuhrmann
HRMN	fuhrmann
HRMN	fuhrmann
HRMN	fuhrmann
HRMNVS	fuhrmann
HRMNYVS	fuhrmann
HRMS	armstrong
HRMVSV	fuhrmann
HRMZ	fuhrmann
HRNAKY	pasternak
HRNANDZ	fernandes
HRNDVN	bernd
HRN	abernathy
HRN	abernathy
HRN	abernathy
HRNKR	nkrumah
HRNSBAY	hornsby
HRRA	andorra
HRSFAL	horsfall
HRT	ahriman
HRTLYNG	hertling
HRTVK	ahriman
HRV	ahriman
HRVN	ahriman
HRVNYMVS	cerveny
HRVS	ahriman
HRVY	ahriman
HRYK	cathryn
HRYKN	cathryn
HRYNG	cathryn
HRYNGSAV	beckingsale
HRYS	chrysler
HRYSVN	chrysler
HRYT	cathryn
HRYVL	cathryn
HSAKA	hasakah
HSAKAH	hasakah
HS	aaliyahs
HS	aaliyahs
HSH	bathsheba
HSKAH	skahan
HSKH	aaliyahs
HSMANS	coesmans
HSMNS	autumns
HSNA	cessna
HSN	aaliyahs
HSN	aaliyahs
HST	kazakhstan
HSTR	ruthstrom
HSTYNGZ	augustyn
HSYMANZ	ayman
HSYN	calsyn
HSYN	calsyn
HSYN	calsyn
HSYN	calsyn
HTCR	abercrombie
HTKVKS	addicks
HTRYK	coventry
HTZLR	hetzler
HVADLY	bradly
HVA	heshvan
HVAR	almudevar
HVBR	abraham
HVBRMN	abraham
HVBVRVG	apoorva
HVBVRV	apoorva
HVBVRVQ	apoorva
HVCYNSVN	boleyns
HVDAYDAH	hudaydah
HVDGY	adgeringelant
HVD	blvd
HVDKYNS	adkins
HVDKYNZ	parkyn
HVDSN	adsett
HVDSVN	adsett
HVFGARD	asgard
HVFRD	abelard
HVFRYN	bryn
HVFT	aftab
HVGAN	aganovic
HVGARD	asgard
HVGARD	asgard
HVGARTY	hegarty
HVG	heshvan
HVG	heshvan
HVG	heshvan
HVGLND	berglund
HVGNBVM	agndie
HVGN	agndie
HVGS	ags
HVGTAYLYNG	ayling
HVGTYLYNG	marylynn
HVGV	heshvan
HVGVYN	kevyn
HVHNSVN	brownsville
HV	heshvan
HV	heshvan
HVK	heshvan
HVKN	bjerknes
HVLAND	auckland
HVLDN	adnams
HVLDZVRS	abners
HVL	devlin
HVL	devlin
HVLKAMB	kamb
HVLKNR	faulkner
HVLM	abdalmalik
HVLMN	abdalmalik
HVLMZ	abdalmalik
HVLNDNSYS	pansys
HVLRVYD	holroyd
HVLS	abduls
HVLSTN	ahlstrom
HVLTLNDNSYS	holtlandensis
HVLYMN	lymn
HVLZN	selznick
HVLZVARS	bolivars
HVMAK	bamako
HVM	heshvan
HVM	heshvan
HVMN	agamemnon
HVNG	addington
HVNYGBRG	honigberg
HVP	heshvan
HVP	heshvan
HVPR	apr
HVQTYLYNG	marylynn
HVQYM	ayman
HVRGAN	gargantua
HVRKAN	arkansan
HVRN	abernathy
HVRNR	abernathy
HVRSFVRD	horsford
HVRST	amherst
HVRTMN	dartmoor
HVRTR	bertram
HVRVAT	horvat
HVRVT	apoorva
HVRVVYTZ	adametz
HVRVYTZ	adametz
HVRYGMV	bryguy
HVRYHAN	beyhan
HVRY	abery
HVRYNG	bryn
HVRYV	abery
HVS	antevs
HVSMN	abbotsmith
HVSTVN	austvollen
HVTN	baumgartner
HVVART	havarti
HVVN	avniel
HVVR	avraham
HVYA	divya
HVYBRG	nyberg
HVYD	ackroyd
HVYGN	cygnus
HVYJN	boldwijn
HVYMAN	ayman
HVYNG	kevyn
HVYSR	chevys
HVYT	blyth
HVYTYNK	augustyn
HVYYSKN	abbys
HVZ	heshvan
HYBAX	baxter
HYBRG	khyber
HYBRT	khyber
HYBVRN	khyber
HYCMN	polyhymnia
HYCNS	aureomycins
HYDAJAT	hidajat
HYDLAND	rydland
HYDN	haydn
HYDN	haydn
HYDNR	haydn
HYDR	hydra
HYDRYC	hydra
HYDRYS	hydra
HYFA	mayfair
HYFLR	mayflower
HYFTZ	abernathy
HYGARTY	hegarty
HYGL	abernathy
HYGN	cygnus
HYGRMN	abernathy
HYGVNT	abernathy
'HYH	abernathy
HY	abernathy
HYJDAN	wijdan
HYJMN	polyhymnia
HYKARV	karvinen
HYK	abernathy
HYKMN	polyhymnia
HYKSVN	abernathy
HYKV	abernathy
HYKY	abernathy
HYKY	abernathy
HYLBRY	aeschylus
HYLDBRAND	hildebrand
HYLD	aeschylus
HYL	aeschylus
HYL	aeschylus
HYL	aeschylus
HYL	aeschylus
HYL	aeschylus
HYLKR	aeschylus
HYLMR	aeschylus
HYLNBRND	hillenbrand
HYLND	hyland
HYLND	hyland
HYLNTH	aeschylus
HYLRY	aeschylus
HYLS	aeschylus
HYLSNTYGR	aeschylus
HYLSVN	aeschylus
HYLT	aeschylus
HYLTH	aeschylus
HYLT	aeschylus
HYLTJ	heyltje
HYLTJH	heyltje
HYLTJH	heyltje
HYLTJ	heyltje
HYLTN	aeschylus
HYLYARD	hillyard
HYLY	aeschylus
HYLYRSTYN	augustyn
HYLYS	aeschylus
HYLYTH	blyth
HYLZ	aeschylus
HYM	hyman
HYMN	polyhymnia
HYMN	polyhymnia
HYMSTD	amethysta
HYNCLY	clyde
HYNCY	chauncy
HYND	hynes
HYNDRYKA	landry
HYNGAN	dungane
HYNG	hynes
HYN	hynes
HYNJ	hynes
HYNLY	heinly
HYNR	hynes
HYNS	boleyns
HYNS	boleyns
HYNS	boleyns
HYNSVN	boleyns
HYNTVN	chrescyntie
HYNTZ	bentz
HYNV	hynes
HYNVNN	hynes
HYNVZ	hynes
HYNZ	hynes
HYNZ	hynes
HYNZ	hynes
HYNZ	hynes
HYNZ	hynes
HYPGRYV	hipgrave
HYP	hyperion
HYPS	gypsies
HYRAY	airay
HYRDGN	byrd
HYRD	byrd
HYRLY	baggarly
HYRN	byrne
HYRNH	arnhem
HYRN	byrne
HYRT	myrtle
HYRVNYMAS	nyman
HYRVNYMVS	cerveny
HYRVTA	zephyrus
HYSAN	maysan
HYS	abernathys
HYSKVKS	abernathys
HYSKVT	abernathys
HYSLAP	hyslop
HYSL	hyslop
HYSLVP	hyslop
HYSMANS	tysmans
HYSMNS	tysmans
HYSR	abernathys
HYTN	abernathy
HYTR	aaltruide
HYTR	aaltruide
HYTS	abbotsmith
HYTSVN	huntsville
HYTVN	abernathy
HYTZ	abernathy
HYTZ	abernathy
HYVARD	edvard
HYVGN	hyvonen
HYV	hyvonen
HYVKYNZ	hyvonen
HYVM	hyvonen
HYVNGAN	dungane
HYVNSV	brownsville
HYVVYT	hyvonen
HYVZ	hyvonen
HYVZR	hyvonen
HYYN	abernathy
HYZ	abernathy
HYZMAN	ryzman
HYZMANS	guzmans
HYZMNS	autumns
HYZMNZ	polyhymnia
HYZYMNZ	lymn
HZLTVN	aaltje
HZMNZ	agamemnon
JABJH	jabir
JAB	jabir
JAB	jabir
JAD	ahmadinejad
JAD	ahmadinejad
JAD	ahmadinejad
JAGARD	jagard
JAG	jagard
JAGR	agra
JAGV	jagard
JAHMANH	jahmane
JAHNS	icahns
JAKAMYNTH	cynthia
JAKSVN	kojaks
JAKVAS	akivas
JAKVBH	djakarta
JAKVB	djakarta
JAKVBJH	djakarta
JAKVBJ	djakarta
JAKVBS	jakobsson
JAKVBSVN	jakobsson
JAKVBSVN	jakobsson
JAKVBY	djakarta
JAKVBZ	djakarta
JAKVMYNTAY	jacomyntie
JAKVMYNTYH	jacomyntie
JAKVMYNTY	jacomyntie
JAKVMYT	djakarta
JAKVS	djakarta
JAKVYZ	djakarta
JAKVZ	djakarta
JAKYVZ	djakarta
JALA	jala
JALVNN	alva
JAMVNA	jamuna
JANA	jana
JANARDHAN	janardhan
JANATVN	anathea
JANCS	bojanchev
JANG	bojangles
JANG	bojangles
JANG	bojangles
JANGNYKL	bojangles
JANGR	bojangles
JANGTAYY	bojangles
JAN	abidjan
JAN	abidjan
JAN	abidjan
JAN	abidjan
JANK	abidjan
JANK	abidjan
JANKYNSVN	blankenship
JANSH	abidjans
JANS	abidjans
JANSJH	jansje
JANSJ	jansje
JANSKY	jansky
JANSN	abidjans
JANSN	abidjans
JANSVN	abidjans
JANSVN	abidjans
JANTH	anantha
JANT	abidjan
JANT	abidjan
JANTJ	ariaantje
JANTVJ	abidjan
JANTYH	blantyre
JANVTH	abidjan
JANVT	abidjan
JANVTJH	janotje
JANY	abidjan
JANYKA	tanganyika
JANZ	janzen
JANZ	janzen
JAP	japan
JAPJH	jaepje
JAPJ	jaepje
JARAS	guadalajaras
JARBVT	jarbot
JARDYN	hardy
JARS	adars
JART	aphichart
JARVALA	carvallo
JARVYS	jarvis
JARYTJN	marytje
JASCK	jaschek
JAS	jaschek
JASPR	jasper
JASPRZ	kasprzak
JASTAM	anastacia
JASTAS	anastasia
JASTJH	ojaste
JASTJ	ojaste
JAST	ojaste
JASTJY	ojaste
JASTYH	grasty
JASTYN	augustyn
JASTYN	augustyn
JASTYN	augustyn
JASTYN	augustyn
JASTYS	chasitys
JASVA	jasvinder
JASVYNDR	jasvinder
JATJY	daatje
JATYNDR	jatinder
JAVF	java
JAVYD	davy
JAVYKA	davy
JAVYR	davy
JAYAN	jayan
JAYANT	jayant
JAYARAM	jayaram
JAYN	jayne
JAYN	jayne
JAYNVR	jayne
JAYP	ajay
JBHH	abhay
JBH	abhay
JBYR	byra
JDY	addy
JF	aaltje
JF	aaltje
JFKK	akkad
JFRY	fry
JFRYZ	fry
JHAMANH	haman
JHANG	jhang
JHAN	jhang
JHAR	adhara
JHMANH	abdalrahman
JHRA	bahrain
JKBS	absalom
JK	dijkstra
JKMN	agamemnon
JKMN	agamemnon
JKSVN	dijkstra
JKVBS	absalom
JKVBSVN	absalom
JKVBZ	dijkstra
JKYN	parkyn
JLA	abdulaziz
JLAL	bilal
JL	ajlun
JLJ	ajlun
JLNY	nadolny
JLTH	althea
JLT	aaltje
JLTJH	aaltje
JLVMARK	jelvemark
JMAL	abdalmalik
JMAL	abdalmalik
JMAR	amara
JML	amlak
JML	amlak
JMML	himmler
JMVLA	kevlar
JMYLA	mylar
JMYLAH	lylah
JMYLA	mylar
JMYL	mylar
JMYLH	mylar
JMYLH	mylar
JMYL	mylar
JNAH	anaheim
JNA	wijnand
JNDRYAV	landry
JNDRYC	landry
JNG	addington
JNG	addington
JN	boldwijn
JNK	ankara
JNK	ankara
JNKS	armonks
JNKS	armonks
JNKYNSVN	belenky
JNKZ	ankara
JNT	kristijntje
JNTJS	kristijntje
JNTRY	coventry
JNYFR	nyffeler
JNYKH	akhmatova
JNYK	albany
JNYNGZ	aurangzeb
JNYRV	albany
JNYSYLDA	albanys
JPSN	aesops
JPY	cherepy
JRADA	estrada
JRALD	emerald
JRARD	berardi
JRARD	berardi
JRARDY	berardi
JRGNZ	gorgonzola
JRHARD	erhard
JRMYAS	araguayas
JRMY	academy
JRMYK	gromyko
JRMYS	amys
JRS	jrs
JRSTL	gerstl
JRTRVD	bertram
JRVNYMVS	cerveny
JRVNYVS	cerveny
JRVYS	chevys
JRYNG	bryn
JRYNGR	bryn
JRYTSMA	jorritsma
JRYTY	marytje
JRYTZVN	marytje
JSF	bakersfield
JSPR	hertzsprung
JSTR	abstract
JSTVN	austvollen
JSYKA	psyko
JSYK	psyko
JTRV	aaltruide
JTSAM	jetsam
JVAB	aabar
JVANA	chovanak
JVANDR	vandry
JVANG	evangelina
JVAN	bevan
JVAN	bevan
JVANYTA	albany
JVAV	levavy
JVAY	solovay
JVBAL	anibal
JVBJ	bjerknes
JVB	aabar
JVB	aabar
JVBYN	bynon
JVDAS	pravdas
JVD	blvd
JVDY	addy
JVDY	addy
JVF	aaltje
JVF	aaltje
JVFL	aeroflot
JVGLA	aglaia
JVHANA	bacchanalia
JVHAN	hovhaness
JVHANSN	afghans
JVHANSN	afghans
JVHANSVN	afghans
JVHANSVN	afghans
JVHANSVN	afghans
JVHANY	bethany
JVHANZ	hovhaness
JVHANZ	hovhaness
JVLAY	balaye
JVL	devlin
JVL	devlin
JVLTZ	baltzell
JVLYANTH	anantha
JVLYANTJH	ariaantje
JVLYANTJ	ariaantje
JVLYANT	bryant
JVLYANY	kalyan
JVLYF	alelyunas
JVLY	alelyunas
JVLY	alelyunas
JVLY	alelyunas
JVNAS	adrianas
JVNGAN	dungane
JVNGANZ	dungane
JVN	avniel
JVN	avniel
JVN	avniel
JVNV	anvers
JVNY	lyubovny
JVNYN	conyne
JVNYVR	lyubovny
JVPRV	apoorva
JVRAH	avraham
JVRA	avraham
JVRAN	kevran
JVRAVLV	jouravlev
JVRGNZ	gorgonzola
JVRJ	arjuna
JVRJN	arjuna
JVRJN	arjuna
JVRJYA	najya
JVRJYV	arjuna
JVRK	ark
JVRVYTZ	adametz
JVRY	abery
JVRYNG	bryn
JVRYSMA	tysmans
JVRYTSMA	jorritsma
JVS	antevs
JVSLYN	roslyn
JVSTH	austhamaren
JVSTJ	justje
JVSTY	augustyn
JVSVA	osvaldo
JVSVYG	antevs
JVSYP	sisyphean
JVTLYN	allyn
JVVN	avniel
JVYDYP	ackroyd
JVYNR	kevyn
JVYNR	kevyn
JVYSF	chevys
JVYS	chevys
JVYT	blyth
JVYT	blyth
JVZA	afzal
JVZF	aaltje
JVZFVS	antevs
JVZP	fitzpatrick
JVZY	fuzzy
JVZYH	beyhan
JVZY	fuzzy
JVZY	fuzzy
JYAF	najya
JYA	najya
JYAKVB	kayak
JYAN	abyan
JYANY	abyan
JYAVRDANY	bigourdan
JYBSVN	korzybski
JYBYNS	dobyns
JYGANG	gang
JY	najya
JY	najya
JYJSBRTVS	gijsbertus
JYKMN	agamemnon
JYLAM	alamo
JYLBRT	albert
JYL	aeschylus
JYLT	heyltje
JYLYAN	kalyan
JYLZ	aeschylus
JYM	ayman
JYML	amlak
JYMSVN	abrahams
JYMY	academy
JYMYNY	jacomyntie
JYMZ	ayman
JYMZ	ayman
JYMZ	ayman
JYNAKYRAMAN	janakiraman
JYNG	synge
JYN	allyn
JYN	allyn
JYN	allyn
JYN	allyn
JYN	allyn
JYNS	boleyns
JYNTVN	chrescyntie
JYNYK	albany
JYNZ	alfonzo
JYPH	apocrypha
JYRARDYN	berardi
JYRMASKA	alaska
JYRVSK	dnepropetrovsk
JYSH	baryshnikov
JYS	abbys
JYSR	abbys
JYSTR	abstract
JYSVZ	abbys
JYTA	maytag
JYVK	hyvonen
JYVRDANV	bigourdan
JYVVANY	albany
JYVVYL	aeschylus
JYVYL	aeschylus
JYZAN	byzantine
JYZN	alkhazna
JYZSBRTVS	asbrink
JZYRH	zyrtec
KAB	alkabeer
KABRYLV	abery
KACLYNG	jaclyn
KACV	kacalek
KACVN	kacalek
KACY	confederacy
KACYH	confederacy
KADLASK	adelas
KADMN	admiral
KADMVS	admiral
KADN	adnams
KADRYBYSYK	badry
KADRYKYS	badry
KADV	advent
KADYN	akademik
KAFRY	afra
KAFY	kafka
KAFYN	kafka
KAGBVRN	ashikaga
KAGL	kagle
KAGL	kagle
KAGLYN	glynn
KAGSAL	beckingsale
KAGSVL	ags
KAHAN	kahane
KAHVN	barakah
KAKALK	haleakala
KAKANDS	oaklands
KA	afrikaans
KAKBRYD	bryde
KAKDKAR	kakodkar
KAKRAFT	kraft
KAKRYL	conakry
KAKSHD	bakshee
KAKTVS	kaki
KAKY	kaki
KAKYVLA	kaki
KAKYVR	kaki
KALA	haleakala
KALAFATAS	kalafatas
KALAFVT	kalafatas
KALAHAN	calahan
KALANAN	alana
KALATVR	kalathur
KALBAVT	galbavy
KALB	kalb
KALB	kalb
KALBRYJ	albright
KALBYDA	kalb
KAL	alukal
KALDL	kaldis
KALDVL	kaldis
KALDVL	kaldis
KALDYS	kaldis
KALHYN	unukalhai
KALHYNH	unukalhai
KAL	alukal
KALKAN	kalkan
KALKLASVR	falkland
KALMAN	kalman
KALMN	kalman
KALMN	kalman
KALMYS	kalmyk
KALPAK	kalpak
KALPANA	kalpana
KALPS	alps
KALPYN	kalpak
KALR	abdalrahman
KALRTY	karty
KALRY	dalrymple
KALSGH	kalsow
KALSVN	kalsow
KALSYN	calsyn
KALT	kalt
KALTVN	kalt
KALV	alukal
KALVM	alukal
KALVNLV	alukal
KALVRT	calvert
KALVYN	allyn
KALYA	kalyan
KALYAN	kalyan
KALYANY	kalyan
KALYARV	kalyan
KALY	kalyan
KALYGY	kalyan
KALYLA	kalila
KALYNSAN	rosalyns
KALYNT	kalyan
KALYNZ	kalyan
KALYS	alyson
KALYS	alyson
KALYSYAK	alyson
KALYYVS	kalyan
KAMACV	camacho
KAMALA	kamala
KAMAL	kamal
KAMAMA	camama
KAMAR	amara
KAMAT	kamath
KAMB	kamb
KAMBS	kamb
KAMBYTZ	kamb
KAMBYY	kamb
KAMBZ	kamb
KAMDAR	kamdar
KAMHVLZ	kamholz
KAM	eckam
KAM	eckam
KAML	kamlish
KAMLN	kamlish
KAMLYS	kamlish
KAMN	amna
KAMNS	kamens
KAMPAGNA	campagna
KAMPAR	amparo
KAMPBL	campbell
KAMP	goldkamp
KAMPR	goldkamp
KAMPTVN	ampte
KAMPVS	goldkamp
KAMPYLV	goldkamp
KAMPYVTR	goldkamp
KAMR	amran
KAMRVD	amran
KAMRVN	amran
KAMRVS	amran
KAMSKAYA	kamskaya
KAMSTAK	amstadt
KAMYA	kamiya
KAMYNG	amy
KAMYN	amy
KAMYV	amy
KANAKAKVRN	kanakakorn
KANA	askanas
KANAK	kanak
KANAL	kanal
KANAL	kanal
KANAN	vivekananda
KANAVA	askanas
KANBVY	afrikaner
KAN	afrikaner
KANDAYV	kanda
KANDLY	chandler
KANDV	iskander
KANDVYYT	iskander
KANDY	andy
KANFR	manfred
KANFYLD	afrikaner
KANG	kang
KANG	kang
KANG	kang
KAN	afrikaner
KANKNT	afrikaner
KANLN	afrikaner
KANLY	afrikaner
KANLY	afrikaner
KANN	kannada
KANR	afrikaner
KANRLY	afrikaner
KANRVY	afrikaner
KANSL	alaskans
KANSTABARYS	constabaris
KANSTABV	blanstan
KANTARA	antaramian
KANTH	anantha
KANT	hellekant
KANT	hellekant
KANTRA	antaramian
KANTR	antrosio
KANTRL	antrosio
KANV	afrikaner
KANVRY	vanvranken
KANYA	chaitanya
KANYF	afrikaner
KANYG	afrikaner
KANYNGHAM	bingham
KANYS	albanys
KANYSNA	albanys
KANYTZ	afrikaner
KANYVN	afrikaner
KANZY	kanze
KAPA	kapalka
KAPANGA	kapanga
KAP	kapalka
KAPK	kapalka
KAPLAN	kaplan
KAPLN	kaplan
KAPLYNK	kaplenk
KAPNR	kapner
KAPRAL	kapral
KAPS	kapson
KAPSVN	kapson
KAPVR	kapalka
KAPYLA	kapila
KARABVLVT	karabulut
KARAGR	karaganda
KARAHR	ankara
KARA	ankara
KARANJLV	karan
KARAN	karan
KARARA	ararat
KARASA	ankaras
KARAS	ankaras
KARASKV	ankaras
KARASV	ankaras
KARAYL	karayel
KARBAJAL	carbajal
KARBALA	karbala
KARBN	karbala
KARBVNLY	karbala
KARBVNYA	karbala
KAR	akar
KARDAL	kardal
KARDL	ardley
KARDL	ardley
KARDLYS	ardley
KARDNAS	cardenas
KARDYNALY	cardinali
KARGYL	argyle
KARHART	carhart
KARKARN	arkansan
KARKAS	farkas
KARLAYL	karla
KARL	karl
KARL	karl
KARLKVYST	karl
KARLS	karls
KARLSVN	karls
KARLTVN	carlton
KARLTVN	carlton
KARLVS	karl
KARLVT	karl
KARLYN	charlyn
KARLYN	charlyn
KARMAN	karmann
KARMVDY	carmody
KARMVNA	carmona
KARMYCAYL	karmann
KARN	karn
KARN	karn
KARNLYAN	carnelian
KARNR	karn
KARNRY	karn
KARNYA	karn
KARNY	karn
KARNY	karn
KARNZ	karn
KARP	karp
KARPLAS	karlas
KARPNTR	carpenter
KARPNTYR	blantyre
KARSTNSN	carstens
KARSTNZ	carstens
KARSVN	dakars
KARSVN	dakars
KART	crockart
KARTNR	baumgartner
KARTRAYT	pontchartrain
KARTR	chartres
KARTVYZ	crockart
KARTY	karty
KARTYK	karty
KARTYR	karty
KARTYS	karty
KARVLYN	carolyn
KARVR	karvinen
KARVSV	karvinen
KARVSV	karvinen
KARVYN	karvinen
KARYAGA	karaganda
KARY	karyn
KARY	karyn
KARYDA	kardal
KARYDYAN	karyn
KARYH	karyn
KARYJR	karyn
KARY	karyn
KARYLV	daryl
KARYRA	karras
KARYS	barbarys
KASAK	takasaki
KASAMA	kasama
KASAM	kasama
KASANVVA	casanova
KASARA	asmara
KASAT	kasat
KASGRVH	alaskas
KASL	alaskas
KASLMN	alaskas
KASM	kasmalkar
KASMN	kasmalkar
KASMYCY	kasmalkar
KASNR	alaskas
KASNYR	alaskas
KASPRZAK	kasprzak
KASRTYNV	karty
KASRYL	alaskas
KASTA	anastacia
KASTANV	astana
KASTLV	astley
KASTLV	astley
KASTNR	kastner
KASTNR	kastner
KASTRCM	kasterchem
KASTRGYN	kastrup
KASTR	kastrup
KASTRV	kastrup
KASTRYKAM	kastrup
KASTRYKVM	kastrup
KASTRYVM	kastrup
KASTVL	kast
KASTVRY	kast
KASTY	grasty
KASTYLV	grasty
KASTYN	augustyn
KASVF	alaskas
KASVN	alaskas
KASY	alaskas
KASYNG	synge
KASYNLY	alaskas
KASYNSKY	bilinsky
KASYV	alaskas
KATA	venkata
KATALANV	atalanta
KATAN	atanacio
KATARYN	catharyn
KATB	barakat
KATBRT	barakat
KATCY	saskatchewan
KATKART	patkar
KATL	katleman
KATL	katleman
KATLMN	katleman
KATLR	katleman
KATLYR	katelyn
KATN	delikatny
KATR	katrin
KATRNTJ	katryntje
KATRYJ	katryntje
KATRYJN	katryntje
KATRY	katryntje
KATRYNA	katryntje
KATRYNA	katryntje
KATRYN	katryntje
KATRYN	katryntje
KATRYN	katryntje
KATRYN	katryntje
KATRYN	katryntje
KATRYNTH	katryntje
KATRYNTJH	katryntje
KATRYNTJ	katryntje
KATRYNTY	katryntje
KATVALA	katwala
KATVPYS	barakat
KATY	katy
KATYNG	katryntje
KATZ	katz
KAVASYN	avas
KAVAYY	amitava
KAV	kave
KAV	kave
KAVDLYNG	allyn
KAVDYL	chavda
KAVH	kave
KAVH	kave
KAV	kave
KAVLY	jouravlev
KAVLY	jouravlev
KAVLYNG	allyn
KAVN	avniel
KAVRZ	avraham
KAVS	avs
KAVSTN	kastner
KAVYTA	kavita
KAYA	bakaya
KAYAK	kayak
KAY	bakaya
KAYK	bakaya
KAYLAS	kaylas
KAYL	kayla
KAYN	ayn
KAYN	ayn
KAYNY	ayn
KAYPR	bakaya
KAYRAS	mayras
KAYRD	ayres
KAYRVF	ayres
KAYSR	kayser
KAYT	bakaya
KAYT	bakaya
KAZDAN	kazdan
KAZGRYF	kazakh
KAZMAYR	kazmaier
KAZVHYRV	ghazvanid
KAZVNVZY	ghazvanid
KAZY	kazakh
KAZYR	kazakh
KAZYRR	kazakh
KBAKYAN	bakaya
KBAKYBV	akbar
KBANYS	albanys
KBRG	ekberg
KBR	abraham
KBYR	byra
KBYR	byra
KCNG	addington
KDAVR	akdag
KD	akdag
KDL	adler
KDL	adler
KDR	adri
KDYM	dymond
KDYN	dyna
KDYRA	byra
KDYR	addy
KDYSYA	andys
KDYSYH	andys
KFART	alfaro
KHV	akhmatova
KK	akkad
KLABVRN	claborn
KLAF	auckland
KLAG	alagesan
KLAG	alagesan
KLAGSTVN	langston
KLAK	amlak
KLAMN	klammer
KLAMR	klammer
KLANFYLD	auckland
KLANSY	klans
KLANTVN	adgeringelant
KLARJH	abelard
KLARK	clark
KLARK	clark
KLAR	abelard
KLARTAY	artaxerxes
KLARTH	arthers
KLARTJH	klaartje
KLARTJ	klaartje
KLARTJY	klaartje
KLART	klaartje
KLARTY	hegarty
KLARYJ	hilary
KLASA	kailasa
KLASJ	klassa
KLASJH	klassa
KLASMYR	klansman
KLASN	klassa
KLASNR	klassa
KLAT	klatt
KLATZ	blatz
KLAVDYA	auckland
KLAVDY	auckland
KLAVSY	olavs
KLAVYTR	auckland
KLAYN	auckland
KLAYN	auckland
KLAYR	auckland
KLAYSJ	barclays
KLAYSVN	barclays
KLAYSVN	barclays
KLAYTVN	clayton
KLAZ	klazura
KLAZVRA	klazura
KLAZYNG	klazura
KLBAY	alba
KLB	ackley
KLBRN	albright
KLBVRN	colburn
KLBVRN	colburn
KLBY	colby
KL	ackley
KLDNY	kolodny
KLDVL	ackley
KLDVY	ackley
KLFLT	colfelt
KLKAR	kasmalkar
KL	ackley
KL	ackley
KLMANZ	allman
KLMBV	abdalmalik
KLMN	abdalmalik
KLMP	klemp
KLNFYLD	blumenfeld
KLN	ackley
KLN	ackley
KLNR	ackley
KLRTAY	alberta
KLRTY	daugherty
KLRVS	abdalrahman
KLT	aaltje
KLTN	keltner
KLTNR	keltner
KLVB	ackley
KLVBK	ackley
KLVKYNAS	reynas
KLVLY	ackley
KLVMPNR	clumpner
KLVNFRV	manfred
KLVSN	ackley
KLVTH	abbotsmith
KLVYNN	brooklyn
KLYBR	klyber
KLYBRN	klyber
KLY	brooklyn
KLY	brooklyn
KLYF	brooklyn
KLYFRD	brooklyn
KLYFT	brooklyn
KLYFTVN	brooklyn
KLYK	brooklyn
KLY	brooklyn
KLY	brooklyn
KLYLA	lylah
KLYMR	brooklyn
KLYMVF	brooklyn
KLYNGRVT	brooklyn
KLYNK	brooklyn
KLYN	brooklyn
KLYN	brooklyn
KLYNSVRG	brooklyns
KLYNZ	brooklyn
KLYR	brooklyn
KLYR	brooklyn
KLYR	brooklyn
KLYR	brooklyn
KLYRTYH	brooklyn
KLYS	allyson
KLYSH	allyson
KLYTVN	blyth
KLYVY	brooklyn
KMA	akman
KMAL	abdalmalik
KMAL	abdalmalik
KMBRY	alhambra
KMBS	combs
KMBZ	abercrombie
KMDR	adri
KMFVYS	chevys
KMFYLD	aeschylus
KM	akman
KMKR	ackroyd
KMLLV	zollverein
KMPASTR	astrakhan
KMPBL	campbell
KMP	akman
KMP	akman
KMPR	empranthiri
KMPSTR	dempster
KMPVS	akman
KMPY	akman
KMR	akman
KMR	akman
KMR	akman
KMRVN	akman
KMSPTR	armstrong
KMSTR	armstrong
KMYLAH	lylah
KMYLA	mylar
KMYLH	mylar
KMYR	chernomyrdin
KNAMVRY	adnams
KNAVAY	cannava
KNDAL	andalusia
KNDL	braendle
KNDRYK	landry
KNDV	lendvai
KNDVLF	kandolf
KNDY	andy
KNDYG	andy
KNDY	andy
KNG	kngwarreye
KNG	kngwarreye
KN	bjerknes
KN	bjerknes
KN	bjerknes
KNNYNG	benny
KNPVL	bjerknes
KNRAD	coenradus
KNRAD	coenradus
KNRAD	coenradus
KNRADVS	coenradus
KNRAT	alpheratz
KNRDYNG	cordy
KNR	bjerknes
KNSYNGTV	kensingto
KNTA	almintaqah
KNTARV	anntar
KNVB	anvers
KNVFYNKH	blenkhorn
KNVL	vanvleck
KNY	albany
KNY	albany
KNYKRBKR	ackroyd
KNYNGTVN	addington
KNYN	conyne
KNYSKY	albanys
KNYVN	sunnyvale
KNYVN	sunnyvale
KNZ	alfonzo
KPJH	gepje
KPL	altiplano
KPLY	plyler
KPR	apr
KPRT	albert
KPTAN	toptani
KPYSTRAN	austranten
KRAB	krab
KRA	kraack
KRACLY	heraclitus
KRACLY	heraclitus
KRACN	abstract
KRACR	cracraft
KRAKART	djakarta
KRAKFRD	krakatoa
KRAKFVRD	krakatoa
KRAK	krakatoa
KRAK	krakatoa
KRAKT	krakatoa
KRAMARY	paramaribo
KRAMHVRN	kram
KRAMR	kram
KRANDLMYR	crandlemire
KRANSVYK	transvaal
KRANSVYYK	transvaal
KRANZVYK	carranza
KRAP	arapaho
KRAPR	apr
KRAQTVN	braque
KRARAS	adharas
KRASBY	krasen
KRAS	krasen
KRASN	krasner
KRASYK	krasen
KRATR	krattiger
KRATRZ	krattiger
KRATYGR	krattiger
KRATZR	kratzer
KRAVFVRD	almoravid
KRAVL	jouravlev
KRAVLY	jouravlev
KRAVN	almoravid
KRAVN	almoravid
KRAVSVN	almoravid
KRAY	airay
KRAYDR	ackroyd
KRAYG	airay
KRAYG	airay
KRAYJ	airay
KRAYJ	airay
KRAY	airay
KRAYSVL	brays
KRAZN	alcatraz
KRAZYR	alcatraz
KRBLA	rollerblade
KRBL	kuperblum
KRBSR	herbsleb
KRBTRY	arbitron
KRBVNYL	lyubovny
KRBYT	darby
KRC	abercrombie
KRDAL	ardalich
KRDLA	ardley
KRDL	ardley
KRDRY	badry
KRFT	cockroft
KRFTVN	cockroft
KRG	aberg
KRG	aberg
KRGR	hargreaves
KRGR	hargreaves
KRHANG	arkhangelsk
KRH	ackroyd
KR	ackroyd
KRK	ackroyd
KRKRAFT	kraft
KRKRAFT	kraft
KRLY	baggarly
KRLYVS	baggarly
KRMR	ermrey
KRMYK	gromyko
KRMYT	myth
KRNAY	bernays
KRNFRD	arnfield
KRN	abernathy
KRN	abernathy
KRN	abernathy
KRNL	thornley
KRNLYS	allyson
KRNLYVS	heinly
KRNS	akrons
KRNSVYK	akrons
KRNVL	vanvleck
KRNYZ	czerny
KRNZ	krenz
KRPS	antwerps
KRRAY	murray
KRS	krs
KRS	krs
KRS	krs
KRSKYNTYH	gursky
KRSLYK	slyke
KRSN	krasner
KRSNR	krasner
KRSNR	krasner
KRSNV	krasner
KRSPV	krs
KRST	amherst
KRSTN	amherst
KRSTS	hursts
KRT	ackroyd
KRTLND	cortland
KRTR	bertram
KRTYN	martyn
KRTZR	bartz
KRVASH	chuvash
KRVASZ	delmarvas
KRVB	ackroyd
KRVCFVRD	abelard
KRV	ackroyd
KRVD	ackroyd
KRVG	ackroyd
KRVKFVRD	crockford
KRVK	ackroyd
KRVKN	ackroyd
KRVL	geervliet
KRVM	ackroyd
KRVM	ackroyd
KRVMH	ackroyd
KRVM	ackroyd
KRVM	ackroyd
KRVMN	ackroyd
KRVMR	ackroyd
KRVMY	academy
KRVMYTS	mysts
KRVNHYM	hyman
KRVNY	cerveny
KRVNZ	krenz
KRVPYK	ackroyd
KRVSBY	busby
KRVSCN	kruschen
KRVS	ackroyd
KRVSH	kresh
KRVSN	krasner
KRVSN	krasner
KRVTYV	ackroyd
KRVVD	ackroyd
KRVYL	ackroyd
KRVYN	kevyn
KRVYR	ackroyd
KRVZ	ackroyd
KRVZYR	zyrtec
KRY	conakry
KRYCFYLD	bryce
KRY	conakry
KRYDA	ackroyd
KRYDR	ackroyd
KRYGAN	aganovic
KRYG	bryguy
KRYG	bryguy
KRYGR	bryguy
KRYGR	bryguy
KRY	conakry
KRYK	conakry
KRY	conakry
KRY	conakry
KRYLA	maryland
KRYLAS	kaylas
KRYL	beryl
KRYLYZ	marylynn
KRYM	barrymore
KRYMN	barrymore
KRYN	bryn
KRYN	bryn
KRYN	bryn
KRYNZ	bryn
KRYPYV	apocrypha
KRYQR	conakry
KRYR	conakry
KRYSAN	conakrys
KRYSAYNTAY	santayana
KRYS	conakrys
KRYSC	conakrys
KRYS	conakrys
KRYS	conakrys
KRYSH	baryshnikov
KRYSJH	conakrys
KRYS	conakrys
KRYS	conakrys
KRYSP	conakrys
KRYSPN	conakrys
KRYSPYJN	conakrys
KRYSPYN	conakrys
KRYSSAYNTYH	alyssa
KRYSTA	krystal
KRYSTA	krystal
KRYSTAL	krystal
KRYSTAL	krystal
KRYSTAL	krystal
KRYST	krystal
KRYSTLR	krystal
KRYSTMN	krystal
KRYSTMN	krystal
KRYSTN	krystal
KRYSTR	krystal
KRYSTV	krystal
KRYSTVF	krystal
KRYSTVFR	krystal
KRYSTVFRSVN	krystal
KRYSTVN	krystal
KRYSTVN	krystal
KRYSTYANA	krystal
KRYSTYAN	krystal
KRYSTYAN	krystal
KRYSTYANSN	krystal
KRYSTY	krystal
KRYSTY	krystal
KRYSTYJNTH	kristijntje
KRYSTYJNTJH	kristijntje
KRYSTYJNTJ	kristijntje
KRYSTYNA	krystal
KRYSTYN	krystal
KRYSTYNH	krystal
KRYSTYN	krystal
KRYSTYN	krystal
KRYSTYN	krystal
KRYSTYNTY	christyntie
KRYSVAYJN	conakrys
KRYSVJYN	conakrys
KRYSVYJN	conakrys
KRYSVYN	conakrys
KRYSVZN	conakrys
KRYSY	conakrys
KRYSY	conakrys
KRYSY	conakrys
KRYSZ	conakrys
KRYTR	conakry
KRYVAS	akhmatovas
KRYVASZ	akhmatovas
KRYVN	conakry
KRYVSN	conakry
KRYVVNVZ	conakry
KRYYK	conakry
KRZNA	alkhazna
KSAVAN	kesavan
KSAV	kesavan
KSAY	lindsay
KS	addicks
KSK	addicks
KSKYN	bilinsky
KSL	stockslager
KSL	stockslager
KSLN	stockslager
KSLR	stockslager
KST	blackstone
KSTLAK	eastlake
KSTL	anthistle
KSTLVT	anthistle
KSTNR	blackstone
KSTRAP	dijkstra
KSTR	dijkstra
KSTRCM	dijkstra
KSTRSVN	dijkstra
KSVAN	bevan
KSVN	addicks
KSYDY	sydney
KSYM	syme
KSYM	syme
KTAN	afghanistan
KTARA	antaramian
KTB	arktiki
KTCAM	atacama
KT	arktiki
KT	arktiki
KTLAR	cotlar
KTL	anthistle
KTL	anthistle
KTLT	aaltje
KTLY	gently
KTNZRV	alfonzo
KTSYMATYDS	almaty
KTVLA	kevlar
KTVYN	kevyn
KTY	almaty
KTY	almaty
KTYL	kettyle
KTZ	adametz
KVAAYNTN	paynter
KVAKNBAS	abbas
KVAKNBVS	czechoslovakia
KVA	huckvale
KVAL	huckvale
KVALSYK	calsyn
KVANBAY	anbar
KVANG	evangelina
KVANG	evangelina
KVANG	evangelina
KVAN	bevan
KVANLAN	scanlan
KVANRAD	alvarado
KVANRAD	alvarado
KVANRADT	alvarado
KVANRADVS	alvarado
KVANRDT	vanriper
KVANRYD	vandry
KVANTVN	cervantes
KVARSKY	kovarski
KVARTZYTH	bartz
KVASMAN	tasman
KVAST	sevastopol
KVASYM	akhmatovas
KVATRYN	katryntje
KVAVRYNG	avery
KVAYLYSY	bayly
KVAYMAN	ayman
KVAYNTANA	antanaitis
KVAYNTVN	paynter
KVAYT	clayton
KVBA	aabar
KVB	huckvale
KVB	huckvale
KVBLA	ablation
KVBN	abner
KVBSA	absalom
KVBV	gelbvieh
KVBV	gelbvieh
KVBYB	byblos
KVBYLAH	lylah
KVBYLA	babylon
KVCAR	bacar
KVC	huckvale
KVCRAN	cranach
KVCY	alcyone
KVCYH	alcyone
KVDAMAH	qudamah
KVDAMA	andaman
KVDVGNV	ragnvald
KVDY	addy
KVGANDA	karaganda
KVGLAN	england
KVGLYN	glynn
KVGVMA	abdalmalik
KVHAN	hovhaness
KVHN	baryshnikov
KVJH	huckvale
KVJYAS	araguayas
KVKAL	alukal
KVKALYK	kalmyk
KV	huckvale
KVKBRN	blackburn
KVK	huckvale
KVKFYLD	aeschylus
KVK	huckvale
KVKNBAS	abbas
KVKNJ	banjarmasin
KV	huckvale
KVK	huckvale
KVKRYL	beryl
KVKSVN	addicks
KVKTAVAY	amitava
KVKVNN	adrienne
KVKVRK	ark
KVKYA	shakya
KVLASA	kailasa
KVL	devlin
KVL	devlin
KVLKA	alkabeer
KVLMN	abdalmalik
KVLN	alnilam
KVLN	alnilam
KVLN	alnilam
KVLNV	alnilam
KVLR	abdalrahman
KVLSAR	bulsara
KVLS	abduls
KVLSVN	abduls
KVLT	aaltje
KVLTY	kelty
KVLVL	alva
KVLYCALA	cala
KVLY	alelyunas
KVLY	alelyunas
KVLYHA	beyhan
KVLYN	allyn
KVLYNG	allyn
KVLYNGVVD	allyn
KVLYNS	brooklyns
KVLYNZ	allyn
KVLYR	lyra
KVLYS	allyson
KVMAR	amara
KVMARV	delmarva
KVMBR	alhambra
KVMPTVN	ampte
KVMR	amran
KVMR	amran
KVMVRV	apoorva
KVMVRYTA	chrystal
KVN	avniel
KVNG	addington
KVNG	addington
KVNKA	ankara
KVN	avniel
KVN	avniel
KVNRAD	coenradus
KVNRAD	coenradus
KVNRADVS	coenradus
KVNRAT	alpheratz
KVNRAT	alpheratz
KVNRAYT	airay
KVNRYAT	arya
KVNT	accenture
KVNV	anvers
KVNVPKA	konopka
KVNVR	vanvranken
KVNVVR	anvers
KVNYNG	conyne
KVPJANZ	janzen
KVPJ	gepje
KVP	huckvale
KVPLN	alnilam
KVPLND	copland
KVPLS	abduls
KVPNZ	alfonzo
KVPR	apr
KVPR	apr
KVPS	aesops
KVRADYNY	brady
KVRAM	avram
KVRAN	kevran
KVRAN	kevran
KVRAPATY	koorapaty
KVRBT	abtine
KVRBYN	bynon
KVR	avraham
KVRDAS	kordas
KVRDS	alfords
KVRDYK	cordy
KVRDZ	abelard
KVRKAM	arkansan
KVRKVL	ark
KVRL	adderley
KVRLY	baggarly
KVRN	abernathy
KVRNLH	thornley
KVRNLVS	thornley
KVRNLYS	allyson
KVRNLYVS	heinly
KVRNLYVSN	heinly
KVRNLYZ	allyz
KVRNVAL	panvalkar
KVRNYVL	czerny
KVRNZ	abernathy
KVRP	antwerp
KVRSL	ekerslato
KVRSLV	ekerslato
KVRSN	abners
KVRSTN	amherst
KVRT	albert
KVRTH	alsworth
KVRTL	bartle
KVRTLND	cortland
KVRTLNT	atlanta
KVRTRAYT	bertram
KVRTZ	bartz
KVRVNLA	arvola
KVRVYN	kevyn
KVRYA	arya
KVRY	abery
KVRY	abery
KVRYDVR	bryde
KVRYGAN	aganovic
KVRY	abery
KVRY	abery
KVRYLA	maryland
KVRYL	beryl
KVRZAYN	zaynah
KVSADA	masada
KVSAK	adisak
KVSAY	lindsay
KVSH	abshawe
KVSJH	antevs
KVSJ	antevs
KVSKY	dostoevsky
KVSKYMAKY	dostoevsky
KVSLV	alva
KVSMANS	coesmans
KVSMANZ	bertelsmann
KVSMAS	cosmas
KVSMNS	autumns
KVSNKV	ankara
KVSTA	lovstad
KVSTA	lovstad
KVSTANZA	costanza
KVST	lovstad
KVSTN	castner
KVSTRMN	abstract
KVSTYLV	styles
KVSTYS	dustys
KVSVGH	afghan
KVSYN	calsyn
KVSYRA	syracuse
KVSZ	antevs
KVTA	acosta
KVTCAY	biscay
KVT	huckvale
KVTCY	aitcho
KVTJANZ	cootjans
KVTLA	atlanta
KVTMAYR	mayr
KVTNY	delikatny
KVTRVNYV	cerveny
KVTY	almaty
KVTZ	adametz
KVVAR	almudevar
KVV	huckvale
KVVS	antevs
KVYALSKY	rogalsky
KVYALYK	alya
KVY	chevy
KVYCY	alcyone
KVYK	boyko
KVYKNBAS	abbas
KVYKNBVS	anbar
KVYL	aeschylus
KVYL	aeschylus
KVYL	aeschylus
KVYLYN	marylynn
KVYMN	lymn
KVYN	kevyn
KVYN	kevyn
KVYN	kevyn
KVYN	kevyn
KVYN	kevyn
KVYN	kevyn
KVYN	kevyn
KVYNRAD	coenradus
KVYNRAD	coenradus
KVYNRAD	coenradus
KVYNRAT	alpheratz
KVYNRAYT	airay
KVYNRDVS	kevyn
KVYNRYDVS	bryde
KVYNRYT	freemasonry
KVYNTANA	antanaitis
KVYNTN	chrescyntie
KVYNT	chrescyntie
KVYNTVN	chrescyntie
KVYPR	cyprian
KVYRYN	bryn
KVYSMAN	tysmans
KVYST	amethysta
KVYT	blyth
KVYT	blyth
KVYYKL	ackley
KVYYLYN	marylynn
KVYYMAN	ayman
KVYYMN	lymn
KVYYNLN	ainley
KVYYNTANAR	montanaro
KVYYNTVN	chrescyntie
KVYY	aliyyah
KVYYST	amethysta
KVYYT	aliyyah
KVYYTZ	adametz
KVYZMN	ryzman
KVZN	alkhazna
KVZV	ghazvanid
KVZY	fuzzy
KVZY	fuzzy
KVZYN	allyn
KYALASA	ayalas
KYASVN	araguayas
KYAT	guyatt
KYB	becky
KYBH	abhay
KYBL	byblos
KYBL	byblos
KYBLR	byblos
KYBLR	byblos
KYBV	becky
KYCN	alyce
KYCRV	lycra
KYCYN	chrescyntie
KYD	ackroyd
KYD	ackroyd
KYDL	rydland
KYDRA	hydra
KYF	becky
KYF	becky
KYFR	aelfric
KYFR	aelfric
KYGAN	aganovic
KYGYNZ	kyrgyzstan
KYHL	ahlstrom
KYHV	becky
KYJV	becky
KYKBRD	abelard
KYKBRYD	bryde
KY	becky
KY	becky
KY	becky
KY	becky
KYK	becky
KYKVMA	abdalmalik
KYLAN	boylan
KYLBAY	alba
KYLBRV	albright
KYLBY	colby
KYLBYN	bynon
KYLG	jekyll
KYLGVR	jekyll
KYLH	jekyll
KYLHVRN	engelhorn
KYL	jekyll
KYL	jekyll
KYL	jekyll
KYLPK	jekyll
KYLR	jekyll
KYLR	jekyll
KYLR	jekyll
KYLRMT	jekyll
KYLT	heyltje
KYLY	bayly
KYLYVN	bayly
KYLZ	jekyll
KYMBAL	kimball
KYMBRLY	kimberly
KYMBRY	alhambra
KYM	ayman
KYM	ayman
KYMPA	amparo
KYMV	ayman
KYMVN	avniel
KYMVRA	avraham
KYMZ	ayman
KYNA	dyna
KYNAN	anand
KYNANN	inanna
KYNARD	maynard
KYN	parkyn
KYNCN	lynch
KYNGASTVN	antofagasta
KYNGFAY	kingfai
KYNGRY	congregationalist
KYNGSFVRD	kingsford
KYNGSTVN	kingston
KYNGZTN	aurangzeb
KYNH	parkyn
KYN	parkyn
KYN	parkyn
KYN	parkyn
KYN	parkyn
KYN	parkyn
KYN	parkyn
KYN	parkyn
KYN	parkyn
KYNKNN	keinknen
KYNKYD	belenky
KYNMN	feynman
KYNMN	feynman
KYNRSLY	ekerslato
KYNSLA	queensland
KYNSL	ansley
KYNSMN	boleyns
KYNSVN	boleyns
KYNT	chrescyntie
KYNT	chrescyntie
KYNTL	antley
KYNY	parkyn
KYNY	parkyn
KYNYNY	conyne
KYNYVN	parkyn
KYNZ	parkyn
KYNZMAN	boltzmann
KYNZY	parkyn
KYP	skype
KYP	skype
KYP	skype
KYPLYNG	allyn
KYPYNG	pynchon
KYRA	byra
KYRAN	cyrano
KYRAS	lyras
KYRBAY	arbanas
KYRBY	darby
KYR	kyrgyzstan
KYRK	kyrgyzstan
KYRTA	alberta
KYRTY	daugherty
KYRVN	kyrgyzstan
KYRYL	beryl
KYRYSY	averys
KYSA	beckys
KYS	beckys
KYS	beckys
KYS	beckys
KYS	beckys
KYSLV	beckys
KYSNRVS	beckys
KYSR	beckys
KYSR	beckys
KYSTVFR	amethysta
KYSVN	beckys
KYSY	beckys
KYSYDY	beckys
KYSY	beckys
KYSYNJR	beckys
KYSYN	beckys
KYTAGVCY	maytag
KYTAMVRA	altamira
KYTC	kyte
KYTCN	kyte
KYT	kyte
KYT	kyte
KYT	kyte
KYT	kyte
KYT	kyte
KYTL	kyte
KYTLY	gently
KYTS	kyte
KYTY	kyte
KYTYNG	tyng
KYV	becky
KYVCY	alcyone
KYV	becky
KYVK	becky
KYVKYVLYS	allyson
KYVMR	amran
KYVNG	addington
KYVNG	addington
KYVNG	addington
KYVS	antevs
KYVSMATV	akhmatova
KYVYVALY	sunnyvale
KYVZVN	avniel
KYZR	allyz
KZMNZ	agamemnon
'LAALDYN	alaaldin
LABAT	labatt
LABDN	labdon
LABDVN	labdon
LABKYN	alabama
LABLA	ablation
LABL	ablation
LAB	alabama
LABRAD	labrador
LABRYVLA	labrador
LABSR	skylabs
LABYN	abyan
LACLN	apalachicola
LACNS	alans
LACYNY	lacy
LADASKY	ladasky
LADR	adri
LADRVT	adri
LADVN	advent
LADVVYKA	advent
LADVVYKVS	advent
LADVYG	advent
LADYK	gladys
'LADYN	gladys
LADYVYL	gladys
LAFAM	kalafatas
LAFAVNTYN	kalafatas
LAFGRYN	afghan
LAFVRKAD	afrikaans
LAFY	kalafatas
LAGRLYNG	lagerling
LAGRSTRVM	lagerstrom
LAGVMVRVF	alagesan
LAGVN	alagesan
LAHLMA	lahelma
LAHYJ	abdullah
LAJ	guadalajara
LAJRBRG	anderberg
LAKAY	bakaya
LAKH	akhmatova
LAKLH	akl
LAK	amlak
LAK	amlak
LAK	amlak
LAK	amlak
LAKR	akrill
LAKS	lakshmi
LAKSV	lakshmi
LAKSYN	lakshmi
'LAKVABAH	alaqabah
LAKVTVRH	amlak
LAKVVD	amlak
LAKY	laky
LAKY	laky
LAKYSA	laky
LALKYN	valkyrie
LAL	bilal
LALS	admirals
LALY	laly
LALYT	laly
LAMARK	lamark
LAMASTVS	lamastus
LAMBARD	lambadaris
LAMBARDV	lambadaris
LAMBDA	lambda
LAMBLY	ambler
LAMBRN	lamborn
LAMBRT	lambert
LAMBRVS	lambrecht
LAMBVLY	lamb
LAMBVRN	lamborn
LAMBVRN	lamborn
LAM	alamo
LAM	alamo
LAMPLAYT	champlain
LAMPN	lamp
LAMPY	lamp
LAMPYT	lamp
LAMRS	lamars
LAMVRS	lamars
LAMYKYN	lamykin
LANA	alana
LANDAGR	landahl
LANDASTRVM	yolandas
LANDAYR	landahl
LANDBRG	sandberg
LANDGRN	auckland
LANDGRYN	landry
LANDKVYYST	auckland
LAND	auckland
LANDL	auckland
LAND	auckland
LANDMN	landman
LANDN	auckland
LANDR	landrum
LANDRS	flanders
LANDRVM	landrum
LANDRY	landry
LANDRZ	landrum
LANDYN	andy
LANDYN	andy
LANDYS	andys
LANGDVN	langdon
LANG	elangco
LANG	elangco
LANG	elangco
LANGLY	langland
LANGNZ	langnes
LANGSA	langs
LANGSAV	langs
LANGSTVN	langston
LANGSV	slangsvold
LANGV	elangco
LANGYR	blantyre
LANJ	adgeringelant
LANKA	lanka
LANKART	slankard
LANKSTAF	blanstan
LANKTVN	lankton
LAN	adgeringelant
LAN	adgeringelant
LAN	adgeringelant
LAN	adgeringelant
LANR	adgeringelant
LANR	adgeringelant
LANSDYL	alans
LANSFRD	alans
LANS	alans
LANSTZ	blanstan
LANSYNG	lansing
LANTA	atalanta
LANT	adgeringelant
LANTLVSAMAD	lantlosamade
LANTRMAN	lanterman
LANTZ	lantz
LANTZ	lantz
LANVM	adgeringelant
LANVSY	adgeringelant
LANY	billany
LANY	billany
LANZ	lanz
LAPASV	lapaso
LAP	aesculapius
LAPLAYN	laplace
LAP	aesculapius
LAPVRD	aesculapius
LAPVRS	aesculapius
LAPVRT	laporta
LAPVTA	laputa
LAPVVRS	aesculapius
LAPYDARY	lapidary
LAPYSKV	aesculapius
LARA	clara
LARALY	laralee
LARDYNGA	flardinga
LARJA	abelard
LARJ	abelard
LARN	abelard
LARNS	barnshaw
LARNS	barnshaw
LARSN	aguilars
LARSN	aguilars
LARSVN	aguilars
LARTR	chartres
LARVC	abelard
LARVKVYH	abelard
LARV	abelard
LARVRL	abelard
LARYF	hilary
LARYSA	hilarys
LARYVYR	hilary
LARZ	abelard
LASKALA	alaska
LASKA	alaska
LASKARY	alaska
LASK	alaska
LASKVS	alaska
LAS	adelas
LAS	adelas
LAS	adelas
LASNYK	lasnik
LAST	ballast
LASTRA	lastra
LASTR	lastra
LASTRY	lastra
LASTYNG	augustyn
LASVN	adelas
LASYNGR	synge
LATALA	latala
LATA	latala
LATAM	latala
LATBRY	lathbury
LATBVRY	lathbury
LATKYNZ	platkus
LAT	ablation
LATZ	blatz
LAVANDH	blavatnik
LAVAYN	blavatnik
LAVD	berislav
LAV	berislav
LAV	berislav
LAVLS	yaroslavl
LAVMN	berislav
LAVNKA	hlavenka
LAVNYVS	avniel
LAVRAY	avraham
LAVRNS	laverns
LAVSTAD	lovstad
LAVTN	blavatnik
LAVTVN	berislav
LAVYGNH	lavigne
LAVYN	berislav
LAVYT	berislav
LAVZAK	berislav
LAYAN	malayan
LAYBS	playboy
LAYBZ	playboy
LAYDVYNA	ayda
LAYDYA	ayda
'LAYDYN	ayda
LAYHV	balaye
LAYKZ	balaye
LAY	balaye
LAYL	layla
LAY	balaye
LAYMAK	sulaymaniyah
LAYMB	sulaymaniyah
LAYND	auckland
LAYNG	ayn
LAYN	ayn
LAYN	ayn
LAYRD	abelard
LAYTBRN	clayton
LAYTMN	clayton
LAYTNYNG	clayton
LAYV	balaye
LAYV	balaye
LAYV	balaye
LAYVLY	balaye
LAYVRYTSN	balaye
LAYVSAY	magsaysay
LAYVVY	balaye
LAYVY	balaye
'LAYYN	ayyubid
LAZARA	lazara
LAZARD	lazard
LAZARV	lazar
LBANRD	albania
LBANVRD	albania
LBDAN	abdalmalik
LBDVN	abdalmalik
LBN	abner
LBRYNYDYS	brandys
LBVN	gelbvieh
LBVR	gelbvieh
LBVRT	albert
LCLH	colclasure
LCMN	alcmena
LCMR	alcmena
LCNR	acapulco
LDFVRD	bradford
LDJ	abidjan
LDK	goldkamp
LDVAYDJ	ayda
LDVYK	advent
LF	adolf
LFLR	abdalrahman
LFTVS	oudedelft
LG	algae
LHAN	culhane
LHLH	adelheid
LHMAN	abdalrahman
LHMAN	abdalrahman
LHMN	abdalrahman
LHMN	abdalrahman
LHNRR	adelheid
LHRNTZ	lohrentz
LHRYAN	aryan
LHYJ	abernathy
LHY	abernathy
LJ	lilja
LKAMBR	alhambra
LKRN	abernathy
LKRVS	tsiolkovsky
LKS	milks
LKSN	milks
LKVST	lovstad
LKY	milky
LMBRN	alhambra
LMBRN	alhambra
LMBRT	alembert
LMBVRNH	arnhem
LMBVRN	lamborn
LMBVRN	lamborn
LMBVVRN	abdalmalik
LM	abdalmalik
LMP	abdalmalik
LMPYNG	lamping
LMRZ	abdalmalik
LMVN	abdalmalik
LMYR	palmyra
LNDAHL	landahl
LNDAVR	mandaville
LND	abend
LNDRY	landry
LNDRZ	alejandra
LNDVAY	lendvai
LNDY	andy
LNDYN	andy
LNDYNV	andy
LNDZ	wendzel
LNGLY	angle
LNGLYNG	glynn
LNGMYD	ingmar
LNGMYD	ingmar
LNGSS	billingss
LNGSTN	kingston
LNGSTVN	kingston
LNKY	belenky
LNLVSAMAD	lantlosamade
LNLVZAMYD	amy
LNNDN	breanndan
LNRT	albert
LNS	lincolns
LNSVN	brownsville
LNTLVSAMAD	lantlosamade
LNTLVSAMYD	lantlosamade
LNTYN	augustyn
LPARD	alphard
LPART	malpartida
LPLA	malplaquet
LP	adolph
LPVRS	abners
LPVRTA	alberta
LPVVRS	abners
LRAP	abdalrahman
LRBZ	abdalrahman
LRD	abdalrahman
LRMN	abdalrahman
LSARD	brassard
LSLY	balsley
LSR	abduls
LSR	abduls
LST	ahlstrom
LSYAK	calsyn
LTBRY	bryan
LTJY	aaltje
LTRYJ	aaltruide
LTV	aaltje
LVALAY	balaye
LVATS	blavatsky
LVAYNGH	solvay
LVAYNJ	solvay
LVAYN	solvay
LVBV	alva
LVBVTYN	augustyn
LVBYN	bynon
LVC	alva
LVDMN	blvd
LVDVRF	blvd
LVDVVYKA	blvd
LVDVVYKAS	alaskas
LVDVYJK	blvd
LVDVYKA	blvd
LVDVYKAS	alaskas
LVDVYK	blvd
LVDVYKS	blvd
LVDVYKVS	blvd
LVDVYSVS	blvd
LVFARV	alfaro
LVFASV	belfast
LVFBARV	aabar
LVFR	aelfric
LVFSTRVM	lofstrom
LVGH	afghan
LVGNDRA	alejandra
LVGZ	alva
LVJYK	alva
LVKA	afrikaans
LVKARD	kardal
LVKAS	alaskas
LVK	alva
LVK	alva
LVK	alva
LVK	alva
LVK	alva
LVK	alva
LVKN	alva
LVKS	addicks
LVKSTVN	austvollen
LVKV	alva
LV	alva
LV	alva
LV	alva
LVMAS	alabamas
LVMBARDV	lombard
LVML	alva
LVM	alva
LVMN	agamemnon
LVNAN	anand
LVNAV	benavides
LVNDAN	breanndan
LVND	abend
LVNDVN	lendvai
LVNJ	alva
LVN	alva
LVN	alva
LVNLY	heinly
LVNMV	alva
LVNYG	lyubovny
LVNY	lyubovny
LVNY	lyubovny
LVNY	lyubovny
LVNYNGDAL	bloomingdale
LVNZ	alfonzo
LVNZ	alfonzo
LVPATKYN	lupatkin
LVP	alva
LVPR	alva
LVPRSTY	amherst
LVPYN	pynchon
LVPZ	alva
LVRA	alvarado
LVRA	alvarado
LVRC	abercrombie
LVRD	abelard
LVRJYV	alva
LVRNA	abernathy
LVRN	abernathy
LVRNS	alvins
LVRNT	bernt
LVRNTZN	bentz
LVRNZ	abernathy
LVRNZN	abernathy
LVRNZV	abernathy
LVRNZY	abernathy
LVRTVN	calvert
LVRTY	calvert
LVRY	calvary
LVRY	calvary
LVRY	calvary
LVRY	calvary
LVRY	calvary
LVSANTVS	antevs
LVS	alva
LVS	alva
LVSMVR	abbotsmith
LVSRV	alva
LVSSKV	elviss
LVST	galveston
LVSTR	abstract
LVSTY	augustyn
LVSYH	alva
LVSY	alva
LVSY	alva
LVSY	alva
LVSYTV	forsyth
LVTBG	alva
LVTMPYV	altman
LVTR	aaltruide
LVTYNZ	augustyn
LVTZ	adametz
LVVRA	alvarado
LVVRJAT	lauverjat
LVVT	alva
'LVY	ogilvy
'LVY	ogilvy
LVYD	ogilvy
LVY	ogilvy
LVY	ogilvy
LVYNDN	kevyn
LVYNG	kevyn
LVYN	kevyn
LVYN	kevyn
LVYNSVN	alvins
LVYS	ogilvys
LVYSYLY	ogilvys
LVYSYVR	ogilvys
LVYYNGH	anghe
LVYYNG	ogilvy
LVYYSALY	rosalyn
LVYYZV	ogilvy
LVYZ	ogilvy
LVZANV	anvers
LVZYR	zyrtec
'LYA	alya
'LY	alelyunas
'LYA	alya
'LYA	alya
'LYA	alya
LYA	alya
'LY	alelyunas
'LY	alelyunas
LYAM	alya
LYANG	guiyang
LYANZ	kalyan
LYAV	alya
LYBANNRD	libannord
LYBANVRD	cybanski
LYBCN	klyber
LYBL	byblos
LYBLYT	blyth
LYBMN	klyber
LYBRCAK	arcadia
LYBRG	klyber
LYBRN	brno
LYBRTY	bruty
LYBRYK	bryan
LYBSKAMB	kamb
LYBSN	klyber
LYBVRN	klyber
LYBVYTZ	klyber
LYBYD	klyber
LYBY	klyber
LYCARSVN	carskadon
LYCFYLD	alyce
LYC	alyce
LYCMR	alyce
LYCTN	alyce
LYCVRVYYS	alyce
LYDAL	abdalmalik
LYDA	ayda
LYD	clyde
LYDMAN	bodman
LYDN	clyde
LYDN	clyde
LYDRAK	badrak
LYDRDRAP	draper
LYDRDRP	clyde
LYDRDRVP	clyde
LYDRDVRP	clyde
LYDR	clyde
LYDVR	clyde
LYDVYNA	clyde
LYDYA	clyde
LYDYA	clyde
LYFAYV	beaufays
LYGYV	flygare
LYHY	polyhymnia
LYK	slyke
LYKYVRY	slyke
LYLA	lylah
LYLA	lylah
LYLA	lylah
LY	alelyunas
LYLBK	carlyle
LY	alelyunas
LY	alelyunas
LY	alelyunas
LY	alelyunas
LY	alelyunas
LYLY	lyly
LYLY	lyly
LYLYND	leelynde
LYLYNTAL	antal
'LYMA	hollyman
'LYM	hollyman
'LYMA	hollyman
LYMBAX	baxter
LYMBVRG	baumberger
LYM	hollyman
LYMN	lymn
LYMR	hollyman
LYMYNG	hollyman
'LYN	allyn
LYNAN	alelyunas
LYNARS	maynard
LYNDAL	lynda
LYNDAN	lynda
LYNDBK	leelynde
LYNDBRG	leelynde
LYNDGARD	lindgard
LYNDGRN	leelynde
LYNDHLM	leelynde
LYND	leelynde
LYND	leelynde
LYNDL	leelynde
LYNDL	leelynde
LYNDMN	leelynde
LYNDMN	leelynde
LYNDN	leelynde
LYNDNMVT	leelynde
LYNDR	leelynde
LYNDRMN	leelynde
LYNDRVTS	leelynde
LYNDSY	lynds
LYNDVN	leelynde
LYNDZ	leelynde
LYNDZY	leelynde
LYNGAS	kanchenjungas
LYNGLY	allyn
LYNHAN	moynihan
LYNH	allyn
LYNKH	allyn
LYNK	allyn
LYNKLN	allyn
LYNKVLN	allyn
LYNKVYS	allyn
LYN	allyn
LYN	allyn
LYN	allyn
LYN	allyn
LYN	allyn
LYN	allyn
LYN	allyn
LYNSTRAT	boonstra
LYNVAL	panvalkar
LYNVNN	allyn
LYNVRA	vanvranken
LYPARD	camelopardalis
LYPKYN	parkyn
LYPSKAMB	kamb
LYPSKMB	gypsies
LYPSKM	gypsies
LYPSKVMB	gypsies
LYPSKVMP	gypsies
LYPST	bialystok
LYPYJ	polyphemus
LYR	lyra
LYR	lyra
LYRN	byrne
LYRYKAL	alukal
LYRYK	lyra
LYSBTH	lysbethje
LYSBTJH	lysbethje
LYSBTJ	lysbethje
LYSBTJY	lysbethje
LYSKANV	alaskan
LYSKMB	allyson
LYSKN	allyson
LYSKY	allyson
LYS	allyson
LYSN	allyson
LYSN	allyson
LYSTR	bialystok
LYSTVN	bialystok
LYSVN	allyson
LYSVN	allyson
LYSY	allyson
LYSYN	allyson
LYT	blyth
LYTL	lytle
LYTLTVN	lytle
LYTLY	lytle
LYTMN	clytemnestra
LYTN	blyth
LYTRL	blyth
LYTV	blyth
LYTVN	blyth
LYTVN	blyth
LYTVYN	blyth
LYVA	sunnyvale
LYVANDN	juvander
LYVANDVN	juvander
LYVAYN	ayn
LYVBVNY	lyubovny
LYVH	alelyunas
LYV	alelyunas
LYV	alelyunas
LYV	alelyunas
LYV	alelyunas
LYV	alelyunas
LYVNARD	barnard
LYVNARDV	barnard
LYVNDVN	leelynde
LYVNGVD	ingvar
LYVN	alelyunas
LYVNL	ainley
LYVNSBRY	lounsbery
LYVNVRA	vanvranken
LYVNZ	alelyunas
LYVVH	alelyunas
LYVV	alelyunas
LYVY	alelyunas
LYVYNGSTVN	kingston
LYVYN	kevyn
LYVYN	kevyn
LYVYS	chevys
LYVYV	alelyunas
LYVYVS	alelyunas
LYVYVY	alelyunas
'LYYAH	aliyyah
LYYL	aeschylus
LYYVVH	alelyunas
LYZA	allyz
LYZA	allyz
LYZARD	felizardo
LYZARDZ	felizardo
LYZBTY	allyz
LYZ	allyz
LYZN	allyz
LYZR	allyz
LYZVT	allyz
MABANAG	mabanag
MABAY	islamabad
MABY	abyan
MAC	almach
MACTLD	machteld
MADABA	ahmadabad
MADAKS	ahmadabad
MADJ	smadja
MADLYN	madelyn
MADLYN	madelyn
MADLYN	madelyn
MADN	adnams
MADRVN	madras
MADSN	ahmads
MADVN	advent
MADVRAY	madras
MADYGAN	madigan
MADY	mady
MADYS	gladys
MADYSVN	gladys
MADYV	mady
MAFRY	mafraq
MAFYN	maffray
MAGAGNA	magagna
MAGARD	jagard
MAGDALYNTH	magdaleentje
MAGD	magda
MAGLYRV	magliaro
MAGR	magritte
MAGRVDR	magritte
MAGS	magsaysay
MAGVAYR	magsaysay
MAGVYR	armageddon
MAGYL	magyar
MAHADVAN	mahadevan
MAHAJAN	mahajan
MAHALT	mahala
MAHALY	mahaly
MAHA	maha
MAHAVLT	mahault
MAHTV	mahto
MAHVLT	hamah
MAHVT	hamah
MAJV	maj
MAJY	maj
MAJYV	maj
MAKARAYG	karayel
MAKAYVLY	bakaya
MAKK	akkad
MAKLAQLYN	oakland
MAK	bamako
MAK	bamako
MAK	bamako
MAKRYJ	conakry
MAKSVL	aksu
MAKSY	aksu
MAKSYM	aksu
MAKSYMYLYAN	kalyan
MAKV	bamako
MAKVMBR	alhambra
MAKVNVCY	bamako
MAKVSY	bamako
MAKY	bamako
MAKYNVN	bamako
MAKYRAS	mayras
MAKYSAK	maysan
MAKZYM	bamako
MALAMVD	malamood
MALAN	guatemalan
MALBRG	malberg
MALD	grimaldo
MALDN	grimaldo
MALKVK	kasmalkar
MALKVM	kasmalkar
MALN	malnar
MALNR	malnar
MALRVNY	malraux
MALTYN	malta
MALVN	abdalmalik
MALVNY	abdalmalik
MALYGAN	chemaly
MALYK	chemaly
MAMA	camama
MAMFVRD	stamford
MAMN	amna
MAMRT	amran
MAMY	amy
MANAMA	manama
MANA	mana
MANA	mana
MANBR	manber
MANC	amancio
MANDAL	mandal
MANDA	amanda
MANDAR	mandar
MANDAVYL	mandaville
MANDL	mandl
MANDR	mandrell
MANDY	mandy
MANGAN	mangan
MANGLANY	manglani
MANGR	mangan
MANGYN	mangan
MANJYT	kilimanjaro
MANJYT	kilimanjaro
MANKA	ankara
MANK	abdalrahman
MANKRT	abdalrahman
MANKS	banks
MANKVS	romanovs
MANKY	abdalrahman
MANLY	manley
MANMA	manama
MAN	abdalrahman
MANRV	abdalrahman
MANSN	ahrimans
MANSTR	ahrimans
MANSYL	transylvania
MANSYNGR	ahrimans
MANTA	diamantaras
MANTL	mantle
MANTNZ	bustamante
MANTRAS	diamantaras
MANTVR	bustamante
MANTYKS	blantyre
MANTY	blantyre
MANVLY	vanvleck
MANVLY	vanvleck
MANV	abdalrahman
MANV	abdalrahman
MANV	abdalrahman
MANV	abdalrahman
MANVRY	vanvranken
MANX	manx
MANYJA	germany
MANYKS	germany
MANY	germany
MANY	germany
MANYNG	germany
MANYSKAS	maniskas
MANYS	germanys
MANYT	germany
MANYV	germany
MANZ	abdalrahman
MAPARTYDA	malpartida
MAPLZ	maple
MARALY	amaral
MARANY	kumaran
MARAT	marat
MARAZAS	marazas
MARBAC	marbach
MARBL	marble
MARC	beaumarchais
MARCYNDV	marcy
MARDR	amardeo
MARDVC	amardeo
MARFY	amara
MARGALTA	margaret
MARGALYTY	margaret
MARGANTH	gargantua
MARGANT	gargantua
MARGARTA	margarita
MARGARYTA	margarita
MARGARYTAY	margarita
MARGARYTJH	margaret
MARGARYTJ	margaret
MARGARYTJ	margaret
MARGARYTJY	margaret
MARGARYT	margaret
MARGARYT	margaret
MARGARYT	margaret
MARGARYTY	margaret
MARGLYN	marilyn
MARGRTA	margarita
MARGRYJH	margery
MARGRYTA	margarita
MARGRYTH	margretha
MARGRYTH	margretha
MARGRYTJ	margery
MARGRYTJY	margery
MARGRYT	margery
MARGRYTYH	margery
MARGVLYN	margaret
MARGVLYS	margaret
MARGVLYVKS	margaret
MARJNT	marjorie
MARKHAM	markham
MARKLY	markley
MARK	bismark
MARK	bismark
MARKS	bismarks
MARKSN	bismarks
MARKSTYNR	marksteiner
MARKV	bismark
MARKV	bismark
MARKVM	bismark
MARKVPVLY	bismark
MARKVS	bismark
MARKVS	bismark
MARKVS	bismark
MARKVYT	bismark
MARKVYZA	bismark
MARKVZ	bismark
MARKYL	bismark
MARKY	bismark
MARKYNGTVN	parkyn
MARKYYVS	bismark
MARLA	marla
MARLAT	marlatt
MARL	marla
MARLY	baggarly
MARLYN	charlyn
MAR	amara
MARN	amarnath
MARPL	marple
MARRL	marrakesh
MARSAL	marsala
MARSLA	marsala
MARSL	delmars
MARSLV	delmars
MARSLYNV	marilyn
MARS	delmars
MARS	delmars
MARSTVN	marston
MARSY	delmars
MARTL	martland
MARTLND	martland
MARTN	baumgartner
MARTNTJY	martyntje
MARTYJN	martijn
MARTYJN	martijn
MARTYJNTJH	martijntje
MARTYJNTJY	martijntje
MARTY	marty
MARTY	marty
MARTYNH	martyn
MARTYNJ	martyn
MARTYNJ	martyn
MARTYN	martyn
MARTYN	martyn
MARTYNSN	martyn
MARTYNTH	martyntje
MARTYNTH	martyntje
MARTYNTJH	martyntje
MARTYNTJ	martyntje
MARTYNT	martyntje
MARTYNT	martyntje
MARTYNV	martyn
MARTYNVS	martyn
MARTYNZ	martyn
MARTYNZ	martyn
MARTYNZ	martyn
MARTYZN	marty
MARTYZNTJ	martyntje
MARTZ	martz
MARVAHA	delmarva
MARVCY	delmarva
MARV	delmarva
MARVN	delmarva
MARVN	delmarva
MARVNY	delmarva
MARVYN	delmarva
MARVYN	delmarva
MARVYT	delmarva
MARXAM	marx
MARYA	maryann
MARYANA	maryann
MARYAN	maryann
MARYGANTH	gargantua
MARYGANT	gargantua
MARYH	dimaryp
MARYJH	dimaryp
MARYJH	dimaryp
MARYJKN	dimaryp
MARYJ	dimaryp
MARYJNT	dimaryp
MARYKANDV	maryland
MARYKN	dimaryp
MARYLYN	marylynn
MARY	dimaryp
MARY	dimaryp
MARYN	catharyn
MARYNV	catharyn
MARYSH	baryshnikov
MARYS	marys
MARYSVN	marys
MARYTH	marytje
MARYTH	marytje
MARYTJ	marytje
MARYTJ	marytje
MARYTJY	marytje
MARYTJY	marytje
MARYT	marytje
MARYT	marytje
MARYV	dimaryp
MARYVS	dimaryp
MARYYANY	maryann
MARYZ	dimaryp
MARZK	marz
MARZ	marz
MASAHYRV	masahiro
MASARA	masaru
MASATAKA	masataka
MASATV	masataka
MASAYV	magsaysay
MASBRG	asbrink
MASKARY	baskar
MASKL	maskell
MASK	maskell
MASKYAS	alaskas
MASLD	maslin
MASLLY	maslin
MASNA	masna
MASNA	masna
MASRMN	alabamas
MASTN	castner
MASTYR	grandmaster
MASVN	alabamas
MASYK	alabamas
MASY	alabamas
MASYMV	alabamas
MASYN	alabamas
MATAKV	matako
MATA	mata
MATANA	matana
MATAR	matar
MATAY	mata
MATJKA	matejka
MATLV	matlin
MAT	akhmatova
MATSVDA	matsuda
MATSVMVTV	fermats
MATSVN	fermats
MATVLA	matula
MATV	akhmatova
MATVR	akhmatova
MATVS	akhmatova
MATYNV	almaty
MATYS	almatys
MATYS	almatys
MATYV	almaty
MATYVS	almaty
MAVBAY	bayard
MAVBY	demavend
MAV	demavend
MAV	demavend
MAV	demavend
MAVN	avniel
MAVPYN	demavend
MAVR	avraham
MAVRS	mavers
MAVSR	avs
MAX	lomax
MAYFYLD	mayfair
MAYKLYS	allyson
MAYKLZN	gamay
MAYK	gamay
MAYKN	gamay
MAYKVHN	gamay
MAYKVK	gamay
MAYLN	ayling
MAY	gamay
MAY	gamay
MAYMVN	ayman
MAYNDRT	mandrell
MAYN	maynard
MAYN	maynard
MAYNR	maynard
MAYR	mayr
MAYR	mayr
MAYR	mayr
MAYR	mayr
MAYR	mayr
MAYRN	mayr
MAYRS	ayrshire
MAYRYK	mayr
MAYRZ	mayr
MAYSAL	maysan
MAYSA	maysan
MAYSL	mays
MAYSTYK	mayston
MAYTAG	maytag
MAYTHAM	austhamaren
MAYT	maytag
MAYT	maytag
MAYTY	maytag
MAYVHAY	abhay
MAYV	gamay
MAYZ	gamay
MAZRA	mazera
MBARK	bark
MCLD	mclaren
MCTLD	abstract
MDABA	ahmadabad
MDAVR	avraham
MDBA	lindback
MDH	abudhabi
MDLYN	allyn
MDNYK	kolodny
MDNYT	kolodny
MDRK	adri
MDRR	adri
MDS	mds
MDSN	mds
MDSVN	mds
MDVNA	dvina
MDYNA	dyna
MDYNH	dyna
MDYNH	dyna
MDYN	dyna
MDYNNY	benny
MDYNT	chrescyntie
MDYSVN	andys
MDYSVN	andys
MFRG	pumfrey
MFRK	pumfrey
MFRVK	pumfrey
MGDALNT	bloomingdale
MGDALYNTJ	magdaleentje
MGDALYYNTJH	magdaleentje
MGDA	bloomingdale
MGDAYNTJ	eyntje
MGLAGLYN	flaglelee
MGLAT	aoglat
MGNAN	magnan
MGNASN	bolognas
MGNH	ragnhild
MGNY	agndie
MGR	almgren
MGY	almgren
MGY	almgren
MGY	almgren
MGYNL	ainley
MGYS	egyptologys
MGYSY	egyptologys
MGYV	almgren
MHADVAN	mahadevan
MHAMA	austhamaren
MHARAK	adhara
MHL	ahlstrom
MH	amharic
MHMA	abdalrahman
MHRAH	mahrah
MHRA	bahrain
MHRG	aberg
MHRH	ahriman
MHRK	mehrkens
MHRM	fuhrmann
MHVYT	amharic
MJDL	adler
MJ	somjee
MJYA	najya
MJYD	ackroyd
MJYKAL	alukal
MJYK	boyko
MKAH	barakah
MKALYR	kalyan
MKA	afrikaans
MKARDL	ardley
MKDALN	abdalmalik
MKDRMVT	ackerman
MKDVLND	abend
MKDVNALD	aguinaldo
MKDVNALD	aguinaldo
MKDVYL	advent
MKFARLND	mcfarland
MKFARLYN	charlyn
MKFRLYN	charlyn
MKGAVYN	davy
MKGRAT	grater
MKGVVAN	bevan
MKGVYRK	akgun
MKGVYR	akgun
MKGYRY	abery
MKH	akhmatova
MKH	akhmatova
MKHNRY	boukhny
MKKAH	hanukkah
MKKAN	afrikaner
MKKARTY	karty
MKKARTY	karty
MKKAVN	akkad
MKKNA	knaff
MKKNY	akkad
MKKNZY	akkad
MKKRKN	bjerknes
MKLAGLYN	flaglelee
MKLAQLYN	alaqabah
MKLARN	abelard
MKLAVLYN	yaroslavl
MKLAVLYN	yaroslavl
MKLAVVGYNG	auckland
MKLYN	brooklyn
MKLYN	brooklyn
MK	demke
MK	demke
MKMAHAN	mcmahan
MKMAHVN	akman
MKMAHVN	akman
MK	demke
MKMANYS	germanys
MKMVLN	akman
MKMYLAN	boylan
MKNAT	abernathy
MKNYL	aeschylus
MKNYL	aeschylus
MKRA	kraack
MKRAYH	airay
MKRAY	airay
MKRDY	cordy
MKRVN	ackroyd
MKRYS	conakrys
MKSFYLD	barksfield
MKSN	addicks
MKSYMV	syme
MKTAVYS	koktavy
MKVC	demke
MKVTV	austvollen
MKVY	chevy
MKVY	chevy
MKYL	jekyll
MKY	becky
'ML	amlak
MLA	amlak
MLANDR	landrum
MLANY	billany
MLAYYR	amlak
MLBAY	alba
MLCR	shallcross
MLCYR	alcyone
MLKA	alkabeer
MLKVLM	abdalmalik
MLKVM	alkabeer
MLMN	abdalmalik
MLN	alnilam
MLR	abdalrahman
MLTH	althea
MLV	alva
MLVN	alva
MLVR	alva
MLYBV	klyber
MLYDY	clyde
MLY	somlyo
MLYNGR	allyn
MLYN	allyn
MLYNY	allyn
M'MA	abdalmalik
MMH	amharic
MMTA	mamta
MNAMA	benamar
MNAMH	adnams
MNARD	barnard
MNDL	braendle
MNDL	braendle
MNDL	braendle
MNDR	alejandra
MNDVZA	lendvai
MNDYBL	andy
MNDYK	mendyke
MNDY	andy
MNDZ	wendzel
MNFVL	agamemnon
MNGAN	dungane
MNGH	anghe
MNG	addington
MNGS	armstrongs
MNHART	barnhart
MNH	agamemnon
MNJYVN	agamemnon
MNK	agamemnon
MNKVSV	agamemnon
MNKYVS	belenky
MNMA	annmarie
MNNYNG	benny
MNRV	agamemnon
MNSA	ainsaar
MNSN	autumns
MNSTRYNA	boonstra
MNSVR	autumns
MNSVR	autumns
MNSVR	autumns
MNSVRY	autumns
MNTL	antley
MNT	accenture
MNTQH	accenture
MNTSR	advents
MNTSYNN	solzhenitsyn
MNTY	blantyre
MNTZR	bentz
MNYJR	agamemnon
MNYKS	addicks
MNY	agamemnon
MNY	agamemnon
MNYNG	conyne
MNYN	conyne
MNZR	agamemnon
MNZS	franzs
MNZYZ	agamemnon
MPL	champlain
MPL	champlain
MQBRH	abraham
MQRBY	darby
MQSVD	almqvist
MRANDA	maranda
MRDYS	lombardys
MRDYT	cordy
MRHAVS	avs
MRJYNYV	sunnyvale
MRKL	aurkleven
MRKLY	aurkleven
MRKNT	bjerknes
MRKR	ackroyd
MRNDA	spaarndam
MRNY	czerny
M'RQ	albuquerque
MRSR	mrs
MRSRYA	anniversary
MRSRYV	anniversary
MRTN	baumgartner
MRTNZ	baumgartner
'MR	amran
MRVAH	apoorva
MRVAN	cervantes
MRYGAN	aganovic
MRYJ	camry
MRYK	camry
MRYKS	camry
MRYMAN	ayman
MRY	camry
MRY	camry
MRYMN	barrymore
MRYNLY	bryn
MRYS	camrys
MRYT	camry
MRZ	amran
MSALXY	absalom
MSA	gramsas
MSANDR	alesandro
MSBARN	barn
MSKS	omsks
MSKYN	chomsky
MSLYN	roslyn
MSMAN	bertelsmann
MSR	abrahams
MSS	brahmss
MSTAN	afghanistan
MST	amstadt
MST	amstadt
MSTRZ	armstrong
MS'VD	abrahams
MSYF	abrahams
MSYNA	calsyn
MSYNGR	synge
MSYN	calsyn
MSYVS	abrahams
MTANA	antanaitis
MTLYN	allyn
MT	amtrak
MT	amtrak
MTNA	etna
MTNA	etna
MTRNC	amtrak
MTRNYC	ternyck
MTRV	amtrak
MTRYNC	katryntje
MTSGR	cosgriff
MTSVMVTV	huntsville
MTSVN	huntsville
MTVR	amtrak
MTYN	augustyn
MTYN	augustyn
MTYV	almaty
MTYV	almaty
MTYV	almaty
MTYVS	almaty
MTYVS	almaty
MTYVSVN	almaty
MTYVZ	almaty
MTZGR	fitzgerald
MTZYNG	metzing
MVALR	abdalrahman
MVANZR	vanzandt
MVBAY	bayard
MVBLY	blystone
MVDGYL	argyle
MVD	blvd
MVDY	addy
MVDY	addy
MVFAD	fadil
MVGANTY	blantyre
MVHAMA	austhamaren
MVHAN	hovhaness
MVHR	ahriman
MVKASA	chickasaw
MVK	humvee
MVKRYJ	conakry
MVLANDR	landrum
MVLDN	adnams
MVLK	alkabeer
MVL	devlin
MVLN	alnilam
MVLR	abdalrahman
MVLR	abdalrahman
MVLVY	ogilvy
MVLYGAN	flygare
MVLY	alelyunas
MVLYNARY	maynard
MVMFVRD	mumford
MV	humvee
MVNAGAN	flanagan
MVNAK	anakin
MVNAKV	anakin
MVNAZ	ashkenazim
MVNDFRANS	mondfrans
MVNDVR	lendvai
MVNKAR	ankara
MVNK	ankara
MVNKS	armonks
MVNKZ	ankara
MVN	avniel
MVN	avniel
MVNRV	apoorva
MVNS	abelsons
MVNTAG	montag
MVNTAGV	montag
MVNTALBANV	montalbano
MVNTA	almintaqah
MVNTANARV	montanaro
MVNTANV	antanaitis
MVNTGMRY	montgomery
MVNTGVMRY	montgomery
MVNT	accenture
MVNTRAL	australasia
MVNTRV	afrocentrism
MVNTVYA	divya
MVNTYJV	blantyre
MVNVLYT	blyth
MVNYZ	lyubovny
MVNZLR	anzlovar
MVRABYTV	araby
MVRAD	alvarado
MVRAL	admiral
MVRALS	admirals
MVRALT	gibraltar
MVRA	avraham
MVRANDV	aurand
MVRAN	kevran
MVRANV	granvin
MVRAS	accras
MVRAVAN	moravan
MVRAY	airay
MVRAYNS	rayner
MVRC	abercrombie
MVRDAC	adirondack
MVRDAK	amsterdam
MVRFY	avraham
MVRHAVS	avraham
MVRHAVS	avraham
MVRKL	aurkleven
MVRKN	bjerknes
MVRLAN	borland
MVRL	adderley
MVRL	adderley
MVRL	adderley
MVRLYJ	baggarly
MVRLY	baggarly
MVRMAN	ackerman
MVR	avraham
MVRNYNG	conyne
MVRS	abners
MVRS	abners
MVRS	abners
MVRSTAD	maurstad
MVRTAN	spartan
MVRTN	baumgartner
MVRTVN	albert
MVRTYMR	daugherty
MVRTYMR	daugherty
MVRTY	daugherty
MVRTYMVR	daugherty
MVRV	apoorva
MVRVNY	cerveny
MVRVYL	aeschylus
MVRYL	beryl
MVRY	abery
MVRY	abery
MVRYN	bryn
MVRYSN	averys
MVRYSVN	averys
MVRYSVN	averys
MVRYTA	chrystal
MVSAL	absalom
MVSANA	prasana
MVSFYS	buffys
MVSLA	ameslan
MVSMN	abbotsmith
MVS	antevs
MVSVN	antevs
MVSVY	antevs
MVSYG	kosygin
MVSY	antevs
MVSYR	assyria
MVSYVN	antevs
MVSZ	antevs
MVTA	acosta
MVTANA	antanaitis
MVT	humvee
MVTVR	austvollen
MVTVRZ	arzate
MVTYSV	almatys
MVVR	avraham
MVYL	aeschylus
MVY	chevy
MVYNYHAN	beyhan
MVYNZ	kevyn
MVYR	assyria
MVYSAN	maysan
MVYS	chevys
MVYSS	abyssinia
MVYSVN	chevys
MVYZ	allyz
MVYZVN	allyz
MVZYNA	dyna
MVZZ	belshazzar
MYAV	myanmar
MYAYNDRT	alejandra
MYCALYS	alyson
MYCA	aureomycin
MYCAN	african
MYCAYLYS	bayly
MYCL	aureomycin
MYCLTJN	aaltje
MYCLTN	aureomycin
MYCLTYN	augustyn
MYCLYS	allyson
MYCN	aureomycin
MYDLBRV	albright
MYDLTN	keltner
MYDLTVN	rydland
MYD	academy
MYDR	hydra
MYDY	academy
MYGN	cygnus
MYGNRAN	aldebaran
MYGNRY	cygnus
MYGR	academy
MYGR	academy
MYGVYL	academy
MYHALYK	mahaly
MYHAN	beyhan
MYJR	academy
MYJRY	abery
MYKAK	gromyko
MYKALK	kalkan
MYKA	gromyko
MYKAS	alaskas
MYKAYL	kayla
MYKAYYL	ayyubid
MYKAYYLYZ	allyz
MYKAYYLZ	ayyubid
MYKK	gromyko
MYKLACLN	apalachicola
MYKLJN	gromyko
MYKLM	gromyko
MYKLSN	elsner
MYKLSVN	gromyko
MYK	gromyko
MYKNA	gromyko
MYKR	gromyko
MYKS	gromyko
MYKS	gromyko
MYKS	gromyko
MYKT	gromyko
MYKVK	gromyko
MYKVLYK	gromyko
MYKV	gromyko
MYKYNG	gromyko
MYKYNZ	gromyko
MYKZ	gromyko
MYLAD	mylar
MYLAM	mylar
MYLAM	mylar
MYLAN	boylan
MYLARA	mylar
MYLARD	duchaylard
MYLAR	mylar
MYLASYS	kaylas
MYLBRT	albert
MYLDRD	aldrich
MYLGRAM	milgram
MYLKS	milks
MYLKV	mylar
MYLKY	milky
MYLMAN	allman
MYLMAN	allman
MYLMV	mylar
MYLN	mylar
MYLNR	mylar
MYLNVR	mylar
MYLNYVM	mylar
MYLR	mylar
MYLSTVN	ahlstrom
MYLT	heyltje
MYLT	heyltje
MYLTN	heyltje
MYLVARD	alvarado
MYLV	mylar
MYLVS	mylar
MYLVT	mylar
MYLYANZ	kalyan
MYLYGAN	flygare
MYLYKN	bayly
MYLY	bayly
MYLY	bayly
MYLY	bayly
MYLYND	leelynde
MY	academy
MYMAS	alabamas
MY	academy
MY	academy
MYMY	academy
MYNA	dyna
MYNA	dyna
MYNAMV	dynamite
MYNARD	maynard
MYNARD	maynard
MYNARYK	masaryk
MYNDRT	alejandra
MYNGV	ingvar
MYNKY	belenky
MYN	jacomyntie
MYN	jacomyntie
MYN	jacomyntie
MYN	jacomyntie
MYN	jacomyntie
MYNRAL	admiral
MYNR	jacomyntie
MYNRVA	apoorva
MYNRZ	jacomyntie
MYNSR	boleyns
MYNSTRL	boonstra
MYNSY	boleyns
MYNTAKAH	mintaka
MYNTAKVA	jacomyntie
MYNTKA	jacomyntie
MYNT	jacomyntie
MYNTR	jacomyntie
MYNTVN	jacomyntie
MYNTZ	jacomyntie
MYNVARYNG	bovary
MYNYARD	minyard
MYNY	jacomyntie
MYNZ	jacomyntie
MYNZ	jacomyntie
MYPL	academy
MYRA	myra
MYRA	myra
MYRANKR	cyrano
MYRFLD	butterfly
MYR	chernomyrdin
MYRMAK	mirmak
MYR	chernomyrdin
MYR	chernomyrdin
MYR	chernomyrdin
MYRS	ayrshire
MYRSY	ayrshire
MYRTY	myrtle
MYRVA	apoorva
MYRVL	chernomyrdin
MYRVT	chernomyrdin
MYRYDYT	bryde
MYRZ	chernomyrdin
MYRZ	chernomyrdin
MYRZ	chernomyrdin
MYSA	amys
MYSA	amys
MYSAN	maysan
MYSAT	alsatian
MYSLAV	berislav
MYSL	premyslid
MYSL	premyslid
MYSM	amys
MYSN	amys
MYSRA	amys
MYSTRY	mistry
MYSTYK	myst
MYSVNR	amys
MYSYK	amys
MYTAL	antal
MYTAVA	amitava
MYTCL	myth
MYTCM	myth
MYTNYK	delikatny
MYTRVVYK	myth
MYTSL	mysts
MYTV	myth
MYTV	myth
MYTVN	myth
MYTVNN	myth
MYV	academy
MYVS	academy
MYVSN	academy
MYVVZ	academy
MYVZ	academy
MYVZR	academy
MYYH	academy
MYYR	academy
MYYRS	ayrshire
MYZ	academy
MYZ	academy
MYZVN	academy
MYZYRA	byra
MZDH	abudhabi
MZYK	boyko
MZYVN	avniel
NAB	anabaptist
NABL	venable
NABYL	babylon
NADAN	adan
NADANSVN	adans
NADVLNY	nadolny
NADYG	bernadette
NAF	funafuti
NAF	funafuti
NAF	funafuti
NAFZA	afzal
NAGASAKY	nagasaki
NAGASYVA	nagasiva
NAGNT	agent
NAGY	gnagy
NAHAM	abraham
NAJR	najaf
NAJYAH	najiyah
NAJYA	najya
NAKAGAKY	nakagaki
NAKAMVRA	nakamura
NAKASVRA	nakasora
NAKASYMA	nakashima
NAK	anakin
NAKSVN	aksu
NAKVYYN	anakin
NAL	aguinaldo
NALYK	aguinaldo
NAM	adnams
NANDVANY	nandwani
NANLY	anand
NAN	anand
NANS	arizonans
NANSY	arizonans
NANTVN	anant
NAP	annapolis
NAP	annapolis
NAPTVN	napton
NAPVLYTANV	napolitano
NARAD	narad
NARDN	barnard
NARDV	barnard
NARDY	barnard
NARLA	narla
NARSAVAG	narsavage
NARV	achernar
NASAV	anasazi
NAS	adrianas
NAS	adrianas
NATAN	atanacio
NAT	abernathy
NATSN	nats
NAVAR	navarre
NAVARV	navarre
NAVAS	navas
NAV	benavides
NAV	benavides
NAVYA	benavides
NAVYLV	benavides
NAYA	benaya
NAYDV	anay
NAYFH	nayfeh
NAYFLR	mayflower
NAYKRBYKR	anay
NAYKS	anay
NAYKS	anay
NAYKVLAS	vlasic
NAYLR	naylor
NAYLZ	naylor
NAYMAH	ayman
NAYRMN	anay
NAYT	anay
NAYT	anay
NAZAHA	nazahah
NAZARYTYAN	nazaretian
NAZARYV	nazarene
NBATAY	bataan
NBATYH	abbate
NBATY	abbate
NBL	hornblower
'NBR	hillenbrand
NBRS	brs
NDA	adirondack
NDKARNY	nadkarni
NDN	rindner
NDVD	lendvai
NDYN	andy
NFAN	bienfang
NFDV	advent
NFJAN	neefjan
NFL	aeroflot
NFYSA	buffys
NFYZA	byzantine
NFZA	afzal
NGTYV	addington
NGY	dingyi
NHAVS	avs
NHNH	houyhnhnm
NJAF	banjarmasin
NJF	banjarmasin
NJVA	akhmatova
NJYAH	aaliyah
NJYA	najya
NJYH	banjarmasin
NKLAS	klassa
NKLS	bankler
NKNZ	keinknen
NKV	ankara
NKV	ankara
NL	ainley
NLKYN	milky
NLS	abduls
NLSN	elsner
NLT	aaltje
NMAZY	amazon
NPAN	belmopan
NP	chunping
NPL	altiplano
NPR	apr
NPTVN	abrupt
NPVRA	avraham
NRAD	coenradus
NRDNFLT	nordenfelt
NRS	abners
NRTRVP	bertram
NRVP	apoorva
NRY	freemasonry
NRY	freemasonry
NSLY	ansley
NSNAL	aguinaldo
NSVA	transvaal
NSVM	brownsville
NSYDA	ayda
NSYHA	anshan
NSYH	pansy
NSYRA	syracuse
NTAKR	mintaka
NTRTVN	afrocentrism
NTYFA	antofagasta
NTYHA	anantha
NVALA	kalevala
NVAR	invar
NVAYL	ayling
NVAZ	gavazzeni
NVBL	ablation
NVBL	ablation
NVDA	chavda
NVDYNG	dyna
NVF	anvers
NVGNT	accenture
NVJANS	abidjans
NVJANZ	janzen
NVJNANS	arizonans
NVJNS	konvinse
NVJNT	kristijntje
NVKS	addicks
NVKV	anvers
NVLAN	adgeringelant
NVLD	groenveld
NVLF	vanvleck
NVL	vanvleck
NVL	vanvleck
NVNYS	albanys
NVP	anvers
NVRA	vanvranken
NVRBAY	arbanas
NVRDA	amsterdam
NVRDBAY	bayard
NVRDBVRG	nordborg
NVRDDRAP	draper
NVRDNSTVRM	nordenstrom
NVRDRAP	draper
NVRDRVPH	cordrey
NVRDT	bernhardt
NVRDVRP	leiderdorp
NVRDVRP	leiderdorp
NVRHA	avraham
NVRKAT	arkansan
NVRN	vanvranken
NVRSRAP	witwatersrand
NVRSVRP	anvers
NVRTKAT	atka
NVRTVRPH	caerphilly
NVRTVRP	vanvranken
NVRVVD	vanvranken
NVRY	convery
NVSAK	adisak
NVSL	ameslan
NVT	anvers
NVTZN	adametz
NVTZ	adametz
NVVALA	kalevala
NVVRDDRP	noorddorp
NVVSL	ameslan
NVVYK	anvers
NVYA	divya
NVYFL	mayflower
NVYJANZ	janzen
NVYK	anvers
NVYL	aeschylus
NVYL	aeschylus
NVYLS	beryls
NVYNGTVN	addington
NVYS	chevys
NVZ	anvers
NYBY	nyberg
NYCVLAS	vlasic
NYCVLS	ternyck
NYDAL	abdalmalik
NYDA	ayda
NYDH	snyder
NYDLZ	rydland
NYD	snyder
NYFJAN	neefjan
NYFYN	nyffeler
NYGLY	gillogly
NYG	albany
NYGRA	agra
NYGT	addington
NYHALANY	nihalani
NYKALAS	kalashnikov
NYKLAS	klassa
NYKLAS	klassa
NYKLAS	klassa
NYKLAS	klassa
NYKL	ackley
NYKL	ackley
NYKL	ackley
NYKL	ackley
NYKLS	abduls
NYKLS	abduls
NYKLS	abduls
NYKLS	abduls
NYKLSN	elsner
NYKLSN	elsner
NYKLSVN	abduls
NYKLV	ackley
NYKLZ	ackley
NYKLZ	ackley
NYK	albany
NYK	albany
NYK	albany
NYKRBAKR	bourbaki
NYKRBKR	ackroyd
NYKRBYKR	darby
NYKRSVN	chancellorsville
NYKS	addicks
NYKSVN	addicks
NYKVLA	kevlar
NYKVLAS	vlasic
NYKVLAS	vlasic
NYKVLAS	vlasic
NYKVLAS	vlasic
NYKVL	albany
NYKVLSAN	ailsa
NYKVLS	abduls
NYKVLS	abduls
NYKVLS	abduls
NYKVLSVN	abduls
NYKVLYK	slyke
NYKVLY	albany
NYKVLY	albany
NYKVLZ	albany
NYKVLZ	albany
NYKV	albany
NYKY	albany
NYKY	albany
NYKY	albany
NYKY	albany
NYLBRY	albright
NYLJH	aeschylus
NYLMG	almgren
NYLND	disneyland
NYL	aeschylus
NYL	aeschylus
NYLS	beryls
NYLS	beryls
NYLS	beryls
NYLS	beryls
NYLTH	althea
NYLTJH	heyltje
NYLTJ	heyltje
NYLTJY	heyltje
NYLZ	aeschylus
NYMAH	nyman
NYMA	nyman
N'YMH	amharic
NYMH	ganymede
NYMRAD	alvarado
NYMTZ	ganymede
NYMY	ganymede
NYNDK	conyne
NYNJA	banjarmasin
NYN	conyne
NYN	conyne
NYNS	boleyns
NYNSTAR	ninstar
NYNV	conyne
NYNVYS	chevys
NYPAN	belmopan
NYPNBRG	brandenburg
NYPTVN	cryptozoic
NYR	albany
NYR	albany
NYS	albanys
NYS	albanys
NYSN	albanys
NYSPL	albanys
NYSYLDA	albanys
NYTYN	augustyn
NYVAN	sunnyvale
NYVARK	sunnyvale
NYVAYNGTN	sunnyvale
NYVAYNGTVN	sunnyvale
NYVBAY	bayard
NYVBRY	bryan
NYVBRY	bryan
NYVKVLAS	vlasic
NYVKVYST	amethysta
NYVLND	sunnyvale
NYVMAN	nyman
NYVMAN	nyman
NYVMN	sunnyvale
NYVMYR	chernomyrdin
NYVSAM	aissama
NYVTN	sunnyvale
NYVVYNGTVN	addington
NYVYSVN	chevys
NYVYYNGTVN	addington
NYYVKAMB	kamb
NYYVTN	albany
'NYZH	albany
NZAHAH	nazahah
NZAHA	nazahah
NZAHH	anzac
NZYRAH	abdalrahman
NZYRA	byra
NZYRH	zyrtec
PABLT	capablanca
PABLV	capablanca
PACVLKH	alkhazna
PACYANV	abyan
PADVA	accapadi
PADVLA	padula
PADYAL	padial
PADYLA	dylan
PAGLAYS	aglaia
PAGLYA	paglia
PAGLYS	paglia
PAGLYYARV	paglia
PAGT	campagna
PAJT	pajerek
PAKALA	pakala
PAKARD	packard
PAKNAS	pakenas
PAKS	paks
PAKS	paks
PAKT	dipak
PAKVAT	akiva
PALAGY	palagyi
PALAK	apalachicola
PALFVRD	alford
PALMRT	palmert
PAL	apalachicola
PAL	apalachicola
PALRMV	palermo
PALSKY	rogalsky
PALSN	nepals
PALSYFR	calsyn
PALTJH	aaltje
PALTJ	aaltje
PALTJY	aaltje
PALVMBV	palembang
PALYDV	alya
PALY	alya
PALY	alya
PALY	alya
PALYS	alyson
PAMFRY	amery
PAM	anupam
PANAGS	panagos
PANAS	panas
PANC	pancras
PANDA	panda
PANDR	alejandra
PANDVLFYNV	pandolfino
PANDYAN	pandya
PANDYT	pandya
PANDZ	panda
PANFYL	panfil
PANGBVRN	pangborn
PANJABY	banjarmasin
PANKRAS	ankaras
PANKRS	pankhurst
PANN	pannon
PAN	belmopan
PANT	pant
PANVALKR	panvalkar
PANVN	panvalkar
PANYKV	albany
PANYSY	albanys
PAPALARDV	pappalardo
PAPAY	papay
PAPLASKAS	paplaskas
PAPLTVN	paplaskas
PAPLY	paplaskas
PAPN	kapner
PAP	papay
PAP	papay
PAPVYK	papay
PAQ	chappaquiddick
PARA	paracelsus
PARAT	ararat
PARAYL	parayil
PARDN	bringardner
PARDYNGTN	pardington
PARDYNGTVN	pardington
PARDY	camelopardalis
PARDZ	camelopardalis
PARHAM	parham
PARK	park
PARKYN	parkyn
PARKZ	park
PARMAR	parmar
PARNS	barnshaw
PARSANZ	barsai
PARSL	parsley
PARSN	parsi
PARSVNS	parsons
PARSVNZ	parsi
PARTVN	bonaparte
PARTVS	bonaparte
PARTY	vadaparty
PARYNGTVN	catharyn
PARY	amparo
PARYS	barbarys
PASKAL	alaska
PASKV	pasko
PASKV	pasko
PAS	agrippas
PASTRNAK	pasternak
PASTVR	pasternak
PASYFYK	agrippas
PASYR	agrippas
PATN	patna
PATR	cleopatra
PATRSVN	cleopatra
PATRSVN	cleopatra
PATRVKLVS	cleopatra
PATRYK	cleopatra
PATRYK	cleopatra
PATRYK	cleopatra
PATRYS	cleopatra
PATRYSYA	cleopatra
PATRYZYV	cleopatra
PATS	patsy
PATTA	battan
PATVCY	alapati
PATVKSNT	alapati
PATYL	koorapaty
PAVL	pavlik
PAVLSN	pavlik
PAVLS	pavlik
PAVLTH	pavlik
PAVLT	pavlik
PAVLYK	pavlik
PAV	pavarotti
PAVV	pavarotti
PAYJ	papay
PAYK	papay
PAYNH	payne
PAYN	payne
PAYNTVN	paynter
PAYNY	payne
PAY	papay
PAYPR	paypal
PAYRAMYD	jayaram
PAYTH	ghayth
PAYTJ	payton
PAYTR	payton
PAYTR	payton
PAYTVN	payton
PAYVLSVN	kayvon
PAYVLTJ	aaltje
PAYVTH	ghayth
PD	chopde
PDRAM	dramamine
PDRSN	sadrs
PDRSVN	chancellorsville
PDY	addy
PG	hipgrave
PGRAM	anagram
PGT	addington
PK	hopkins
PKR	ackroyd
PKYNGZ	aurangzeb
PLAK	altiplano
PLAMN	plamen
PLAMR	plamen
PLANK	altiplano
PLAN	altiplano
PLANT	norplant
PLASTYNV	elastoplast
PLATFVRM	platform
PLAT	plat
PLAT	plat
PLATYV	gallaty
PLAYR	playboy
PLC	acapulco
PLHAM	alhambra
PLKCYA	aaliyah
PLKY	milky
PLNKNR	kaplenk
PLNTH	anantha
PLTAYR	alta
PLTCR	pletcher
PLTFRM	platform
PLTKVS	platkus
PLTNN	keltner
PLT	aaltje
PLT	aaltje
PLTYV	kelty
PLTYYR	kelty
PLVHN	altiplano
PLVMR	altiplano
PLYGRYNY	bryn
PLYNSKYN	bilinsky
PLYSKYN	allyson
PLYT	blyth
PLYV	plyler
PNBAKR	diefenbaker
PNDLTN	braendle
PNDLTVN	braendle
PNDYA	pandya
PNGADV	pengadu
PNG	addington
PNKRAS	ankaras
PNL	ainley
PN	clumpner
PNS	abelsons
PNTVN	accenture
PNYMAN	nyman
PNYNSVLA	boleyns
PNYNZVLA	conyne
PNY	albany
PPH	sappho
PPLR	apple
PPYN	pynchon
PRABST	abstract
PRACT	abstract
PRADV	prada
PRAGV	prager
PRAHL	prahl
PRAKTYKVM	praktikum
PRAL	kapral
PRALT	gibraltar
PRAM	pram
PRAMVD	pram
PRANAV	pranav
PRANGS	aurangzeb
PRANK	pranke
PRAPYS	arapaho
PRASAD	prasad
PRASANA	prasana
PRASANT	prasana
PRASN	capras
PRAS	capras
PRATP	pratap
PRAT	pratap
PRATS	ararats
PRATVL	pratap
PRATYK	pratap
PRATYKS	pratiksh
PRATYKV	pratap
PRAVL	jouravlev
PRAVYN	pravda
PRAYB	sprayberry
PRAYL	prayaga
PRAYM	prayaga
PRAYVN	prayaga
PRAYVYT	prayaga
PRBN	abner
PRC	abercrombie
PRDYKARV	hardikar
PRDYKYS	beckys
PRDYS	lombardys
PRKAS	farkas
PRKS	barksdale
PRKYNS	parkyn
PRKYNZ	parkyn
PRLMAN	pearlman
PRLMN	pearlman
PRL	adderley
PRLR	abdalrahman
PRLY	baggarly
PRMAL	permalloy
PRNT	bernt
PRNTYS	montys
PRPK	perpk
PRSATTAM	tattam
PRSKAT	carskadon
PRSL	aprs
PRSLT	aprs
PRSTN	amherst
PRSTRVD	lagerstrom
PRSTRV	lagerstrom
PRSTVN	amherst
PRSVN	aprs
PRSYNV	aprs
PRSYVAL	sunnyvale
PRVAMR	amran
PRVAN	cervantes
PRVGTV	addington
PRVJT	apoorva
PRVMVNTVRY	promontory
PRVN	apoorva
PRVPS	malaprops
PRVS	antevs
PRVTRV	aaltruide
PRVTVS	antevs
PRVV	apoorva
PRVVST	lovstad
PRVYN	kevyn
PRVY	apoorva
PRVYS	chevys
PRYA	arya
PRYAVLT	arya
PRYBL	byblos
PRYCARD	bacardi
PRYDY	bryde
PRYKLY	brooklyn
PRYKN	masaryk
PRYKT	masaryk
PRYLV	beryl
PRYMRV	barrymore
PRYMV	barrymore
PRYMYVS	barrymore
PRYNG	bryn
PRYN	bryn
PRYNS	cathryns
PRYNSS	cathryns
PRYNT	katryntje
PRYNY	bryn
PRY	pryor
PRYSKAT	saskatchewan
PRYSLR	chrysler
PRYSTLY	chrystal
PRYSTLY	chrystal
PRYST	chrystal
PRYSTVN	chrystal
PRYSYLA	averys
PRYSYNG	synge
PRYTCARD	pritchard
PRYTY	marytje
PRYTY	marytje
PRYTZ	marytje
PRYVR	pryor
PRYVS	pryor
PRYVST	chrystal
PRYYVTY	pryor
PRZ	kasprzak
PSKYN	bilinsky
PSNKV	aesops
PS	aesops
PSTMA	christman
PST	capstick
PTCR	abercrombie
PTKR	abrupt
PTLA	atlanta
PTRN	aaltruide
PTR	aaltruide
PTRSN	pyotrs
PTRSN	pyotrs
PTRSVN	chancellorsville
PTRSVN	chancellorsville
PTRVF	aaltruide
PTRVNLA	arvola
PTRV	aaltruide
PTRVV	aaltruide
PTRVYC	aaltruide
PTRYC	bryce
PTRYK	coventry
PTRY	coventry
PTRZ	aaltruide
PTSY	betsy
PTV	abrupt
PTYBN	abner
PTYBVN	abrupt
PTYL	kettyle
PTYNS	augustyn
PTY	abrupt
PTY	abrupt
PTY	abrupt
PTYTJYN	martyntje
PTZVLD	petzold
PVALMA	abdalmalik
PVA	akhmatova
PVGA	abigail
PVGLYS	allyson
PVG	novgorod
PVGVSYAN	pogosyan
PVHAN	hovhaness
PVHAR	adhara
PVHL	ahlstrom
PVH	hovhaness
PVKVRNY	czerny
PVLAKVS	amlak
PVLGAR	bulgar
PVLK	alkabeer
PVLMYTYS	almatys
PVLND	abend
PVLN	alnilam
PVLN	alnilam
PVLNT	accenture
PVL	devlin
PVL	devlin
PVLSN	elsner
PVLS	abduls
PVLS	abduls
PVLTR	aaltruide
PVLV	alva
PVLVVYN	kevyn
PVLYNG	allyn
PVLYPALY	paypal
PVLY	alelyunas
PVLYS	allyson
PVLYT	blyth
PVLYYAM	khayyam
PVLZ	alzena
PVMA	abdalmalik
PVMFRY	fry
PVNA	aamina
PVNT	accenture
PVNVZ	anvers
PVPAT	alapati
PV	abrupt
PVP	abrupt
PVP	abrupt
PVRAHV	avraham
PVRANYK	kevran
PVRJZ	arjuna
PVRKV	ark
PVR	avraham
PVRTNVY	baumgartner
PVRTRFYLD	bertram
PVRVS	antevs
PVRYNTVN	katryntje
PVRYR	abery
PVSALA	faisalabad
PVSARY	anniversary
PVSN	antevs
PVS	antevs
PVSTYL	styles
PVSV	antevs
PVSY	antevs
PVTKVNN	adrienne
PVT	yevtushenko
PVTRY	coventry
PVTYT	tytie
PVTYT	tytie
PVTZ	adametz
PVVLZ	alzena
PVV	abrupt
PVYNT	chrescyntie
PVYNTYNG	poynting
PVYRYR	abery
PVYSL	chevys
PVYV	chevy
PVZYVS	antevs
PYAK	kayak
PYATJY	daatje
PYATK	atka
PYBADY	abad
PYDH	abudhabi
PYD	ackroyd
PYD	ackroyd
PYJH	cherepy
PYJT	cherepy
PYKAP	kapalka
PYKARD	kardal
PYKASV	alaskas
PYKL	ackley
PYK	boyko
PYK	boyko
PYK	boyko
PYK	boyko
PYKRL	ackroyd
PYKS	addicks
PYKVLBNY	albany
PYKZ	boyko
PYLAR	duchaylard
PYLARZ	duchaylard
PYLATV	latvia
PYLAZV	thermopylae
PYL	pyle
PYL	pyle
PYLVSKY	dostoevsky
PYLVYV	ogilvy
PYLY	bayly
PYLYSNRY	allyson
PYNAKL	akl
PYNA	dyna
PYNCAZ	pynchon
PYNCRA	pancras
PYNDAR	lynda
PYNDV	leelynde
PYNGNVT	brobdingnag
PYNG	pynchon
PYNKVVYTZ	pynchon
PYNKY	belenky
PYN	pynchon
PYN	pynchon
PYN	pynchon
PYNSN	boleyns
PYNSVN	boleyns
PYNTH	cynthia
PYNTN	chrescyntie
PYNTR	afrocentrism
PYNTR	afrocentrism
PYNTR	afrocentrism
PYNTVN	chrescyntie
PYNTVN	chrescyntie
PYNV	pynchon
PYNV	pynchon
PYNXAM	dynamite
PYNYAN	bunyan
PYNY	pynchon
PYNZ	pynchon
PYPGRAS	pipgras
PYP	pype
PYP	pype
PYPR	cyprian
PYPVNY	lyubovny
PYRAMYD	pyramid
PYRAN	cyrano
PYRANY	cyrano
PYRARD	berardi
PYRAVAT	blavatnik
PYRKV	pyramid
PYRLMAN	pearlman
PYRL	pyramid
PYRMN	pyramid
PYR	pyramid
PYRSN	ayrshire
PYRSN	ayrshire
PYRSN	ayrshire
PYRS	ayrshire
PYRS	ayrshire
PYRSVN	ayrshire
PYRT	myrtle
PYRV	pyramid
PYRVZ	pyramid
PYRY	pyramid
PYRYR	pyramid
PYRYZ	kyrgyzstan
PYRZ	pyramid
PYSAH	hafsah
PYSAN	maysan
PYSH	baryshnikov
PYSLY	chrysler
PYSNS	allysons
PYS	pepys
PYS	pepys
PYS	pepys
PYSTVN	amethysta
PYTAN	afghanistan
PYTA	maytag
PYTH	pythagoras
PYTJ	marytje
PYTKV	pythagoras
PYTMN	clytemnestra
PYT	pythagoras
PYT	pythagoras
PYT	pythagoras
PYT	pythagoras
PYTR	pyotr
PYTR	pyotr
PYTR	pyotr
PYTRSVN	pyotrs
PYTRV	pyotr
PYTRZ	pyotr
PYTS	pythagoras
PYTYBVN	pythagoras
PYVMLY	somlyo
PYVN	avniel
PYVNYK	lyubovny
PYV	cherepy
PYVRYNTN	katryntje
PYVTR	pyotr
PYYK	aliyyah
PYYRY	abery
PYYV	aliyyah
PYZA	byzantine
PYZLY	grizzly
PYZS	kyrgyzstan
PYZVLYTV	blyth
PYZYALY	alya
PYZYNY	pyziur
PYZY	pyziur
PYZYR	pyziur
PZARAYS	brays
QADSYH	adsett
QALYA	alya
QASAN	casandra
QASM	asma
QAYD	ayda
QAYS	amways
QBYLH	babylon
QDAMH	adam
QDYLA	dylan
QDYL	dylan
QDYM	dymond
QDYRA	byra
QDYR	addy
QDYSH	andys
QDYSYHA	andys
QLYA	alya
QLYBA	cybanski
QLYB	klyber
QLYLA	lylah
QML	amlak
QMR	amran
QNTVN	accenture
QRBYA	abyan
QRYBYH	charybdis
QSAN	alagesan
QSN	bosnia
QSYM	syme
QSYM	syme
QTRAN	austranten
QVASYM	akhmatovas
QVBYLH	babylon
'QYLA	bayla
'QYLA	bayla
'QYL	aeschylus
'QYL	aeschylus
QYT	blyth
QYVN	avniel
RABKYN	rabkin
RABLD	grable
RABL	grable
RABNAV	grabnar
RABN	grabnar
RABN	grabnar
RAB	arab
RABRT	radenburgerabroek
RABRTSN	rabats
RABRTSVN	rabats
RAB	arab
RABTM	crabtree
RABVYL	arab
RABYDYAKS	araby
RABY'H	araby
RABYJN	araby
RABYN	araby
RABYN	araby
RABYNSN	araby
RABYNSVN	araby
RABY	araby
RABY	araby
RABYV	araby
RACL	heraclitus
RAC	abstract
RADAK	estrada
RADBRG	bradbury
RADBVD	bradbury
RADBVN	bradbury
RADHA	radha
RADHYKA	radhika
RADKLYF	bradely
RADK	fradkin
RADMN	admiral
RADNBRC	radenburch
RADNBRGARBRVK	radenburgerabroek
RADNBRGRABRK	radenburgerabroek
RADNBRGRABRVK	radenburgerabroek
RADNBRGRBRVK	radenburgerabroek
RADNYK	adnams
RAD	alvarado
RADRAMVNY	hadramawt
RADRFRD	bradford
RADR	adri
RADR	adri
RADT	alvarado
RADVA	stradivarius
RADVF	advent
RADVLFS	adolfs
RADVLFVS	adolf
RADV	advent
RADVYG	advent
RADYAH	radeyah
RADYH	brady
RADYNG	brady
RADY	brady
RAFALKV	rafalko
RAFAL	rafal
RAFALSKY	rafalski
RAFA	arafat
RAFAYL	arafat
RAFAYLY	arafat
RAFNR	arafat
RAF	arafat
RAFRTY	rafferty
RAFYKYV	arafat
RAFYL	arafat
RAFYN	arafat
RAFY	arafat
RAGATZ	ragatz
RAGLND	ragland
RAGL	ragland
RAGNAR	ragnar
RAGNARSVN	ragnarsson
RAGNRD	fragonard
RAGNVALD	ragnvald
RAGRV	agra
RAGSDYL	ragsdale
RAHARJV	rahardjo
RAHBK	abdalrahman
RAHRR	abdalrahman
RAHRYG	phrygia
RAHVL	abdalrahman
RAHY	abdalrahman
RAJCR	rajcher
RAJNDR	rajendra
RAJN	indrajit
RAJ	indrajit
RAJR	indrajit
RAJRZ	indrajit
RAJS	indrajit
RAJV	indrajit
RAJYV	indrajit
RAKAH	barakah
RAKL	akl
RAKL	akl
RAK	amtrak
RAKVN	amtrak
RAKV	amtrak
RAKYKVT	amtrak
RALF	ralf
RALF	ralf
RALF	ralf
RAMA	aramaic
RAMBL	ambler
RAMBV	drambuie
RAMPLZ	rampling
RAM	abram
RAM	abram
RAMR	abram
RAMS	abrams
RAMSY	abrams
RAMSYR	abrams
RAMTAN	antaramian
RAMVLVS	abram
RAMVS	abram
RAMY	abram
RAMYRV	abram
RAMZ	abram
RANA	cranach
RANDL	crandlemire
RANDR	alejandra
RANGL	franglais
RANKYN	francyntie
RANN	brannen
RAN	aldebaran
RAN	aldebaran
RAN	aldebaran
RANR	granroth
RANTGN	arantes
RANY	albany
RANY	albany
RANY	albany
RANYV	albany
RAPBRYK	arapaho
RAP	arapaho
RAPR	apr
RARK	ararat
RASA	murasaki
RASCN	buraschi
RASDAL	ragsdale
RASD	accras
RASFVRD	accras
RASKH	chandrasekhar
RASK	nebraska
RASKYN	ladasky
RASL	accras
RASL	accras
RASMN	erasmus
RASNDAL	krasnodar
RASNDYL	brandy
RASNMAN	denman
RASPYNY	rasputin
RAS	accras
RAS	accras
RAS	accras
RAS	accras
RASTN	castner
RASTRAM	astrakhan
RAST	grasteinen
RASTYN	grasty
RASTY	grasty
RASVM	accras
RASV	accras
RASV	accras
RASV	accras
RASYD	accras
RATCSVN	pratchett
RATGRT	alpheratz
RATJRT	alpheratz
RATKS	pratiksh
RATMN	dratman
RATRA	alcatraz
RAT	alpheratz
RATRFVRD	waterford
RAT	alpheratz
RATSTRVM	ararats
RAVBATM	batman
RAVDAH	pravda
RAVDA	pravda
RAVDA	pravda
RAVLND	jouravlev
RAVLT	jouravlev
RAVNR	almoravid
RAV	almoravid
RAV	almoravid
RAV	almoravid
RAVRDY	raverdy
RAV	almoravid
RAVRT	almoravid
RAVS	almoravid
RAVT	almoravid
RAVYAH	aaliyah
RAVYH	almoravid
RAVYNDRAN	ravindran
RAVYRAJ	raviraj
RAVY	almoravid
RAVY	almoravid
RAYBLT	raybould
RAYDAH	hudaydah
RAYDJ	airay
RAYDL	airay
RAYDN	haydn
RAYFL	mayflower
RAYLH	rayle
RAYLY	bayly
RAYMVND	raymond
RAYNR	rayner
RAYP	airay
RAY	airay
RAYSL	brays
RAYS	brays
RAYSTLYN	brays
RAYT	airay
RAYTZ	airay
RAYVARD	bayard
RAYVLYNGZ	airay
RAYV	airay
RAYVTYALA	ayala
RAYZL	airay
RAZDAN	razdan
RAZN	alcatraz
RAZVRBK	razorback
RBHVLZ	rebholz
RBRTSVN	norberts
RBVK	anderberg
RBVSV	anderberg
RBYAH	gharbiyah
RBYH	darby
'RBYL	babylon
RBYS	darbys
RDAH	heyerdahl
RDA	amsterdam
RDBVN	nordborg
RDFYLD	abelard
RDLFVS	ardley
RDLVS	ardley
RDMN	beardmore
RDMYL	beardmore
RDRYK	badry
RDVA	edvard
RDVLF	abelard
RDVNDV	lendvai
RDYDH	cordy
RDYH	cordy
RDY	cordy
RFA	mirfak
RFSNS	cerfs
RFSVN	cerfs
RF'T	barff
RGD	aberg
RGV	aberg
RHLYNG	allyn
RHNY	boukhny
RHYMAH	hyman
RHYMH	hyman
RHYM	hyman
RJAS	jaschek
RJAT	lauverjat
RJ	arjuna
RKAH	barkah
RKDAL	barksdale
RKKAH	hanukkah
RKSTN	marksteiner
RKVG	ark
RLF	adderley
RLYVS	baggarly
RLYVZ	baggarly
RMD	ackerman
RMFR	pumfrey
RMLYNGR	allyn
RMNCYK	chauncy
RMN	ackerman
RMNS	autumns
RMPLYNG	rampling
RMVNY	germany
RMY	academy
RNALDZ	aguinaldo
RNALT	bernal
R'NA	aamina
RNA	abernathy
RNAVD	abernathy
RNBART	anbar
RNDHL	bernd
RNDR	alejandra
RNDY	andy
RNJ	abernathy
RNVYS	barneys
RN	abernathy
RNY	czerny
RNZLND	renzland
RNZ	abernathy
RPLAGL	flaglelee
RPRT	enterprise
RPTVN	abrupt
RQAH	almintaqah
RQA	alaqabah
RQD	albuquerque
'RRYFA	arrifa
RSA	anniversary
RSL	ekerslato
RSL	ekerslato
RSNYK	chesny
RST	amherst
RSVL	chancellorsville
RSVLVYRT	calvert
RSVNAT	abernathy
RSVNDL	braendle
RSYDA	ayda
RSYDH	forsyth
RSYD	forsyth
RSYNH	calsyn
RSYNJH	calsyn
RSYNTH	cynthia
RSYNTJ	resyntje
RSYVYN	forsyth
RTKLYF	brooklyn
RT	albert
RVAN	cervantes
RVATR	horvat
RVAY	apoorva
RVAYZ	apoorva
RVAZNR	alkhazna
RVBRJ	abraham
RVBR	abraham
RVBRTA	alberta
RVBRT	abraham
RVBRTSVN	alemberts
RVBRTV	abraham
RVBVZ	apoorva
RVBYN	bynon
RVBYNSVN	dobyns
RVBYNZ	bynon
RVBY	abby
RVBY	abby
RVC	apoorva
RVC	apoorva
RVDA	ayurveda
RVDH	abudhabi
RVDLV	adler
RVDNBRG	brandenburg
RVD	apoorva
RVD	apoorva
RVDRYGV	badry
RVDRYGZ	badry
RVDVLFAS	belfast
RVDVLF	adolf
RVDVLFVS	pavlovs
RVGALSKY	rogalsky
RVGVZA	afzal
RVHAN	hovhaness
RVHL	ahlstrom
RVHM	abdalrahman
RVHN	apoorva
RVHRR	aguirre
RVHR	ahriman
RVJAS	carvajal
RVKAN	afrikaner
RVKA	afrikaans
RVKN	apoorva
RVKRY	conakry
RVKSAN	alagesan
RVKSAN	alagesan
RVKV	apoorva
RVKYKY	apoorva
RVKZ	apoorva
RVLAND	auckland
RVLDAN	aldan
RVLFH	geervliet
RVLF	geervliet
RVLF	geervliet
RVLND	geervliet
RVLS	geervliet
RVLV	geervliet
RVLY	geervliet
RVMFVRT	roumfort
RVMRV	amran
RVMYG	academy
RVMYV	academy
RVNALD	aguinaldo
RVNDA	adirondack
RVNDH	gandhi
RVNDL	braendle
RVNDYN	andy
RVNGV	ingvar
RVNTRY	coventry
RVNY	cerveny
RVNY	cerveny
RVNYT	cerveny
RVPKH	akhmatova
RVPRT	albert
RVP	apoorva
RVRKH	arkhangelsk
RV	apoorva
RV	apoorva
RVR	apoorva
RV	apoorva
RVRY	abery
RVRYS	averys
RVSALYN	rosalyn
RVSAM	aissama
RVSAM	aissama
RVSANA	nirvana
RVSA	absalom
RVSKV	dnepropetrovsk
RVSL	ameslan
RVSLYN	roslyn
RVSLYN	roslyn
RVSNAL	aguinaldo
RVSNBLAT	rosenblatt
RVSNDAL	andalusia
RVSNDL	braendle
RVSNFLD	blumenfeld
RVSN	antevs
RVSNR	antevs
RVS	antevs
RVS	antevs
RVS	antevs
RVSR	antevs
RVSTAD	lovstad
RVSTND	bystander
RVSVLT	aaltje
RVSVN	antevs
RVSV	antevs
RVSV	antevs
RVSYALA	ayala
RVSYTR	forsyth
RVTABAGA	rutabaga
RVTGR	hultgren
RVTGRT	hultgren
RVTJ	aaltje
RVTJY	aaltje
RVTRFRD	barford
RVT	apoorva
RVT	apoorva
RVT	apoorva
RVT	apoorva
RVT	apoorva
RVT	apoorva
RVT	apoorva
RVTS	abbotsmith
RVTZ	adametz
RVVLVRY	calvary
RVVTH	horvath
RVVT	apoorva
RVVT	apoorva
RVYAH	aaliyah
RVYAL	ayala
RVYAPA	accapadi
RVYBL	byblos
RVYDN	haydn
RVYH	apoorva
RVYL	aeschylus
RVYLY	bayly
RVYMATA	mata
RVYN	kevyn
RVYN	kevyn
RVYPK	apocrypha
RVY	apoorva
RVYS	chevys
RVYS	chevys
RVYS	chevys
RVYTNBRG	roytenberg
RVYYZ	aliyyah
RVYZ	allyz
RVZMARY	dimaryp
RVZMARY	dimaryp
RVZNDAL	andalusia
RVZNFLDR	aldrich
RVZNJK	alkhazna
RVZN	alkhazna
RVZ	apoorva
RVZ	apoorva
RVZ	apoorva
RVZVLT	aaltje
RVZY	apoorva
RVZYR	zyrtec
RVZYR	zyrtec
RVZYTA	maytag
RYAD	arya
RYBAK	babak
RYBAR	aabar
RYBK	charybdis
RYB	charybdis
RYBRN	brno
RYCARD	bacardi
RYCARDSN	alphards
RYCARDSVN	alphards
RYCAR	bacar
RYCAV	bryce
RYCMN	bryce
RYCMYR	bryce
RYC	bryce
RYCR	bryce
RYCY	bryce
RYCY	bryce
RYDA	ayda
RYDA	ayda
RYDA	ayda
RYDH	bryde
RYDH	bryde
RYDJ	bryde
RYDKVYST	amethysta
RYDL	rydland
RYDNBRC	bryde
RYDNBRGYRBRAK	barborak
RYDN	bryde
RYD	bryde
RYDR	bryde
RYDYG	bryde
RYDY	bryde
RYFKAYND	ayn
RYGAN	aganovic
RYGARD	asgard
RYGLR	bryguy
RYG	bryguy
RYGV	bryguy
RYGYNZ	bryguy
RYHANA	bacchanalia
RYHANH	beyhan
RYHL	ryherd
RYJKARD	kardal
RYJ	abery
RYJSVYJK	rysavy
RYJSVYK	rysavy
RYJYNZ	marylynn
RYKARD	kardal
RYKARD	kardal
RYKR	masaryk
RYKRT	masaryk
RYKSVN	masaryk
RYKTZ	masaryk
RYKVLSVN	masaryk
RYKY	masaryk
RYLND	maryland
RYL	beryl
RYLSBK	beryls
RYLY	marylynn
RYMANT	ayman
RYMND	barrymore
RYMNZ	barrymore
RYM	barrymore
RYMRS	barrymore
RYMVND	barrymore
RYMVND	barrymore
RYMVND	barrymore
RYMVN	barrymore
RYMYL	barrymore
RYMY	barrymore
RYNAH	zaynah
RYNALDA	reenalda
RYNALD	reynaldo
RYNALDS	donalds
RYNALDZ	reynaldo
RYNDNR	rynders
RYNDRT	rynders
RYNDRZ	rynders
RYNG	bryn
RYNGST	kingston
RYNGVVD	bryn
RYNH	bryn
RYNKR	bryn
RYNLDA	aldan
RYN	bryn
RYN	bryn
RYNR	bryn
RYNR	bryn
RYNRT	bryn
RYNTVL	katryntje
RYNVD	bryn
RYNVLDA	aldan
RYNVLD	bryn
RYNVLD	bryn
RYNVLDS	reynolds
RYNVLDSVN	reynolds
RYNVLDZ	bryn
RYNVVD	bryn
RYPL	apocrypha
RY	abery
RYRDAN	bigourdan
RYRDAN	bigourdan
RYRDN	bringardner
RY	abery
RYRSVN	ayrshire
RYRZ	abery
RYSAH	rysavy
RYSALVYRT	rysavy
RYSAR	rysavy
RYSAVY	rysavy
RYSJY	averys
RYSKAR	baskar
RYSLVRT	chrysler
RYSLYNG	rysling
RYSLY	chrysler
RYSNR	averys
RYSNR	averys
RYSNYK	averys
RYSRC	averys
RYS	averys
RYS	averys
RYS	averys
RYS	averys
RYS	averys
RYSR	averys
RYSR	averys
RYSTV	chrystal
RYSTYNTJY	christyntie
RYSTY	chrystal
RYSVLVRT	averys
RYSVLVVRT	averys
RYSVR	averys
RYSVYK	rysavy
RYSY	averys
RYTAKV	alnitak
RYTA	chrystal
RYTCY	marytje
RYT	marytje
RYTSGRT	ritsgert
RYTVGR	marytje
RYTYSGRT	almatys
RYTZGRT	fitzgerald
RYTZ	marytje
RYTZR	fitzroy
RYVARD	edvard
RYVBR	abery
RYVDT	abery
RYVMLR	abdalrahman
RYVNSVN	aryans
RYVNVLD	groenveld
RYVPKA	konopka
RYVR	abery
RYV	abery
RYVRZ	abery
RYVV	abery
RYVYRH	abery
RYVYS	chevys
RYYAD	omayyad
RYYD	abery
RYYNKS	armonks
RYYR	abery
RYZ	ryzman
RYZR	ryzman
RYZVLVRT	calvert
RYZV	ryzman
RYZVY	ryzman
RZBRY	bryan
RZNBAVM	anbar
RZNFLD	blumenfeld
RZNKRANS	aldebarans
RZNLF	adolf
RZNMN	agamemnon
RZNTJY	ariaantje
RZVLVRT	calvert
RZYNT	chrescyntie
SAARTJ	saartje
SABGLASYAL	casablanca
SABHANY	abhay
SABLT	casablanca
SABRAMANYAM	subramaniam
SABRAMANYAN	subramanian
SAB	casablanca
SABTNS	abtine
SABT	abtine
SABVRYN	abery
SABVS	casablanca
SABYN	ratsaby
SABYNY	ratsaby
SACAT	sacajawea
SACK	cossack
SACR	sacramento
SADGRV	sadgrove
SADHA	adhara
SADLR	sadler
SADRBLAM	rollerblade
SADYAH	radeyah
SADYH	assad
SADYK	assad
SADYKV	assad
SADYKVYH	assad
SADYKYV	assad
SADYVP	assad
SAFR	afra
SAF	safavid
SAFT	aftab
SAFTVR	aftab
SAFTYN	aftab
SAGARS	vijayanagars
SAGA	sagady
SAGAYY	sagady
SAGN	agndie
SAGRV	agra
SAGRV	agra
SAHASY	sahasi
SAH	hafsah
SAHVLM	hafsah
SAJN	lissajous
SAJRV	lissajous
SAKAMVTV	sakamoto
SAKARY	sakari
SAKAYV	bakaya
SAKLAD	saklad
SAKLA	saklad
SAKSNA	isakson
SAKSNM	isakson
SAKS	isakson
SAKS	isakson
SAKSVN	isakson
SAKSYM	isakson
SAKTN	adisak
SAKT	adisak
SAKYA	shakya
SAKY	adisak
SALGA	algae
SALGVRV	rasalgethi
SALKRAS	balkhash
SALK	masalkhi
SALMVND	salmond
SALMY	kalmyk
SALTZMN	saltzman
SALTZ	saltzman
SALVMN	desalvo
SALVM	desalvo
SALVMVN	desalvo
SALYAN	kalyan
SALYGRAM	shaligram
SALYN	rosalyn
SALY	rosalyn
SALYT	rosalyn
SALYVAN	galvan
SALZBRG	salzberg
SALZNBRG	salzenberg
SAMADAR	samaddar
SAMAH	samah
SAMAKR	ramakrishna
SAMAN	samantha
SAMANTA	diamantaras
SAMANTA	diamantaras
SAMAR	samar
SAMAS	asamas
SAMBAT	korambath
SAMBVLYK	samblanx
SAMGYN	aissama
SAMH	aissama
SAMK	aissama
SAML	aissama
SAMN	aissama
SAMRAL	amaral
SAMR	aissama
SAMR	aissama
SAMRZ	aissama
SAM	aissama
SAMS	assams
SAMTYNG	tyng
SAMVLS	aissama
SAMVN	aissama
SAMVSKY	samosky
SAMVYL	aissama
SAMYR	gurusamy
SAMYT	gurusamy
SAMYT	gurusamy
SAMZ	aissama
SANAHAN	shanahan
SANANDV	anand
SANA	prasana
SANBRN	sansburn
SANCTY	lanctot
SANDAR	mandar
SANDHV	sandhu
SANDLYN	sandlin
SANDMAN	sandman
SANDRAM	casandra
SANDRM	alesandro
SANDRNZ	alesandro
SANDRS	alesandro
SANDRSVN	alesandro
SANDRZ	alesandro
SANDRZ	alesandro
SAND	alesandro
SANDYP	sandy
SANDY	sandy
SANGLD	angle
SANG	kisangani
SANG	kisangani
SANGV	kisangani
SANJAY	sanjay
SANJH	sanjay
SANJSTR	oranjestad
SANKAR	sankara
SANKN	sanka
SANKR	sanka
SANKR	sanka
SANK	sanka
SANK	sanka
SANLA	scanlan
SANLY	alagesan
SANNAR	eannarino
SANRANG	aurangzeb
SANRAYZ	casandra
SANRJH	alagesan
SANRTH	granroth
SANRTJY	saartje
SANRT	alagesan
SANSAYN	arkansan
SANSBRN	sansburn
SAN	alagesan
SAN	alagesan
SANSS	afrikaanss
SANST	arkansans
SANSVN	arkansans
SANTANA	santana
SANTA	santa
SANTH	anantha
SANTJ	santje
SANTJY	santje
SANTRTJ	antrosio
SANT	desanto
SANTSBRN	pleasants
SANTV	desanto
SANTVS	antevs
SANTVSY	antevs
SANTYK	blantyre
SANTY	blantyre
SANVNDV	alagesan
SANVN	alagesan
SANV	alagesan
SANYL	alagesan
SANY	alagesan
SANY	alagesan
SANYT	alagesan
SANZBVRN	sansburn
SANZ	sanz
SAPRV	apr
SAP	chesapeake
SARANN	saran
SARA	bulsara
SARATY	sarathy
SARDGNA	sardegna
SARDLV	ardley
SARDV	brassard
SARJH	amritsar
SARKNAS	sharknas
SARLVT	susarla
SARLY	baggarly
SARMA	sarma
SARNA	sarna
SAR	amritsar
SAR	amritsar
SARTAKSV	alnitaks
SARTH	arthers
SARTJ	bossart
SARTJY	bossart
SART	bossart
SART	bossart
SARTZR	bartz
SARVATH	horvath
SARVK	amritsar
SARY	anniversary
SARYVL	anniversary
SASAKY	hasakah
SASAN	casandra
SASKA	saskatchewan
SASLAV	saslav
SASMN	alisas
SASNHYM	alisas
SASN	alisas
SASTK	alisas
SASTYK	grasty
SASZH	sasze
SASZ	sasze
SASZY	sasze
SATFN	alsatian
SATFYN	alsatian
SATJ	alsatian
SATKAS	atka
SATN	alsatian
SATR	alcatraz
SATR	alcatraz
SAT	alsatian
SAT	alsatian
SATVN	alsatian
SATVN	alsatian
SATVR	alsatian
SATV	alsatian
SAVAN	kesavan
SAVARAM	savaram
SAVARS	savaram
SAVCVK	kesavan
SAVDY	chavda
SAVFRD	havard
SAVL	jouravlev
SAVL	jouravlev
SAVL	jouravlev
SAVLZ	jouravlev
SAVNDRZ	alesandro
SAVSAN	kesavan
SAV	kesavan
SAVTR	kesavan
SAVTR	kesavan
SAVTZ	savetz
SAVVY	kesavan
SAVYN	rysavy
SAVYR	rysavy
SAYBRMYJ	cybermage
SAYBRT	lindsay
SAYDA	ayda
SAYKS	isakson
SAYKV	lindsay
SAYLR	ayling
SAYMKV	ayman
SAYM	ayman
SAYMVN	ayman
SAYMVNS	caymans
SAYP	lindsay
SAYRY	sayre
SAYTJ	clayton
SAYT	clayton
SAYTV	bodhisattva
SAYTZ	clayton
SAYVRYNGLNT	adgeringelant
SAYVYRDYNGLANT	siuuirdingelant
SAYVYR	kayvon
SAZH	anasazi
SBASTYN	augustyn
SBASTYN	augustyn
SBAYN	ayn
SBHAN	sobhan
SBRA	abraham
SBRT	asbrink
SBRYANY	bryan
SBRY	asbrink
SBS	sbs
SBYRAH	byra
SBYRA	byra
SBYRH	busby
SBYSTN	bystander
SBYT	presbyterian
SDAH	alaisdair
SDAH	alaisdair
SDA	alaisdair
SDAY	domesday
SDGRV	lindgren
SDHA	abudhabi
SDH	abudhabi
SDLR	abdalrahman
SDRHLM	cederholm
SDRVV	adri
SD	alaisdair
SDS	adsett
SDVAL	lindvall
SDVR	advent
SDV	advent
SDYA	pandya
SDYH	addy
SDYK	dykes
SDYRA	byra
SFARD	abelard
SFRD	beresford
SF	bakersfield
SFYLD	rumsfeld
SGAL	agali
SGVRA	avraham
SHA	abshawe
SHRAB	hrabi
SHR	oshrin
SH	abshawe
SHYB	gooshy
SKANL	alaskan
SKARP	baskar
SKAR	baskar
SKLANY	auckland
SKMAN	akman
SKRNTN	bernt
SKSNM	chelyabinsks
SKSPYR	breakspear
SKSTN	blackstone
SKSTVN	austvollen
SKT	alaska
SKVYRA	byra
SKYVRYTY	bilinsky
SLAMKY	islam
SLAMN	islam
SLAR	abelard
SLARYR	hilary
SLAT	ekerslato
SLAY	ameslan
SLAYZ	ameslan
SLBRG	albright
SLBRG	albright
SLDN	adnams
SLDVN	advent
SLF	adolf
SLFY	adolf
SLJ	ameslan
SLJ	ameslan
SLK	alkabeer
SLMA	abdalmalik
SLMA	abdalmalik
SLMYDY	kalmyk
SLMY	kalmyk
SLNY	nadolny
SLR	abdalrahman
SL	ameslan
SL	ameslan
SLT	aaltje
SLTH	althea
SLTJH	aaltje
SLTVN	aaltje
SLVA	alva
SLVD	blvd
SLVDVF	blvd
SLVN	alva
SLVN	alva
SLVVD	alva
SLYJ	roslyn
SLYMANYH	hollyman
SLYMA	hollyman
SLYMH	hollyman
SLYM	hollyman
SLYM	hollyman
SLYNA	roslyn
SLYPRY	cyprian
SLY	roslyn
SLYTR	blyth
SLYV	roslyn
SMAH	asma
SMAL	dismal
SMALYAH	shamaliyah
SMALYH	chemaly
'SMAN	bertelsmann
SMAR	asmara
SMAR	asmara
SMA	asma
SMA	asma
SMAT	akhmatova
SMBHV	shambhu
SMBLNKS	ambler
SMH	abbotsmith
SMKVVN	abbotsmith
SMLY	somlyo
SMMA	amman
SMMR	abbotsmith
SMPL	champlain
SMPT	ampte
SMRN	smirnoff
SMR	abbotsmith
SMR	abbotsmith
SM	abbotsmith
SMSC	americanisms
SMSL	americanisms
SMVTYVK	abbotsmith
SMYAH	aaliyah
SMYH	smyley
SMYLH	smyley
SMYM	smyley
SMYRAH	myra
SMYRA	myra
SMYRA	myra
SMYRH	chernomyrdin
SMYR	chernomyrdin
SMYR	chernomyrdin
SMYR	chernomyrdin
SMYS	amys
SMYTLY	smythe
SMYZ	smyley
SNAN	anand
SNA	cessna
SNA	cessna
SNA	cessna
SNDBRG	lindberg
SNDFVRD	sandford
SNDHYL	aeschylus
SNDLYN	gwendolyn
SNDMN	grandmaster
SNDRS	alcindors
SNDRZ	alejandra
SND	abend
SNDS	amerinds
SNDVYK	lendvai
SNDY	andy
SNDZ	wendzel
SNFNG	bienfang
SNFTLYBN	senftleben
SNGAL	bangalore
SNGLVGLV	angle
SNG	addington
SNG	addington
SNG	addington
SNGVPTA	sengupta
SNGVTA	byungtae
SNHAL	sinhalese
SNJH	banjarmasin
SNKYAT	belenky
SNNRTJ	sannertje
SNNY	benny
SNQAN	qantas
SNR	bosnia
SNSBRN	sansburn
SN	bosnia
SNTJ	ariaantje
SNT	accenture
SNTYAGV	blantyre
SNVRY	convery
SNVTV	anvers
SNYRJH	chesny
SPARD	camelopardalis
SPARNDAM	spaarndam
SPASTYN	augustyn
SPHR	aphrodite
SPRD	hertzsprung
SPRYNGR	hertzsprung
SP	anspach
SPYNVAL	panvalkar
SPY	anspach
SRAB	arab
SRAFYN	arafat
SRASVL	accras
SRATVZA	israt
SRAYNH	rayner
SRCAK	arcadia
SRDAR	sardar
SRHYR	zephyrus
SRJH	arjuna
SRKAMB	kamb
SRKAN	arkansan
SRK	ark
SRKS	barksdale
SRKYAH	aaliyah
SRKYH	gorky
SRLD	adderley
SRL	adderley
SRLYNG	charlyn
SRLY	baggarly
SRMAN	ackerman
SRMN	ackerman
SRPNT	carpenter
SRQYH	albuquerque
SRR	aguirre
SRR	aguirre
SR	basra
SR	basra
SR	basra
SRSTA	bickerstaffe
'SRT	albert
SRTRYD	geertruyd
SRVADY	servadei
SRVARY	bovary
SRVMBC	abcher
SRVVD	apoorva
SRVYC	alyce
SRVYDYV	ackroyd
SRVYS	chevys
SRVY	apoorva
SRYA	arya
SRYF	abery
SRYF	abery
SRYNGTVN	addington
SRY	abery
SRY	abery
SRY	abery
SRYT	marytje
SRYVR	abery
SSADRY	alessandri
SSANY	alessandri
SSDRY	badry
SSYL	assyria
STARLVZN	aristarchus
STFANVS	stefan
STHVRAJAN	sethurajan
STLAYN	eastlake
STLND	eastland
STLR	anthistle
STL	anthistle
STMF	christman
STNT	castner
STRATVN	lysistrata
STRYTR	mistry
ST	abstract
STVFL	austvollen
STVRAMAN	janakiraman
STV	austvollen
STYVNSVN	augustyn
SVAFVRD	hannaford
SVAGATV	agate
SVAMY	amy
SVAMY	amy
SVANK	vankeuren
SVAN	bevan
SVAN	bevan
SVANYK	vandyke
SVANY	albany
SVARMN	varma
SVART	havarti
SVARYNGYN	bovary
SVAS	akhmatovas
SVA	osvaldo
SVAYDA	ayda
SVBHANDV	bachand
SVBVTKA	atka
SVCAN	african
SVDAN	adan
SVDAN	adan
SVDARMV	darmadi
SVDARSAN	sudarshan
SVDR	adri
SVDYP	addy
SVDYPTV	cryptozoic
SVDYR	addy
SVDZ	blvd
SVFN	boisvert
SVFR	aelfric
SVFYH	beyhan
SVFYLD	aeschylus
SVFY	boisvert
SVGN	agndie
SVGRLF	adderley
SVG	boisvert
SVHA	hovhaness
SVHAS	agathas
SVHA	hovhaness
SVHM	abdalrahman
SVKK	akkad
SVKLA	auckland
SVKVL	boisvert
SVKVMAR	amara
SVLAR	kevlar
SVLAYMNYAH	sulaymaniyah
SVLDR	aldrich
SVLD	osvaldo
SVLFVR	adolf
SVLK	alkabeer
SVL	boisvert
SVL	boisvert
SVLTAN	beltane
SVLT	aaltje
SVLTZ	baltzell
SVLVMVN	alva
SVLV	alva
SVLVVY	alva
SVLVYR	ogilvy
SVLVY	ogilvy
SVLY	alelyunas
SVLYS	allyson
SVLYTAS	acostas
SVMA	abdalmalik
SVMASYKAR	baskar
SVMJY	boisvert
SVMN	agamemnon
SVMR	amran
SVMRVYL	aeschylus
SVMVY	boisvert
SVMYKR	gromyko
SVNAR	achernar
SVNA	aamina
SVNDARAM	sundaram
SVNDRZ	alejandra
SVNGKRN	songkran
SVNGR	congregationalist
SVNGRVALA	carvallo
SVNG	svengali
SVNJA	banjarmasin
SVN	avniel
SVN	avniel
SVN	avniel
SVNSN	svens
SVN	avniel
SVNY	lyubovny
SVNY	lyubovny
SVPN	boisvert
SVPRATYK	pratap
SVPRYV	pryor
SVP	boisvert
SVRAB	arab
SVRAB	arab
SVRAJ	avraham
SVRANA	cranach
SVRK	ark
SVRL	adderley
SVRNSN	barnshaw
SVRN	abernathy
SVR	avraham
SVR	avraham
SVRS	abners
SVRSVN	chancellorsville
SVRTL	bartle
SVRTN	baumgartner
SVRVALY	carvallo
SVRYNDR	rynders
SVRYN	bryn
SVSAL	absalom
SVSA	absalom
SV	boisvert
SVSH	abshawe
SV	boisvert
SVSN	antevs
SV	boisvert
SV	boisvert
SV	boisvert
SVSYA	pogosyan
SVSYL	pennsylvania
SVTAN	afghanistan
SVTFN	boisvert
SVTN	baumgartner
SVTR	aaltruide
SVTR	aaltruide
SVTS	abbotsmith
SVTV	austvollen
SVYAK	divya
SVYDA	ayda
SVYDH	abudhabi
SVYFT	aftab
SVYLR	abdalrahman
SVYLR	abdalrahman
SVYNGLR	angle
SVYNRTVN	kevyn
SVYN	kevyn
SVYN	kevyn
SVYR	assyria
SVYTNKY	belenky
SVYTV	austvollen
SVYYNK	aliyyah
SVZALYS	alyson
SVZANA	azana
SVZANH	anhold
SVZA	afzal
SVZ	boisvert
SVZV	boisvert
SVZY	boisvert
SYANDRA	alejandra
SYANG	guiyang
SYANG	guiyang
SYANV	pogosyan
SYBACR	acropolis
SYBL	byblos
SYBL	byblos
SYBLT	byblos
SYBLY	blystone
SYBRT	sybil
SYDA	ayda
S'YDH	abudhabi
SYDLR	rydland
SYDLR	rydland
SYDMN	sydney
SYDNY	sydney
SYDR	hydra
S'YD	ackroyd
SYD	sydney
SYD	sydney
SYDVR	sydney
S'YDY	ackroyd
SYFARD	abelard
SYGL	kosygin
SYGL	kosygin
SYGLTVN	kosygin
SYGMN	kosygin
SYGMN	kosygin
SYGMN	kosygin
SYGMVND	kosygin
SYG	kosygin
SYGS	kosygin
SYHAN	beyhan
SYHN	houyhnhnm
SYHSVBHVN	sihsobhon
SYHY	polyhymnia
SYJH	assyria
SYJKV	assyria
SYJMN	agamemnon
SYKAGV	ashikaga
SYKAR	akar
SYKARV	karvinen
SYKR	psyko
SYK	psyko
SYKVLV	psyko
SYKVRA	avraham
SYKY	psyko
SYLA	bayla
SYLBRMAN	silberman
SYLBRMN	albright
SYLDN	pennsylvania
SYLDZ	pennsylvania
SYLK	pennsylvania
SYL	pennsylvania
SYLVAN	pennsylvania
SYLVA	pennsylvania
SYLVD	pennsylvania
SYLVNN	pennsylvania
SYLVRBRG	pennsylvania
SYLVRMN	pennsylvania
SYLVR	pennsylvania
SYLVRTVRN	pennsylvania
SYLVRVD	pennsylvania
SYLV	pennsylvania
SYLVVD	pennsylvania
SYLVYA	pennsylvania
SYLVYA	pennsylvania
SYLVY	pennsylvania
SYLVYV	pennsylvania
SYLYG	bayly
SYLYMAN	hollyman
SYLYMN	lymn
SYLY	bayly
SYLY	bayly
SYLYT	bayly
SYLZMN	holzman
SYLZ	pennsylvania
SYLZ	pennsylvania
SYMAL	abdalmalik
SYMARD	amardeo
SYMAYH	ayman
SYMBAB	mbabane
SYMLR	syme
SYMNDS	raymonds
SYMN	lymn
SYMN	lymn
SYMN	lymn
SYMN	lymn
SYMN	lymn
SYMNZ	lymn
SYMPLYSYTY	dalrymple
SYMR	syme
SYMR	syme
SYMS	syme
SYMS	syme
SYMSYK	psyko
SYMVDYNZ	dyna
SYMVNA	syme
SYMVNDS	raymonds
SYMVNH	syme
SYMVNH	syme
SYMVN	syme
SYMVN	syme
SYMVNSN	caymans
SYMVNS	caymans
SYMVNZ	syme
SYMVNZ	syme
SYMYNG	symington
SYMYNGTVN	symington
SYMYN	jacomyntie
SYMYN	jacomyntie
SYMZ	syme
SYMZ	syme
SYNA	calsyn
SYNAN	anand
SYNA	calsyn
SYNAYN	anay
SYNDLMN	braendle
SYNDRH	alejandra
SYNGLTVN	synge
SYNG	synge
SYNK	calsyn
SYNKLARY	hilary
SYNKLAYR	auckland
SYNKLR	bankler
SYNK	calsyn
SYNR	calsyn
SYN	calsyn
SYN	calsyn
SYN	calsyn
SYN	calsyn
SYN	calsyn
SYN	calsyn
SYN	calsyn
SYNTYA	resyntje
SYNV	calsyn
SYNVY	calsyn
SYNYBALDY	archibald
SYNYG	calsyn
SYNY	calsyn
SYPL	sisyphean
SYPLVAYDN	haydn
SYPLVYDN	haydn
SYPLZ	sisyphean
SYPMN	sisyphean
SYPN	sisyphean
SYPRYANV	aryan
SYP	sisyphean
SYRAFYN	syracuse
SYRAN	assyrian
SYRANT	arantes
SYRA	syracuse
SYRAY	syracuse
SYRCNT	assyria
SYR	assyria
SYRKVYS	assyria
SYRL	assyria
SYRLY	assyria
SYRR	assyria
SYR	assyria
SYR	assyria
SYR	assyria
SYRS	assyria
SYRS	assyria
SYRVKA	assyria
SYRVN	assyria
SYRVS	assyria
SYRVYZ	assyria
SYRYF	assyria
SYRYL	assyria
SYRYLV	assyria
SYRYNG	assyria
SYSABA	csaba
SY	assyria
SY	assyria
SY	assyria
SY	assyria
SYSK	bekesys
SYSLVNZ	bekesys
SYSLV	bekesys
SYS	bekesys
SYSTMZ	systems
SYSZ	bekesys
SYTARAM	antaramian
SYTA	forsyth
SYTAY	butaysh
SYTH	forsyth
SYTH	forsyth
SYTJ	sytje
SYTJY	sytje
SYTLAYV	atlanta
SYTLR	forsyth
SYTRAH	sitrah
SYTRA	abstract
SYTRH	forsyth
SYT	forsyth
SYT	forsyth
SYTS	forsyth
SYTV	forsyth
SYTYA	forsyth
SYTYH	forsyth
SYTY	forsyth
SYTYZN	forsyth
SYTZ	forsyth
SYTZ	forsyth
SYVALD	osvaldo
SYVALV	sunnyvale
SYVA	pennsylvania
SYVAYRDYNGLNT	siuuirdingelant
SYVLA	kevlar
SYVL	assyria
SYVMN	agamemnon
SYVNG	synge
SYVNKA	ankara
SYVN	assyria
SYVNYS	albanys
SYVRDYNGLNT	siuuirdingelant
SYVR	assyria
SYV	assyria
SYV	assyria
SYVSMNZ	abbotsmith
SYVVD	assyria
SYVYRDYNGLANT	siuuirdingelant
SYVY	assyria
SYVY	assyria
SYYVAYRDYNGLNT	siuuirdingelant
SYYVNYL	lyubovny
SYZNHYM	hyman
SZARV	arvesen
TABVK	aftab
TABYT	abyan
TAC	anastacia
TADR	adri
TAD	amstadt
TAFT	taft
TAFTZ	taft
TAFVN	bickerstaffe
TAGLV	tagle
TAHARA	tahara
TAHRYHA	ahriman
TAHVN	atahualpa
TAJH	ettajer
TAKA	jataka
TAKMN	akman
TAKR	akrill
TAKSBRY	alnitaks
TAKV	alnitak
TAKY	kitakyushu
TALAN	atalanta
TALBRG	albright
TALBVYZ	galbavy
TALKVT	alkabeer
TALMAYR	talman
TALMN	talman
TALMY	talmy
TALN	alnilam
TALNV	alnilam
TALS	chrystals
TALVANN	galvan
TALYBAH	talibah
TALYS	italys
TAMANA	bustamante
TAMARA	tamara
TAMAS	gautamas
TAMATYVS	instamatic
TAMAY	bustamam
TAMBRVS	alhambra
TAMB	tamburino
TAMPAS	tampas
TAMPKYNZ	stamper
TAMSN	abrahams
TAMSVN	abrahams
TAM	altamira
TAM	altamira
TAM	altamira
TAMYNZ	altamira
TAMY	altamira
TAMZ	altamira
TANAK	tanak
TANA	antanaitis
TANG	kuomintang
TANG	kuomintang
TANJS	afghanistan
TANKN	tutankhamen
TANN	britannia
TANTVN	constant
TANYS	brittanys
TAPA	accapadi
TAPLYN	staples
TAPR	apr
TAPSYN	calsyn
TAPTANY	brittany
TAPYK	dictaphone
TAPYN	dictaphone
TAPYV	dictaphone
TARA	antaramian
TARDL	ardley
TARKL	barkley
TARK	stark
TARML	anntar
TARN	amarnath
TARQ	anntar
TARS	gibraltars
TARSVN	gibraltars
TAR	anntar
TARVB	anntar
TARYK	masaryk
TASDYLR	tasdeler
TASKR	tasker
TATAM	statham
TATARY	tartary
TATBAY	greatbanks
TATH	statham
TATJ	aisenstat
TATL	aisenstat
TATL	aisenstat
TATRVY	aisenstat
TATSVRV	photostats
TAT	aisenstat
TAT	aisenstat
TAT	aisenstat
TATYH	aisenstat
TATYH	aisenstat
TATYL	aisenstat
TATZ	aisenstat
TAVARS	tavares
TAVRNYNY	tavernini
TAVR	amitava
TAV	amitava
TAYBVT	butaysh
TAYJMN	butaysh
TAYLBRY	taylor
TAYLMANS	caymans
TAYLMNZ	taylor
TAYLR	taylor
TAYLV	taylor
TAYMN	ayman
TAYNVR	ayn
TAYRAY	mayra
TAYR	ayres
TAYRVN	ayres
TAYRY	ayres
TAYSN	butaysh
TAYSVN	butaysh
TAY	butaysh
TAYT	butaysh
TAY	butaysh
TAYTY	butaysh
TAYV	butaysh
TBT	abtine
TBVK	austbanen
TBYB	byblos
TBYT	ostby
TDL	adler
TFYLAH	lylah
TFYLA	bayla
T'FYLH	adelheid
TGLBRG	albright
TGL	aglaia
THSYN	alioths
TH	abbotsmith
THYRAH	abdalrahman
THYRA	abernathy
THYRH	abernathy
TJAJH	cootjans
TJATJ	tjaatje
TKS	rutks
TK	aitken
TK	aitken
TK	aitken
TKYAH	aaliyah
TKYH	aitken
TLANDR	cortland
TLBRT	albert
TLBVYS	chevys
TLBVYZ	galbavy
TLFR	aelfric
TLKVM	alkabeer
TLLV	zollverein
TLNT	atlanta
TLR	abdalrahman
TL	anthistle
TLYBAH	alaqabah
TLYBA	cybanski
TLYBH	gently
TLYB	gently
TMBRY	alhambra
TMPLMN	champlain
TMPLR	champlain
TMPLTVN	champlain
TMPST	dempster
TM	altman
TMYR	chernomyrdin
TNANT	anant
TNAYA	benaya
TNBRVK	hillenbrand
TNBV	anbar
TNDYRY	andy
TNKN	keinknen
TNPV	baumgartner
TNTS	advents
TNT	accenture
TNVR	vanvranken
TNVRYV	convery
TNYKN	delikatny
TNYSAN	dionysian
TNY	delikatny
TPV	hotpoint
TQYH	beyhan
TRADA	estrada
TRAFTVN	trafton
TRAFVRD	trafalgar
TRAH	sitrah
TRAJKTNSYS	pansys
TRAKV	amtrak
TRAN	austranten
TRANYTSA	austranten
TRAP	trapp
TRAPYN	trapp
TRASH	strasheim
TRASTR	traster
TRA	abstract
TRAVAJLYA	travaglia
TRAVN	stravinsky
TRAVZY	stravinsky
TRAYKTNSYS	pansys
TRAYNTH	traynor
TRAYNTZ	traynor
TRAYNVR	traynor
TRAYSTNSYS	brays
TRAYSTNYS	brays
TRAYSY	brays
TRAZ	alcatraz
TRBRY	barbary
TRD	aaltruide
TRFVRD	barford
TRLD	aaltruide
TRLDY	chitrady
TRL	aaltruide
TRLV	aaltruide
TRMVYL	aaltruide
TRMYNAL	reynaldo
TRNR	aaltruide
TRNSH	barnshaw
TRNS	arbitrons
TRN	aaltruide
TRNTN	austranten
TRNT	austranten
TRNYK	czerny
TRSA	anniversary
TRS	pyotrs
TRSTVN	amherst
TRTJY	dievertje
TRTJY	dievertje
TRTNH	baumgartner
TRTVAN	bertrand
TRTVN	aaltruide
TRVB	aaltruide
TRVBY	aaltruide
TRVDL	aaltruide
TRVDSVN	aaltruide
TRVF	aaltruide
TRVGTVN	aaltruide
TRVHYKV	aaltruide
TRVKS	aaltruide
TRVL	geervliet
TRVL	geervliet
TRVLYNGR	allyn
TRVMBV	stromboli
TRVMYTR	myth
TRVN	aaltruide
TRVP	aaltruide
TRVRAYS	brays
TRVR	aaltruide
TRVRYK	masaryk
TRVRYS	averys
TRV	aaltruide
TRVTR	aaltruide
TRV	aaltruide
TRVT	aaltruide
TRVYLYGR	bayly
TRVYRYK	masaryk
TRVYSDYL	chevys
TRVYTH	blyth
TRVYTJ	katryntje
TRVYT	aaltruide
TRVYYJH	aaltruide
TRYBL	byblos
TRYBL	byblos
TRYDVY	strydom
TRYGS	bryguy
TRYJV	coventry
TRYK	coventry
TRYKTNSYS	pansys
TRYKT	coventry
TRYMSTAR	amstadt
TRYM	barrymore
TRYNDAD	trindade
TRYND	katryntje
TRYNHAM	denham
TRYNJH	katryntje
TRYNKL	katryntje
TRYNTH	katryntje
TRYNTJ	katryntje
TRYNT	katryntje
TRYNVR	katryntje
TRYPS	apocrypha
TRYQ	coventry
TRYS	coventrys
TRYSTNSYS	chrystal
TRYSTRM	chrystal
TRYSY	coventrys
TRYSY	coventrys
TRY	coventry
TRY	coventry
TRY	coventry
TRY	coventry
TRYTL	coventry
TRYTL	coventry
TRYTVRY	coventry
TRYVLV	coventry
TRYVRAYS	brays
TRYVR	coventry
TRYVYTZ	coventry
TRZH	dzerzhinsky
TSKR	blavatsky
TSLA	ameslan
TSLR	abbotsmith
TSNR	abbotsmith
TSTA	acosta
TS	abbotsmith
TSTR	abstract
TSYMA	ayman
TSYNK	solzhenitsyn
TTJY	aaltje
TTRAD	chitrady
TTR	bottrell
TTRV	bottrell
TTRVYN	bottrell
TVAMA	aissama
TVARY	bovary
TVAYCL	ayckbourn
TVB	austvollen
TVBVTYS	almatys
TVBYAS	libyas
TVBYN	bynon
TVDAR	adar
TVD	austvollen
TVFRY	fry
TVFTH	lufthansa
TVHLA	coghlan
TVKR	ackroyd
TVK	austvollen
TVKYV	austvollen
TVLANY	billany
TVLA	kevlar
TVLAY	balaye
TVLDV	advent
TVLMN	abdalmalik
TVL	austvollen
TVLYN	allyn
TVLY	alelyunas
TVLY	alelyunas
TVLY	alelyunas
TVLYVR	alelyunas
TVLYV	alelyunas
TVMANY	germany
TVMAS	alabamas
TVMAS	alabamas
TVMATYVS	almaty
TVMBLY	twombly
TVMS	abrahams
TVM	austvollen
TVMY	academy
TVMY	academy
TVMY	academy
TVMYTYVS	myth
TVMZ	austvollen
TVNAR	achernar
TVNGA	angara
TVNG	addington
TVNG	addington
TVNG	addington
TVNJS	austvollen
TVNR	austvollen
TVNS	abelsons
TVN	austvollen
TVNYS	albanys
TVNYS	albanys
TVNYS	albanys
TVNY	lyubovny
TVRAD	alvarado
TVRAMBR	alhambra
TVRAYA	laxminarayan
TVRBR	barbra
TVRDA	amsterdam
TVRKAT	arkansan
TVRKV	ark
TVRLDH	aldhafra
TVRMALA	tormala
TVRMN	ackerman
TVRNBRG	kornberg
TVRNLY	heinly
TVRNR	abernathy
TVRN	abernathy
TVRN	abernathy
TVRNTVN	bernt
TVRP	antwerp
TVRTL	bartle
TVRTN	baumgartner
TVRTVN	albert
TVRVF	apoorva
TVRVP	apoorva
TVRYA	arya
TVRYN	bryn
TVRYSN	averys
TVRY	abery
TVRZ	arzate
TVSAR	amritsar
TVSKANV	alaskan
TVS	antevs
TVSV	antevs
TVSYNG	synge
TVSYNK	calsyn
TV	austvollen
TV	austvollen
TVTY	almaty
TVVYS	chevys
TVYDA	ayda
TVYDY	ackroyd
TVYH	austvollen
TVYN	kevyn
TVYT	austvollen
TVYT	austvollen
TVYYDYL	dylan
TVYYG	aliyyah
TVYYN	aliyyah
TYBAT	abbate
TYBL	byblos
TYBVT	almaty
TYCAVR	avraham
TYD	ackroyd
TYF	almaty
TYFVRD	abelard
TYGV	stygian
TYHAN	beyhan
'TYH	almaty
TYJATH	abernathy
TYJMN	agamemnon
TYLBRY	albright
TYLDN	kettyle
TYLGNR	kettyle
TYLMANS	holmans
TYLMNS	autumns
TYLMNZ	kettyle
TYLN	kettyle
TYLR	kettyle
TYLR	kettyle
TYLV	kettyle
TYLVTSAN	alagesan
TYLYNG	marylynn
TYMBVL	cymbeline
TYMKV	tymen
TYMN	lymn
TYMN	lymn
TYM	tymen
TYMVNYN	conyne
TYMVR	tymen
TYMYAN	myanmar
TYMYNZ	jacomyntie
TYMZ	tymen
TYNANT	anant
TYNA	augustyn
TYNDAL	tyndale
TYNDAL	tyndale
TYNGLY	tyng
TYNG	tyng
TYNG	tyng
TYNSL	ansley
TYNSLY	ansley
TYN	augustyn
TYN	augustyn
TYN	augustyn
TYNY	augustyn
TYPAL	paypal
TYPV	linotype
TYRNY	blantyre
TYRVKS	blantyre
TYRYH	blantyre
TYRY	blantyre
TYRZA	arzate
TYSMNZ	tysmans
TYS	almatys
TYSYNJR	almatys
TYSZA	almatys
TY	almaty
TYTAY	butaysh
TYTH	blyth
TYTMAS	christmas
TYTS	tytie
TYT	tytie
TYT	tytie
TYTY	tytie
TYVGA	abigail
TYVMYNN	brynner
TYVNA	aamina
TYVNYS	albanys
TYVNYS	albanys
TYV	almaty
TYYVLN	aliyyah
TYZ	allyz
VADAPARTY	vadaparty
VADH	adhara
VADRY	badry
VADZN	nevada
VAFA	afa
VAFYAH	aaliyah
VAFYA	vaya
VAGL	travaglia
VAGNR	vagner
VAGNR	vagner
VAGN	vagner
VAH	jehovah
VAJDYK	vajdic
VAKFYLD	czechoslovakia
VAKRDAYN	saturday
VAKVRN	czechoslovakia
VALANS	alans
VALAS	alaska
VALDMANYVNA	waldmanneuenna
VALDMNNA	waldmanneuenna
VALDMNNYVYNA	waldmanneuenna
VALDMNYVNA	osvaldo
VALDRAM	waldram
VALDV	osvaldo
VALDZ	osvaldo
VALH	valhalla
VALKA	panvalkar
VALKNAR	panvalkar
VALMN	abdalmalik
VALNTYJN	valentijn
VALNTYN	valenti
VALN	alnilam
VALRYN	dalrymple
VALTMN	altman
VALTN	aaltje
VALTR	aaltruide
VALTRZ	aaltruide
VALTVN	aaltje
VALT	aaltje
VAL	avalon
VAL	avalon
VALVM	valvoline
VALVRT	calvert
VALVR	valvoline
VALV	valvoline
VALVYN	valvoline
VAL	avalon
VALYHVR	alya
VALYNGTN	alington
VALYNGTVN	alington
VALYN	rosalyn
VALYS	alyson
VALYS	alyson
VALY	alya
VALY	alya
VALY	alya
VALY	alya
VALYY	aliyyah
VALZ	alzena
VAMBVL	alhambra
VANANTVRP	vanantwerp
VANANVRP	vanantwerp
VANATVRP	devanathan
VANBRN	vanburen
VANBVRN	vanburen
VANDNBRQ	vandenburgh
VANDN	juvander
VANDRVYR	vanderveer
VANDRVYYR	vanderveer
VANDVSN	juvander
VANDVZN	juvander
VANDYK	vandyke
VANDZN	juvander
VANDZVN	juvander
VANG	evangelina
VANK	vankeuren
VANKVRN	vankeuren
VANKVRN	vankeuren
VANSCVNHVN	vanschoonhoven
VANSK	cybanski
VANSKVNHVN	cybanski
VANSY	donovans
VAN	bevan
VANVLK	vanvleck
VANVRANKN	vanvranken
VANVRNKN	vanvranken
VAN	bevan
VANZANT	vanzandt
VANZNDT	vanzandt
VARBRG	barbra
VARBRTVN	barbra
VARBRVG	barbra
VARBRVQ	barbra
VARBVRVG	almudevar
VARBVRV	almudevar
VARDY	edvard
VARGAS	vargas
VARGV	vargas
VARMA	varma
VARNR	varnes
VARNR	varnes
VARNS	barnshaw
VARN	varnes
VARN	varnes
VARNY	varnes
VARTVN	havarti
VARTY	varty
VARVL	varvel
VARYANS	aryans
VARYANTS	variants
VARYANTZ	aryan
VARYVR	bovary
VASALV	vasallo
VASKY	blavatsky
VASLV	akhmatovas
VASM	akhmatovas
VASNGTN	addington
VASNGTVN	addington
VAST	sevastopol
VAST	sevastopol
VASVN	akhmatovas
VAS	akhmatovas
VAS	akhmatovas
VASYK	akhmatovas
VASYM	akhmatovas
VASYNGTVN	synge
VASYT	akhmatovas
VATANAB	watanabe
VATANYB	atanacio
VATKYNZ	blavatsky
VATRHAVS	agatha
VATRMN	alcatraz
VATRSVN	alcatraz
VATRZ	alcatraz
VATS	blavatsky
VATV	blavatnik
VAT	blavatnik
VAVDRAY	airay
VAVDRY	vandry
VAYA	vaya
VAYB	playboy
VAYBY	playboy
VAYDMN	ayda
VAYD	ayda
VAYGL	solovay
VAYLDR	aldrich
VAYL	ayling
VAYMN	ayman
VAYNGRV	ayn
VAYNTH	cynthia
VAYN	ayn
VAYPKJ	paypal
VAYSMN	amways
VAYS	amways
VAYTHAVS	ghayth
VAYTHRN	ghayth
VAYTHVRN	ghayth
VAYTHVS	ghayth
VAYTVRS	clayton
VAYTYKR	clayton
VAYTYKR	clayton
VAYZAK	byzantine
VAYZ	solovay
VBR	abraham
VBSTR	abstract
VB	aabar
VCNR	breckenridge
VDAD	baghdad
VDBRG	edberg
VDLMVDY	abdalmalik
VDLYN	allyn
VDMYR	chernomyrdin
VD	blvd
VFA	afa
VFYAH	aaliyah
VFYH	beyhan
VFYYH	aliyyah
VGL	aglaia
VGL	aglaia
VGNR	agndie
VGNR	agndie
VHRA	bahrain
VJDAN	wijdan
VJYHA	beyhan
VJYHH	beyhan
VJYH	beyhan
VKKYA	shakya
VKRFAS	belfast
VKRV	ackroyd
VK	abdalmalik
VLADAK	ladak
VLADAN	vladan
VLADV	vlad
VLAM	vlaminck
VLAN	adgeringelant
VLA	kevlar
VLA	kevlar
VLDMN	feldman
VLDMNVNA	feldman
VLDMN	feldman
VLDN	adnams
VLD	aguinaldo
VLFSVN	adolfs
VLKMAN	volkman
VLK	alkabeer
VLK	alkabeer
VLMJH	abdalmalik
VLMN	abdalmalik
VLMTH	ramthun
VLMTJ	wellemtje
VLMT	abdalmalik
VLNTA	almintaqah
VLNTYJN	blantyre
VLNTYN	augustyn
VLR	abdalrahman
VLSKY	polsky
VLS	abduls
VLSY	calsyn
VLTMR	altman
VLTR	aaltruide
VLTRYNG	katryntje
VLTRY	aaltruide
VLTY	kelty
VLVDYN	blvd
VLVSV	pavlovs
VLYDH	clyde
VLYNGTVN	addington
VLYNK	allyn
VLYS	allyson
VLYS	allyson
VLZL	alzena
VLZ	alzena
VLZ	alzena
VNABLS	anabels
VNANTVRP	anant
VNASCVNVN	adrianas
VNBRN	brno
VNBVRN	swinburne
VNCVNHVVN	aconcagua
VNC	aconcagua
VNDAZN	adirondack
VNDLND	newfoundland
VNDL	braendle
VNDL	braendle
VNDMN	grandmaster
VNDRFVRD	vanderford
VNDRVR	alejandra
VNDRVYR	alejandra
VNDRY	landry
VNDVSN	lendvai
VNDVVSN	lendvai
VNDVZN	lendvai
VNDVZN	lendvai
VND	abend
VNDYK	mendyke
VNDZL	wendzel
VNG	addington
VNHF	aitkenhead
VNKATA	venkata
VNKAT	venkat
VNKRN	nkrumah
VNKRN	nkrumah
VNKVRN	abernathy
VNKVRN	abernathy
VNKV	ankara
VNKYVRN	belenky
VNKYVRN	belenky
VNLK	ainley
VNNTVRP	anntar
VNRNKN	keinknen
VNR	avniel
VNRYPR	apocrypha
VNSKVNHVVN	bilinsky
VNSL	ansley
VNS	abelsons
VNSVNHAVN	avniel
VNSVNHVVN	brownsville
VNTRLY	afrocentrism
VNTZ	bentz
VN	avniel
VNVLK	panvalkar
VN	avniel
VNVRANKN	vanvranken
VN	avniel
VN	avniel
VN	avniel
VNYK	lyubovny
VNYLK	lyubovny
VNYNGR	congregationalist
VNYRNKN	byrne
VNZANDT	vanzandt
VNZANT	byzantine
VNZND	vanzandt
VNZNT	accenture
VRBK	anderberg
VRBVRVF	anderberg
VRCYK	darcy
VRDAN	bigourdan
VRHVST	lovstad
VRKMN	parkman
VRLV	adderley
VRLYND	charlyn
VRLYNG	charlyn
VRMASRN	banjarmasin
VRMAS	banjarmasin
VRMA	ackerman
VRMVLN	ackerman
VRMVNT	armontrout
VRMYLYYVN	bayly
VRMYVLN	academy
VRMZ	ackerman
VRNGRYN	bryn
VRNN	abernathy
VRNR	abernathy
VRSVVN	chancellorsville
VRVBL	ablation
VRVJH	apoorva
VRVTH	horvath
VRVVD	apoorva
VRVVTJ	aaltje
VRVYJ	apoorva
VRYLAV	maryland
VRYLV	beryl
VRYTY	marytje
VRY	abery
VSAL	absalom
VSLYAN	kalyan
VSLY	roslyn
VSLZ	alzena
VSM	abbotsmith
VSTAL	christal
VSTFAL	westfall
VSTLY	priestly
VSTLY	priestly
VSTMVRLND	westmoreland
VSTN	castner
VSTRHLM	westerholm
VSTRN	abstract
VSTRVLDT	westerveldt
VSTRVLT	abstract
VSTR	abstract
VST	lovstad
VSTVN	austvollen
VSTVR	austvollen
VST	lovstad
VST	lovstad
VS	antevs
VSYM	syme
VSYT	forsyth
VSY	antevs
VSY	antevs
VTMVR	altman
VTR	aaltruide
VTR	aaltruide
VTS	abbotsmith
VT	yevtushenko
VVDARD	dardanelles
VVDBRN	brno
VVDD	addams
VVDGYT	adgeringelant
VVDHAVS	abudhabi
VVDN	adnams
VVDRV	adri
VVDVARD	edvard
VVD	blvd
VVGLR	abdalrahman
VVGL	aglaia
VVG	novgorod
VVJAK	djakarta
VVK	abdalmalik
VVLARD	abelard
VVLARD	abelard
VVLMN	abdalmalik
VVLTRNYNG	aaltruide
VVLY	alelyunas
VVLZ	alzena
VVN	avniel
VVN	avniel
VVRDN	bringardner
VVRYLAV	maryland
VVRYLV	beryl
VVS	antevs
VVTR	aaltruide
VYANN	maryann
VYBH	abhay
VYBKH	akhmatova
VYBRND	bernd
VYBVVV	byblos
VYB	byblos
VYBY	abby
VYCARD	bacardi
VYCVRA	avraham
VYDAD	ayda
VYDAL	abdalmalik
VYDAL	abdalmalik
VYDA	ayda
VYDD	ackroyd
VYDFANG	bienfang
VYDMAN	bodman
VYDMN	ackroyd
VYDMR	ackroyd
VYDRY	badry
VYDVN	ackroyd
VYD	ackroyd
VYDYR	ackroyd
VYDY	ackroyd
VYDYV	ackroyd
VYFAL	buffalo
VYGAND	gandhi
VYGAND	gandhi
VYGJYN	allyn
VYGLY	gillogly
VYGMVR	pygmalion
VYGN	cygnus
VYGRT	agra
VYGSTVN	austvollen
VYGTVN	addington
VYG	bryguy
VYGYNZ	alfonzo
VYJBRAND	wijbrand
VYJBRND	wijbrand
VYJDAN	wijdan
VYJNAND	wijnand
VYJND	abend
VYJNND	breanndan
VYJN	boldwijn
VYKAMP	goldkamp
VYKAS	alaskas
VYKAVN	avniel
VYKFYLD	aeschylus
VYKHAM	markham
VYKLVND	auckland
VYKNZ	alfonzo
VYKRAM	kram
VYKRS	krs
VYKRZ	ackroyd
VYKS	addicks
VYKS	addicks
VYKTVR	arktiki
VYKTVR	arktiki
VYKTYM	tymen
VYK	boyko
VYK	boyko
VYK	boyko
VYK	boyko
VYLADVT	advent
VYLARD	duchaylard
VYLARD	duchaylard
VYLASKV	alaska
VYLAS	kaylas
VYLATZ	blatz
VYLA	bayla
VYLA	bayla
VYLBR	albright
VYLDKAT	goldkamp
VYLDRMN	aldrich
VYLDYNG	baldington
VYLFRD	aelfric
VYLFRD	aelfric
VYLHAYT	ghayth
VYLHLMAS	almas
VYLHLMVS	engelholm
VYLHLM	engelholm
VYLJV	aeschylus
VYLKAKS	aksu
VYLKANS	balkans
VYLKAS	alaskas
VYLKNS	babylons
VYLKN	faulkner
VYLKRSVN	baylors
VYLKYNSN	balkans
VYLKYNSVN	balkans
VYLKYN	marylynn
VYLKYNZ	marylynn
VYLLMVS	allman
VYLMNTJY	almintaqah
VYLMR	abdalmalik
VYLMTJY	heyltje
VYLMT	abdalmalik
VYLMVR	abdalmalik
VYLMVT	abdalmalik
VYLMYNTH	cynthia
VYLMYNTJH	eyntje
VYLMYNTJ	eyntje
VYLMYNT	jacomyntie
VYLMYNYTH	blyth
VYLND	disneyland
VYLND	disneyland
VYLNR	aeschylus
VYLR	abdalrahman
VYLR	abdalrahman
VYLSVN	beryls
VYLS	beryls
VYL	aeschylus
VYL	aeschylus
VYL	aeschylus
VYLYAM	alya
VYLYAMYNA	yaminah
VYLYANY	kalyan
VYLYNGHAM	bingham
VYLYNGZ	marylynn
VYLYR	bayly
VYLY	bayly
VYLY	bayly
VYLY	bayly
VYLZ	aeschylus
VYLZ	aeschylus
VYMAL	abdalmalik
VYMAN	ayman
VYMAN	ayman
VYMBRLY	kimberly
VYMN	lymn
VYMPH	amphon
VYMPJH	dalrymple
VYMPJ	dalrymple
VYMPJY	dalrymple
VYMP	dalrymple
VYMPYJ	dalrymple
VYMR	amran
VYNATA	natalia
VYNBRG	brandenburg
VYNCSTR	abstract
VYNDN	kevyn
VYNDRZ	alejandra
VYNDVM	kevyn
VYND	kevyn
VYNKLMAN	winkelmann
VYNKL	bankler
VYNKLZ	bankler
VYNKV	kevyn
VYNLT	kevyn
VYNND	breanndan
VYNN	brynner
VYNRT	kevyn
VYNR	kevyn
VYNSNT	boleyns
VYNSN	boleyns
VYNSR	boleyns
VYNSTD	against
VYNSTRVM	boonstra
VYNSTVK	against
VYNSTVN	against
VYNSVN	boleyns
VYNTH	cynthia
VYNTJH	eyntje
VYNTJ	eyntje
VYNTJY	eyntje
VYNTRFYLD	winterfeld
VYNTRMYVT	afrocentrism
VYNTRR	afrocentrism
VYNTR	afrocentrism
VYNTRZ	afrocentrism
VYNTVN	chrescyntie
VYNT	chrescyntie
VYNTZ	bentz
VYN	kevyn
VYNVKR	kevyn
VYN	kevyn
VYNYBL	byblos
VYNYKY	kevyn
VYNYNGR	congregationalist
VYNYNGSTD	kingston
VYNYZ	kevyn
VYNZ	kevyn
VYPKJH	wiepkje
VYPKJ	wiepkje
VYPKJY	wiepkje
VYPK	apocrypha
VYPYN	pynchon
VYRAF	arafat
VYRCVAL	percival
VYRJYL	aeschylus
VYRJYNYA	bunyan
VYRNDRA	alejandra
VYRN	byrne
VYRSMA	forsman
VYRTANN	britannia
VYRT	myrtle
VYR	assyria
VYR	assyria
VYR	assyria
VYRYANA	wiryana
VYRZ	arzate
VYSAL	absalom
VYSKA	alaska
VYSL	chevys
VYSPY	chevys
VYSR	chevys
VYSR	chevys
VYSTFAL	westfall
VYSTVN	amethysta
VYST	amethysta
VYS	chevys
VYSVN	chevys
VYSVN	chevys
VYSY	chevys
VYSYVS	chevys
VYTAKA	jataka
VYTAKR	akrill
VYTAL	antal
VYTFYLD	bottfeld
VYTKAMB	kamb
VYTKVS	aitken
VYTMR	altman
VYTMVR	altman
VYTNBRG	roytenberg
VYTN	baumgartner
VYTN	baumgartner
VYTSH	hatsheput
VYTSVN	huntsville
VYT	blyth
VYTVL	austvollen
VYTVR	austvollen
VYTVRYA	arya
VYTV	austvollen
VYT	blyth
VYT	blyth
VYT	blyth
VYTYKR	ackroyd
VYTYK	almaty
VYTYNGTVN	tyng
VYTZ	adametz
VYVA	sunnyvale
VY	chevy
VYVKS	addicks
VYVK	chevy
VYVLA	kevlar
VYVR	avraham
VYVVR	avraham
VYVYANH	abyan
VYVYAN	abyan
VYVYK	boyko
VY	chevy
VY	chevy
VY	chevy
VYYRS	ayrshire
VYZBRAND	brand
VYZNAND	anand
VYZNRY	freemasonry
VYZN	alkhazna
VYZRNR	abernathy
VYZVN	allyz
VZDA	hvezda
VZYNA	dyna
XALDAH	aldan
XALYDH	aldhafra
XAN	alexander
XAY	phiaxay
XLYDA	ayda
XLYDH	clyde
XLYLH	carlyle
XRDL	ardley
YAGLA	yagla
YAGR	agra
YAKVB	kayak
YAKVLTY	kayak
YAKVTAH	yakootah
YAKVTA	akita
YAMAHA	yamaha
YAMAHA	yamaha
YAMHA	yamha
YAMN	amna
YAMYNAH	yaminah
YAMYNA	yaminah
YANGR	guiyang
YANG	guiyang
YANGY	guiyang
YANSVN	aryans
YANVVYTZ	abyan
YAN	abyan
YANYV	abyan
YANZK	yanzek
YAP	jayapura
YARGR	hargreaves
YARLA	barlas
YARMAN	yarman
YARVN	arvesen
YARVS	arvesen
YARYAN	yaryan
YASAR	yasar
YASR	araguayas
YASYN	araguayas
YASYRAH	yasirah
YASYRH	araguayas
YASY	araguayas
YATS	rubaiyats
YAV	aaliyah
YAYN	ayn
YKVTAH	atahualpa
YLND	disneyland
YLYC	alyce
YLYF	bayly
YMHA	amharic
YMN	lymn
YMYNH	jacomyntie
'YN	allyn
YRBRY	barbary
YRMYS	amys
YSRA	basra
YSRYH	ryherd
YSYRAH	syracuse
YSYRA	syracuse
YSYRH	assyria
YTR	aaltruide
YVBYRA	byra
YVFYNGTVN	addington
YVHANS	afghans
YVKYLV	jekyll
YVK	hyvonen
YVLYN	allyn
YVMANS	ahrimans
YVMN	agamemnon
YVMVRA	avraham
YVNAL	aguinaldo
YVNAS	adrianas
YVNGSAP	beckingsale
YVN	avniel
YVNSVN	brownsville
YVN	avniel
YVNYZA	byzantine
YVRANYM	ganymede
YVRBANYK	albany
YVRK	ark
YVRMV	ackerman
YVRYNA	bryn
YVSF	antevs
YVSTN	castner
YVS	antevs
YVSYV	antevs
YVSY	antevs
YVSY	antevs
YVZF	hyvonen
YVZR	ezra
YYKA	afrikaans
YYK	aliyyah
YYTZ	adametz
YYTZ	adametz
YZAK	byzantine
YZK	allyz
YZYD	ackroyd
ZABL	ablation
ZABZ	elizabeth
ZACARY	zachary
ZAFYNA	zafina
ZAGAR	zagar
ZAHD	fahd
ZAHYD	naugahyde
ZAKVB	ganzak
ZAKVB	ganzak
ZAKVMYNTAY	jacomyntie
ZAKYVS	ganzak
ZAK	ganzak
ZAKY	ganzak
ZALAN	zalan
ZAMVR	mazama
ZAMYT	amy
ZANGRL	zangerl
ZAN	azana
ZANKH	pankhurst
ZANKY	ankara
ZANK	ankara
ZANS	kazans
ZANT	byzantine
ZAPARA	zapara
ZARA	lazara
ZARRYTN	irizarry
ZARVS	arvesen
ZARYA	arya
ZARYH	anniversary
ZARYTN	marytje
ZARYTZN	marytje
ZATRVVD	alcatraz
ZAYNAH	zaynah
ZAYNA	zaynah
ZAYRA	mayra
ZAYR	ayres
ZAZA	zaza
ZFRY	fry
ZFYNA	dyna
ZFYNH	aitkenhead
ZHRA	bahrain
ZHRA	bahrain
ZHRA	bahrain
ZHYD	hyde
ZHYRAH	abdalrahman
ZHYRA	byra
ZHYRH	zaporozhye
ZJARYTJN	marytje
ZJARYTN	marytje
ZKH	akhmatova
ZKYAH	aaliyah
ZKYH	gretzky
ZKY	gretzky
ZK	bozkurt
ZK	bozkurt
ZLA	azlan
ZLR	abdalrahman
ZLTJ	aaltje
ZLYKAH	barakah
ZLYXA	alyx
ZMANK	boltzmann
ZMAN	boltzmann
ZMYRAN	cyrano
ZMYT	myth
ZNG	addington
ZNK	alkhazna
ZNTNR	zentner
ZNYKH	akhmatova
ZN	alkhazna
ZPKA	konopka
ZRA	ezra
ZRYA	arya
ZRYFA	mayfair
ZRYF	abery
ZRYH	ryherd
ZRYNK	bryn
ZRY	abery
ZVHANS	afghans
ZVHANSN	afghans
ZVKA	afrikaans
ZVLD	aguinaldo
ZVL	devlin
ZVLMR	abdalmalik
ZVLY	alelyunas
ZVLYKA	slyke
ZVNTK	accenture
ZVRYNK	bryn
ZVRYSYKA	averys
ZVTRVD	aaltruide
ZVTRVVD	aaltruide
ZVVAYTA	maytag
ZVVYTA	maytag
ZVYTA	maytag
ZVYTRVVD	aaltruide
ZVZF	ghazvanid
ZYGMVNT	zygmunt
ZYLT	heyltje
ZYL	zyl
ZYMRAN	amran
ZYNAH	zaynah
ZYNA	dyna
ZYNB	toynbee
ZYNH	aitkenhead
ZYNSR	boleyns
ZYRA	byra
ZYRYLY	marylynn
ZYR	zyrtec
ZYTV	austvollen
ZYVRYNK	bryn
ZYVTRVD	aaltruide
ZYZY	allyz
ZZA	belshazzar
ZZ	belshazzar
