AACTAY	mackay
AALTJ	aaltje
AAMYNA	aamina
AARVN	aaron
ABA	aba
ABAD	abad
ABADA	abad
ABADHBY	abudhabi
ABAJA	abuja
ABAR	aabar
ABCR	abcher
ABDJA	abidjan
ABDLRHMAN	abdalrahman
ABDVN	labdon
ABH	abhay
ABHAY	abhay
ABHY	abhay
ABLA	abella
ABL	abel
ABL	abel
ABLH	able
ABLHYD	abhay
ABLJ	abeltje
ABLT	ablett
ABLTJ	abeltje
ABLY	abley
ABLYSN	allyson
ABND	abend
ABNR	abner
'ABR	aabar
ABR	aabar
ABRAHAM	abraham
ABRAHYM	abraham
ABRAHYM	abraham
ABRAM	abram
ABRAMSVN	abramson
ABRAPT	abrupt
ABRAYT	brays
ABRBAC	eberbach
ABRG	aberg
ABRG	aberg
ABRKRVMBY	barraby
ABRL	cabral
ABRLY	abery
ABRMSKY	obremski
ABRT	albert
ABRT	albert
ABRVTR	brater
ABRY	abery
ABRY	abery
ABRYN	bryn
ABRYNY	bryony
ABSTGARTN	obstgarten
ABST	pabst
ABSTRKT	abstract
ABT	rabat
ABTYN	abyan
ABV	abel
ABVBA	aboba
ABVDBY	abby
ABVDHABY	abudhabi
ABVHBYB	abhay
ABVLYN	allyn
ABVRYMH	abrams
ABVT	ablett
ABVT	ablett
ABVTSMYT	abbotsmith
ABYA	abyan
ABYAB	abyan
ABY	raby
ABY	raby
ABYAD	abyan
ABYAN	abyan
ABYD	byrd
ABY	raby
ABYL	sibyl
ABYLAK	abyan
ABYNA	abyan
ABYNGM	byung
ABYNGN	bynon
ACDL	acadia
AC	ac
ACR	macra
ACRNAR	achernar
ACTY	lacy
ACTYH	macbeth
ACY	lacy
ACYLS	lacys
ACYSVN	alyson
ACYT	lacys
ADAB	adab
ADAM	adam
ADAMV	adam
ADANA	adana
ADAN	adan
ADANL	adan
ADARA	adhara
ADB	adab
ADBRG	sandberg
ADGRYNGLND	adgeringelant
ADGRYNGLNT	adgeringelant
ADGYNGTVN	edgington
ADH	radha
ADKAK	adisak
ADKK	adik
ADKRYK	masaryk
ADKVK	adik
ADKYNZ	adkins
ADKYRK	dunkirk
ADLA	adela
'ADL	adel
ADL	adel
ADLARDV	adelardo
ADLAYD	adelaide
ADLAYD	adelaide
ADLHYD	adelheid
ADLMA	adalma
ADL	adel
ADLR	adler
ADLSVN	adelson
ADLY	ardley
ADMVND	demavend
ADMVNDS	demavends
ADMVNDZ	demavends
ADMVNZ	advent
ADMYRALN	admiralen
ADMYRALZ	admirals
ADMYSTVN	edmiston
ADNAMS	adnams
ADNAMZ	adnams
ADNBRAG	brandenburg
ADNBRG	brandenburg
ADNBRV	anbar
ADNBRVG	brandenburg
ADNBVRG	brandenburg
ADRY	badry
ADRY	badry
ADRYANA	adriana
ADRYAN	aryan
ADRYANS	aryans
ADRYN	aryan
ADRYNKLNT	adgeringelant
ADRYNS	aryans
ADRYNY	bryony
ADRYNY	bryony
ADRYS	landrys
ADSAL	edsall
ADST	adsett
ADSVN	advent
ADT	adit
ADVARD	edvard
ADVARD	edvard
ADVARDSN	vardan
ADVART	adars
ADVLF	adolf
ADVLFSVN	adolfsson
ADVLF	adolf
ADVNCR	adventure
ADVNL	advil
ADVNYS	advents
ADVSVMALY	adusumalli
ADVVART	vandivort
ADY	eady
ADY	eady
ADY	eady
ADY	eady
ADY	eady
ADYH	radeyah
ADYK	vandyke
ADYKS	dykes
'ADYL	eady
ADYL	adil
ADYLRD	aylward
ADYNA	dyna
ADYNGTVN	addington
ADYNGTVN	addington
ADYS	andys
ADYSAK	adisak
ADYSVN	dyson
ADYT	adit
AFA	afa
AFAF	afaf
AFRA	afra
AFRDYT	fridays
AFRVDYT	fridays
AFTAB	aftab
AFV	afa
AFVRYL	avery
AFYCART	cathcart
AFYF	afif
AFYGTN	afghan
AFYNGTN	alington
AFYS	amys
AFYSR	kayser
AFYVN	kayvon
AFZAL	afzal
AFZL	afzal
AGALY	baggarly
AGAS	agass
AGATY	sagady
AGBRN	pangborn
AGBVRN	pangborn
AG	ag
AGLSTVN	agustin
AGMN	hageman
AGMVZ	ragatz
AGNDY	andy
AGNV	agni
AGNVYK	tanganyika
AGPYAN	agopian
AGR	agra
AGRAVALA	agrawala
AGRN	agren
AGRTN	agren
AGRTVN	agren
AGRYNGLANT	adgeringelant
AGRYNGLND	adgeringelant
AGVLV	agali
AGVR	agra
AGVSTV	agustin
AGVSTYN	augustyn
AGVSTYNLY	augustyn
AGVSTYNY	augustyn
AGVYRV	magyar
AGVYV	agoyo
AGYLA	argyle
AGYL	argyle
AGYLSVN	ayson
AGYNST	against
AHAY	abhay
AHLAND	hyland
AHMAN	ahriman
AHMN	ahriman
AHRN	ahern
AHY	athey
AHYH	ayah
AJ	raj
AJAST	rajas
AJAY	ajay
AJDA	majdal
AJLVS	alves
AJNT	aint
AJRAYNGLND	langland
AJYNGTVN	alington
AJYNTVN	paynton
AKA	aka
AK	aik
AKADMY	academy
AKADMYK	akademik
AKAKS	dakars
AKAPADY	vadaparty
AKBRG	aberg
AKBVRN	akbar
AKDAG	akdag
AK	aik
AKGAN	akgun
AKL	akl
AKLAND	oakland
AKLND	oakland
AKLVF	akiva
AKLY	ackley
AKLY	ackley
AKM	akeem
AKMAN	akman
AKMANDNSYS	ekmundensis
AKMANDSYS	mandys
AKMAN	akman
AKMNA	amna
AKMN	akman
AKMR	akar
AKMVNDNSYS	ekmundensis
AKMY	amy
AKN	akin
AK	aik
AKR	akar
AKRM	arm
AKRMAN	ackerman
AKRMN	ackerman
AKRSAND	eckersand
AKRSLATV	ekerslato
AKRSLYTV	parsley
AKRSTV	kristi
AKRT	prakrit
AKRVYD	ackroyd
AKRYL	darryl
AKS	saks
AKSAYL	kayla
AKSDLM	anselm
AKSFRD	ashford
AKSFVRD	ashford
AKSFVRD	ashford
AKSKRYTYA	fakhriyya
AKSLSVN	auslin
AKSLY	ansley
AKSS	aksu
AKSTRND	ekstrand
AKSTYN	augustyn
AKSV	aksu
AKSYL	kayla
AKTS	arts
AKTVN	lankton
AKTVN	lankton
AKTY	katy
AKTYV	katy
AKVAL	akiva
AKVAYLA	kayla
AKVAYL	kayla
AKVDV	saklad
AKVKS	akivas
AKVNA	akiva
AKVNR	akin
AKVSTA	avesta
AKY	laky
AKY	laky
AKYF	laky
AKYHYKV	akihiko
AKYLA	kayla
AKYLA	kayla
AKYLAH	akilah
AKYL	akil
AKYL	akil
AKYLH	akilah
AKYLS	kyles
AKYM	laky
AKYN	parkyn
AKYTVMV	akitomo
AL'ADYN	alaaldin
ALAHAYDYKYA	galahads
ALAHDVD	salahaddin
ALALDYN	alaaldin
AL	al
ALAM	alamo
ALAMZ	alamo
ALANA	alana
ALANGKV	lange
ALAPATY	alapati
ALAQBH	alaqabah
ALARD	allard
ALASR	alar
ALASVRS	alars
ALAVAY	calvary
ALAVY	galbavy
ALAYN	malayan
ALAYSDYR	alaisdair
ALAYS	malays
ALBAHAH	albahah
ALBHA	albahah
ALBHAH	albahah
ALBLJH	allah
ALBR	alber
ALBRAYT	galbraith
ALBRT	albert
ALBRTYNY	albertini
ALBRY	allbery
ALBRYJ	allbery
ALBVN	albion
ALBVZ	alba
ALBYNGR	albinger
ALDHAYD	aldhafra
ALDLHLD	adelheid
ALDN	aldan
ALDN	aldan
ALD	aldo
ALDR	alder
ALDRD	baldred
ALDRYC	aldrich
ALDRYDJ	aldridge
ALDRYG	aldridge
ALDRYG	aldridge
ALDRYJ	audreys
ALDRYJ	audreys
ALDRYJ	audreys
ALDRYJH	aldrich
ALDYN	aldan
ALDZ	valdez
ALFA	alfaro
ALF	alf
ALFANSV	alfonso
ALFARV	alfaro
ALF	alf
ALFRD	alfred
ALFRDV	alfred
ALFRS	alfors
ALFRYNG	elfering
ALFVRD	alford
ALFVRD	alford
ALGADV	alegado
ALGARD	asgard
ALGAYN	calgarys
ALGRV	alger
ALGSAN	alagesan
ALGY	palagyi
ALGYNGTVN	alington
ALHDAD	alhudud
ALHDVD	alhudud
ALJ	aaltje
ALJH	allah
ALKAN	kalkan
ALKBAH	talibah
ALKBR	alkabeer
ALKBYR	alkabeer
ALKK	alok
ALKMR	palikir
ALKMRH	almeroth
ALKMRY	amery
ALKR	walker
ALKRTN	alkerton
ALKRTVN	alkerton
ALKS	alaskas
ALKSANDR	alesandro
ALKSANDRVZ	alesandro
ALKSNDR	alesandro
ALKSY	halsey
ALKSYV	valkyrie
ALKVAB	alkabeer
ALKVK	alok
ALKVR	palikir
ALKYNGTN	alington
ALKYNGTVN	alington
ALKYNTN	elkinton
ALLADHKYAH	alladhiqiyah
ALLADHYKYAH	alladhiqiyah
ALLAHYGYAH	alladhiqiyah
ALLDHYKYAH	alladhiqiyah
ALLDYKYAH	aliyyah
ALLHYQYH	alladhiqiyah
ALM	alm
ALMAR	palomar
ALMAS	almas
ALMATVN	dalmatian
ALMGRN	almgren
ALMKVAST	almqvist
ALMKVYST	almqvist
ALMN	allman
ALMNTAJ	almintaqah
ALMR	almira
ALMRS	alars
ALMRVT	almqvist
ALMVD	talmud
ALMVDYVAR	almudevar
ALMV	alm
ALMVMAN	allman
ALMVR	almira
ALMYNAKAH	almintaqah
ALMYNTAGAH	almintaqah
ALMYNTAKAH	almintaqah
ALMYNTAKVA	almintaqah
ALMYNTKH	almintaqah
ALMYRAL	palmyra
ALN	alan
ALN	alan
ALND	walend
ALNDR	allender
ALN	alan
ALNVR	alnoor
ALNY	albany
ALPN	alpen
ALPRT	alpert
ALPVRT	alpert
AL'QBH	alaqabah
ALRBK	fairbank
ALRD	allard
ALRTN	allerton
ALRTVN	allerton
ALRVY	garvey
ALRY	malory
ALRYGH	albright
ALRYJ	malorys
ALSANDRY	alesandro
ALSAN	alaskan
ALSAN	alaskan
ALSAP	alsop
ALSAP	alsop
ALSAP	alsop
ALSNDRV	alesandro
ALSN	alison
ALSN	alison
ALSNR	elsner
ALSP	alsop
ALSP	alsop
ALSPD	alsops
ALSR	aleser
ALSTRVM	ahlstrom
ALSVN	alvin
ALSVN	alvin
ALSVN	alvin
ALSVP	alsop
ALSVP	alsop
ALSVRS	alvaros
ALSVRT	calvert
ALSVZ	alvarez
ALSY	halsey
ALT	alta
ALTANYN	albanys
ALT	alta
ALTAYR	altair
ALTMAN	altman
ALTMN	altman
ALTMN	altman
ALTRVAYD	rattray
ALTRVD	aaltruide
ALTRVYD	aaltruide
ALTRVYYD	aaltruide
ALTSVN	alton
ALTV	alto
ALTYR	altair
ALTZ	alta
ALVA	alva
ALVAN	galvan
ALVARV	alvaro
ALVARVS	alvaros
ALVARZ	alvarez
ALVAY	calvary
ALVF	alf
ALVKAL	alukal
ALVK	alok
ALVLD	alfeld
ALVRS	alvaros
ALVSA	alisa
ALVVD	blvd
ALVVD	blvd
ALVY	alley
ALVY	alley
ALVYN	allyn
ALVYN	allyn
ALVYN	allyn
ALVYN	allyn
ALVYN	allyn
ALVYS	sallys
ALVZ	alvarez
ALXZNA	alzena
'ALYA	alya
ALYA	alya
'ALY	laly
A'LY	alya
ALY	alya
ALYA	alya
ALYA	alya
A'LYAH	aaliyah
ALYAH	aaliyah
ALY	alya
ALY	alya
ALY	alya
ALYAN	kalyan
ALYAS	alyssas
ALYASVN	alyson
ALYBY	alibey
ALY	alya
ALY	alya
ALYFAS	alyssas
'ALYH	aaliyah
ALYJ	alya
ALYKS	alyssa
ALYLYVNAS	alelyunas
ALYMA	alya
AL'YN	allyn
ALYN	allyn
ALYN	allyn
ALYN	allyn
ALYN	allyn
ALYNGR	albinger
ALYNGTVN	alington
ALYNGTVN	alington
ALYN	allyn
ALYNYK	albanys
ALY	alya
ALYSA	alyssa
ALYS	alyssa
ALYS	alyssa
ALYS	alyssa
ALYSN	alyson
ALYSTVN	alyson
ALYSTYR	alistair
ALYSVN	alyson
ALYSVN	alyson
ALYSVN	alyson
ALYSVN	alyson
ALYSYA	alyssa
ALYVA	alya
ALYVRYA	aliyyah
ALYVT	salyut
ALYVT	salyut
ALYVY	lyly
ALYYA	aliyyah
ALYZA	alya
ALYZABT	elizabeth
ALYZ	allyz
ALYZR	allyz
ALZ	allyz
ALZNA	alzena
ALZN	alzena
ALZVRS	salazars
AMA	ama
AMADVR	amador
AMAGYV	palagyi
A'MAL	amal
AMAL	amal
AMAND	amand
AMANVAL	amaral
AMANV	amani
AMANVL	amani
AMANVYL	tammany
AMANY	tammany
AMANYVL	tammany
AMARA	amara
AMARAL	amaral
AMARDYV	amardeo
AMARNT	amarnath
AMARYT	amarit
AMBAR	aabar
AMBASY	embassy
AMBLR	ambler
AMBRLY	amberle
AMBRLY	amberle
AMBRLYNG	emberling
AMBRVSS	ambrosius
AMBRVSVS	ambrosius
AMBRVSYV	ambrosio
AMBRVSYVS	ambrosius
AMBVS	bambis
AMBYJ	abbys
AMDYV	amy
AMFN	amin
AMLAK	amlak
AML	amal
AMLK	amlak
AMLN	amin
AMLYA	alya
AMNA	amna
AMN	amin
AMNVN	amnon
AMPN	ampon
AMPRVR	amparo
AMPSVN	sampson
AMPT	ampte
AMPTH	sampath
AMPY	campey
AMRALD	emerald
AMR	amir
AMRJYNG	arling
AMRMAN	amerman
AMRVSYV	amery
AMRY	amery
AMRY	amery
AMRY	amery
AMRYKA	amerikan
AMRYKN	lamykin
AMRYKN	lamykin
AMRYTA	amritha
AMS	ams
AMSTAT	amstadt
AMSTD	amstadt
AMSTR	amster
AMSY	ramsay
AMT	amit
AMTYSTA	amethysta
AMVNA	amina
AMVNDSYZ	amundsen
AMVRVSV	amurs
AMVRY	amory
AMVS	ams
AMY	amy
AMY	amy
AMYH	samiyah
AMYHAY	abhay
AMYKVS	amys
AMYLY	smyley
AMYLY	smyley
AMYLYYV	smyley
AMYNA	ramayana
AMYNA	ramayana
AMYNH	samiyah
AMYRA	palmyra
AMYR	amy
AMYR	amy
AMYT	amyot
AMYTAVA	amitava
AMYT	amyot
AMYT	amyot
AMYVT	amyot
AMYVT	amyot
AMYZVTA	amyot
ANAGRAM	anagram
ANAKYN	anakin
ANALVG	analog
ANANDA	ananda
ANAND	anand
AN	ain
ANANSA	ananda
ANANT	anant
ANAS	anas
ANASTASYA	anastasia
ANATVLY	anatoly
ANATY	anatoly
ANAY	anay
ANAYLYN	anatoly
ANAYZA	santayana
ANAZ	anasazi
ANAZA	panza
ANBAR	anbar
ANBR	anbar
ANBV	anbu
ANCY	dancy
ANDAMZ	andaman
AND	and
AND	and
ANDNS	andenes
ANDRA	andra
ANDR	andr
ANDR	andr
ANDRBRG	anderberg
ANDRBVRG	anderberg
ANDRBY	enderby
ANDR	andr
ANDR	andr
ANDRR	anderer
ANDRS	andras
ANDRS	andras
ANDRSN	andersen
ANDRSN	andersen
ANDRSVN	anderson
ANDRVS	andris
ANDRVZ	andris
ANDRYA	landrys
ANDRY	landry
ANDRY	landry
ANDRYAS	landrys
ANDRYS	landrys
ANDRYS	landrys
ANDRYS	landrys
ANDRYSN	landrys
ANDRYSN	landrys
ANDRYVZ	landrys
ANDRYYA	landrys
ANDRYZ	landrys
ANDSVRS	andras
ANDSVRT	vandivort
ANDSVVRT	vandivort
ANDVLSN	andolsen
ANDYSL	andys
ANDYYVRANS	assyrians
ANFANT	enfant
ANFYLD	arnfield
ANGBRTSN	engebretsen
ANGH	anghe
ANGLAND	langland
ANGLANDR	langland
ANGLASMA	angelas
ANGLHARD	engelhardt
ANGLHLM	engelholm
ANGLHVRN	engelhorn
ANGLND	langland
ANGLS	angels
ANGLS	angels
ANGLSMA	engelsma
ANGLSVN	angevin
ANGLTH	langseth
ANGLTJ	angelita
ANGLTJH	engeltje
ANGLYNA	angelina
ANGLYS	angles
ANGLZ	angle
ANGRSVL	slangsvold
ANGVLV	angell
ANH	anghe
ANHLD	anhold
ANJBRTSVN	banjarmasin
ANJL	banjul
ANJLJY	ansley
ANJLS	angels
ANJLT	manjit
ANJLTJA	angelita
ANJLV	banjul
ANJLYNA	santayana
ANJLYS	manleys
ANJLYSYA	haniyya
ANJY	sanjay
ANJYLYNY	marylynn
ANKNY	ankeney
ANKR	anker
ANKRLY	ansley
ANKSTAD	annexstad
ANKVRN	anckorn
ANPYNGKV	enying
ANQ	ana
ANQH	anshu
ANRAH	sarah
ANR	andr
ANRYK	gantrys
ANRYKV	gantrys
ANRYKYV	ryukyu
ANRYKYYVZ	haniyya
ANSAR	ainsaar
ANSKAMB	anscomb
ANSL	ansell
ANSLM	anselm
ANSLMV	anselm
ANSLY	ansley
ANSLYN	ansley
ANSPAC	anspach
ANSR	mansur
ANSTYTV	antti
ANSY	pansy
ANSY	pansy
ANSYH	pansys
ANSYKR	sanskrit
ANTAL	antal
ANTANAYTYS	antanaitis
ANTARAMYAN	antaramian
ANT	aint
ANTH	anthea
ANTNA	santana
ANTRAPY	entropy
ANTRV	antero
ANTRVSYV	gantry
ANTRYKYN	entrikin
ANTSTL	anthistle
ANTSYTL	anthistle
ANTVN	anton
ANTVN	anton
ANTVN	anton
ANTVNVGLV	antonoglou
ANTVNVVYC	antonys
ANTVNY	antony
ANTVNY	antony
ANTVNY	antony
ANTVNYS	antonys
ANTVNYS	antonys
ANTVNYV	antony
ANTVNYVS	antonys
ANTVS	antevs
ANTY	antley
ANTYLA	antila
ANTYPDS	antipodes
ANTYSTL	anthistle
ANTYSTLH	anthistle
ANV	sanov
ANV	sanov
ANVAR	anbar
ANVCYN	anacin
ANV	sanov
ANV	sanov
ANVJYT	anujit
ANVKVL	anukul
ANVN	ann
ANVPAM	anupam
ANVP	anoop
ANVR	anvers
ANVR	anvers
ANVR	anvers
ANVRS	anvers
ANVS	antevs
ANVS	antevs
ANVTYYADYS	savoyards
ANVVY	anay
ANYART	enyart
ANYJMA	nyman
ANYL	anay
ANYL	anay
ANYL	anay
ANYMA	nyman
ANYNG	enying
ANYSA	anisa
ANYS	andys
ANYSH	ayush
ANYSTYN	augustyn
ANYVRSRY	anniversary
ANYVS	andys
ANYYV	haniyya
ANZALVNY	anzalone
ANZLVAR	anzlovar
ANZYNGR	enzinger
APCRC	alphecca
AP	apr
APL	apel
APL	apel
APLBAY	albany
APLBRG	appelberg
APLBY	appleby
APLBY	appleby
APLMN	aplin
APLNDS	laplands
APLYBY	playboy
APLYBY	playboy
APLYN	aplin
APNDYS	andys
APRAYT	pratt
APRLY	early
APRSVN	aperson
APRYL	april
APSTN	capistran
APSTVN	upston
APSTYN	epshteyn
APSYLVN	sylvan
APVNTH	aponte
APVRVA	apoorva
APYDAL	ayda
APYSTYN	augustyn
AQBAL	iqbal
ARAM	atram
ARAND	armand
ARAN	saran
ARARKH	parakh
ARAS	aras
ARAS	aras
ARASMVS	arianisms
ARAY	airay
ARAYZ	airay
ARBANAS	arbanas
ARBR	arber
ARBVR	arbur
ARBYD	araby
ARBY	araby
ARBYL	araby
ARBY	araby
ARCAL	archdale
ARCALH	arch
ARC	arce
ARCARD	orchard
ARCDALY	archdale
ARCDL	archdale
ARCDYL	archdale
ARCR	archer
ARCYBALD	archibald
ARDALYC	ardalich
ARDMN	hardiman
ARDN	arden
ARDRZ	sardar
ARDYS	faradays
AR	ar
ARFANAKYS	orfanakis
ARFVRD	barford
ARFYVS	daryls
ARGAN	garagan
ARGAN	garagan
ARGAR	margaret
ARHARD	earnhardt
ARKARD	barnard
ARKDYL	arkell
ARKTYKY	arktiki
ARLAYJ	barclays
ARL	aral
ARL	aral
ARL	aral
ARLT	arlet
ARLY	early
ARLYJ	carlys
ARLYNDH	riyadh
ARLYNG	arling
ARMAND	armand
ARM	arm
ARMASTRANG	armstrong
ARMATV	armato
ARMNY	armani
ARMRY	amery
ARMSRVNG	armstrong
ARMSTRANG	armstrong
ARMVNTRVT	armontrout
ARMVR	armour
ARMYN	aryan
ARMYTAJ	armitage
ARMYT	amyot
ARMYTAZ	armitage
ARN	arne
ARNAT	arnot
ARND	arend
ARNDT	arendt
ARNFYLD	arnfield
ARNH	arnhem
ARNLD	arnold
ARNST	earnest
ARNT	arnot
ARNT	arnot
ARNT	arnot
ARNTS	arantes
ARNVLD	arnold
ARNVT	arnot
ARNVT	arnot
ARP	earp
ARPYN	arpin
ARS	ars
ARSKAT	barakat
ARSKAYN	carskadon
ARSNALT	arsenault
ARSY	parsley
ARSYD	ackroyd
ARSYKR	arsikere
ARTL	martel
ARTR	arter
ARTRS	tartars
ARTRZ	martz
ARTVT	bartelt
ARTYS	martys
ARTYZ	martys
ARVAL	aral
ARVMA	sarma
ARVN	marvin
ARVNACALAM	arunachalam
ARVNAH	arunah
ARVND	arend
ARVNN	karvinen
ARVRKH	marrakesh
ARVSN	arvesen
ARVYNG	arling
ARVYVLA	arvola
ARYA	arya
ARYA	arya
ARY	arya
ARYC	arya
ARYFA	arya
ARYJ	arya
ARYKA	arya
ARYKA	arya
ARYK	masaryk
ARYK	masaryk
ARYKSN	aryan
ARYKSVN	aryan
ARYKSVN	aryan
ARYKSVN	aryan
ARYN	aryan
ARYNGTN	arlington
ARYS	marys
ARYS	marys
ARYS	marys
ARYSTVTL	aristotle
ARYZ	arya
ARYZ	arya
ARZAT	arzate
ARZ	ariz
ASAKVL	assakul
ASBL	asbell
ASBRN	asbrink
ASBRYNK	asbrink
ASBVRN	asbrink
ASCAFYLD	camfield
ASCAGN	mascagni
ASCRVVYC	ascoly
ASCVFYLD	schofield
ASCVYLAR	scoular
ASCYPLVDN	schipluiden
ASCYPLVYDN	schipluiden
ASCYPN	gascoyne
ASDS	assads
ASFAR	asmara
ASFYLD	ashfield
ASGVRYAN	asguarian
ASKADZ	assads
ASKAGN	alaskan
ASKAHAN	skahan
ASKAJN	alaskan
ASKALANT	atalanta
ASKAL	laska
ASKALYK	kalmyk
ASKALY	kamskaya
ASKANL	askanas
ASKANYL	askanas
ASKARP	baskar
ASKARS	ankaras
ASKARTSYS	skartsis
ASKARY	baskar
ASK	ask
ASKATV	laska
ASKATYA	kamskaya
ASKATY	kasaty
ASKAVN	skaven
ASKAYA	kamskaya
ASKAYLR	baskar
ASKAY	kamskaya
ASKAYT	kamskaya
ASKLDSVN	eskeldson
ASKLTN	skelton
ASKLTVN	skelton
ASKLVYR	astley
ASKNL	raskin
ASKNS	askanas
ASKP	ask
ASKRAB	krab
ASKRANTVN	austranten
ASKRAYZ	kamskaya
ASKRNTN	austranten
ASKRNTVN	austranten
ASKRVYC	survey
ASKRYBLYNG	marylynn
ASKRYBNR	aryan
ASKRYC	skerry
ASKRY	skerry
ASKRYS	averys
ASKRYV	skerry
ASKVAYRL	baskar
ASKVAYR	baskar
ASKVFYLD	ashfield
ASKVGAN	alaskan
ASKVLY	astley
ASKVLYNG	aveling
ASKVLYN	allyn
ASKVLY	astley
ASKVLYZ	allyz
ASKV	ask
ASKVRR	tasker
ASKV	ask
ASKVTVNY	astley
ASKVYLR	skylab
ASKVYVYL	baskerville
ASKYBA	skiba
ASKYLS	skylabs
ASKYNR	parkyn
ASKYN	parkyn
ASKYN	parkyn
ASKYPLADN	assyrian
ASKYPLVYDN	marylynn
ASKYPN	skype
ASKYP	skype
ASKYPY	skype
ASKYRS	assyrias
ASKY	jansky
ASKYTR	assyria
ASLANKARD	slankard
ASLAN	ameslan
ASLAN	ameslan
ASLAN	ameslan
ASLATKYN	slatkin
ASLATKYN	slatkin
ASLATR	slater
ASLATRY	slattery
ASLATVBR	slater
ASLAVK	saslav
ASLAVMYZ	allyz
ASLAVNBRG	slavenburg
ASLAVYN	slavin
ASLAYK	masaryk
ASLBVTNN	slabotnen
ASLD	auld
ASLMN	asselman
ASLNGZVALD	slangsvold
ASLP	aswalap
ASLR	basler
ASLS	basels
ASLSYNG	calsyn
ASLTN	alton
ASLTR	aster
ASLVAN	galvan
ASLVKAM	alukal
ASLVKA	asoka
ASLVMN	alvin
ASLVN	alvin
ASLVN	alvin
ASLVP	saslav
ASLY	astley
ASLYGRZ	allyz
ASLYMAN	ayman
ASLYNY	allyn
ASLYPR	alpert
ASLYP	astley
ASLYTY	almaty
ASLYVPAS	sliupas
ASLYV	astley
ASMA	asma
ASMADJ	smadja
ASMAL	amal
ASMALY	smalley
ASMART	smart
ASMAYT	almatys
ASMDLY	smedley
ASMLN	tasman
ASMVKY	smoky
ASMVLYK	amlak
ASMVLYN	allyn
ASMVR	asmara
ASMVT	asimov
ASMYD	amys
ASMYKLA	smikla
ASMYL	smyley
ASMYLY	smyley
ASMYRNV	assyrian
ASMYT	amyot
ASMYTSVN	rasmussen
ASMYTVYK	smyley
ASMYTZ	smythe
ASMYTZ	smythe
ASNAG	masnaa
ASNAYDR	snyder
ASNDN	ashenden
ASNL	anil
ASNL	anil
ASNLYNG	snelling
ASNR	casner
ASNVDN	ashenden
ASNVFYLD	arnfield
ASNVGRS	anvers
ASNV	masna
ASNYD	snyder
ASNYL	anay
ASNYSL	andys
ASPANGLR	spangler
ASPARDAM	spaarndam
ASPARKS	sparks
ASPARNDAM	spaarndam
ASPAR	gaspar
ASPARV	kasparov
ASPARZA	esparza
ASPATAFVRA	spatafora
ASPAT	spath
ASPATSVVD	kasparovs
ASPATZ	spatz
ASPAVLDYNG	spaulding
ASPAYDR	gaspar
ASPAYDRZ	esparza
ASPAYK	masaryk
ASPAYKS	sparks
ASPAYNYNG	pyongyang
ASPAYRZ	esparza
ASPAYZ	spatz
ASPLMN	spelman
ASPLYD	spleid
ASPLYNTR	splinter
ASPNSR	aspens
ASPNS	aspens
ASPRAG	sprag
ASPR	gaspar
ASPRVT	kasparovs
ASPRYBRY	sprayberry
ASPRY	sperry
ASPVLARYC	spolarich
ASPVLARYX	playtex
ASPVR	gaspar
ASPVRY	sporay
ASPVSTA	spousta
ASPVSYTV	esposito
ASPVTYS	chasitys
ASPYDN	aspen
ASPYLMN	spelman
ASPYNAK	spinak
ASPYNDRYFT	spindrift
ASPYN	aspen
ASPYRAS	assyrias
ASPYR	gaspar
ASPYR	gaspar
ASPYRV	kasparov
ASPYRV	kasparov
ASPYRYNG	spearing
ASPYRZ	kasprzak
ASPYRZ	kasprzak
ASPYSAK	spisak
ASPYSYK	magsaysays
ASPYT	spit
ASPYTZR	spitzer
ASPYVAK	spivak
ASPZYTV	kasparov
ASRAT	israt
ASRAYYL	parayil
ASRMN	asherman
ASTABRT	astarte
ASTABZ	rastaban
ASTAD	amstadt
ASTAD	amstadt
ASTAFL	falstaff
ASTAFVRD	stafford
ASTAG	stagg
ASTAJANV	stajano
ASTAKMN	astrakhan
ASTAKR	astaire
ASTAKSLAJR	stockslager
ASTAKS	astanas
ASTAKY	pataky
ASTAKY	pataky
ASTALKH	masalkhi
ASTAMPR	stamper
ASTAM	assam
ASTANGYR	stangier
ASTANVL	ratanvel
ASTAPLYC	stuplich
ASTARBAK	starbuck
ASTARGS	astartes
ASTARGYL	argyle
ASTARK	stark
ASTARKYP	starkey
ASTARKY	starkey
ASTAR	astaire
ASTAR	astaire
ASTARTLD	startled
ASTART	astarte
ASTARTZ	startz
ASTARYNGR	staringer
ASTARZ	startz
ASTAS	avestas
ASTATM	astarte
ASTATRZ	astaire
ASTATZMN	stutzman
ASTAYLZ	eastway
ASTAYNLS	astanas
ASTAYNMN	astanas
ASTAYN	astana
ASTAYR	astaire
ASTBAY	eastway
ASTCNYK	gasconys
ASTDLR	stadler
ASTDMN	stedman
ASTDYNA	astana
ASTFANS	stefans
ASTFAN	stefan
ASTFAN	stefan
ASTFANVS	stefans
ASTFANV	stefan
ASTFANZ	astana
ASTFN	aston
ASTFNSVN	stinson
ASTGN	aston
ASTK	astik
ASTLR	astor
ASTLY	astley
ASTLYK	astley
ASTLY	astley
ASTNFRD	stanford
ASTNFVRD	stanford
ASTNFVRT	stenfort
ASTNKAMB	astanas
ASTNSL	astanas
ASTNSRAD	stensrud
ASTN	aston
ASTNTJY	steentje
ASTPKN	stepken
ASTPK	astik
ASTRABRYJ	araby
ASTRADR	strader
ASTRAKMN	astrakhan
ASTRAK	amtrak
ASTRANDR	ostrander
ASTRAP	kastrup
ASTR	aster
ASTRASYM	strasheim
ASTRAVB	straub
ASTRLYNG	sterling
ASTRMLR	stremler
ASTRN	eastern
ASTRND	strand
ASTRN	eastern
ASTRVK	astik
ASTRVM	ahlstrom
ASTRVS	easters
ASTRVSTRAP	stroustrup
ASTRYAN	stroyan
ASTRYBL	gastrell
ASTRYD	astrid
ASTRYDM	strydom
ASTRYDR	astrid
ASTRYM	strydom
ASTRYN	stroyan
ASTRYNGR	stringer
ASTRYNJR	katryntje
ASTRYN	stroyan
ASTRYNY	stroyan
ASTRYR	strayer
ASTRY	stray
ASTRYTY	astarte
ASTS	easts
ASTVARD	bastard
ASTVART	astarte
ASTVBRYJ	glastonburys
ASTVDVLA	stodola
ASTVFL	austvollen
ASTVKLAS	stoklas
ASTVK	astik
ASTVK	astik
ASTVKVL	astik
ASTVKY	astley
ASTVLK	astik
ASTVLR	astor
ASTVL	gastli
ASTVN	aston
ASTVNBRAYJ	glastonburys
ASTVNSN	stevenson
ASTVN	aston
ASTVN	aston
ASTVR	astor
ASTVRGA	storga
ASTVRLYR	strayer
ASTVRMZ	astoria
ASTVRR	austvorren
ASTVRYM	strydom
ASTVRY	astley
ASTVRY	astley
ASTV	astik
ASTVVAL	stovall
ASTVY	astley
ASTYANSN	stiansen
ASTYBL	sybil
ASTYBR	aster
ASTYD	astrid
ASTYGBRG	stigberg
ASTYGMN	stygian
ASTYGRS	assyrias
ASTYG	astley
ASTYJH	ayah
ASTYK	astik
ASTYKLMN	stickelman
ASTYLR	astor
ASTYL	astley
ASTYL	astley
ASTYL	astley
ASTYLY	astley
ASTYLZ	styles
ASTYN	aston
ASTYNBRG	stenberg
ASTYNSN	carstensen
ASTYN	aston
ASTYN	aston
ASTYNSVN	stinson
ASTYNTH	styntie
ASTYNTJH	martyntje
ASTYNTJ	martyntje
ASTYNZ	astana
ASTYPLZ	elastoplast
ASTYP	astley
ASTYRN	styron
ASTYRNZ	styrons
ASTYSY	magsaysay
ASTYSY	magsaysay
ASTYT	astley
ASTYVDNT	stuyvesant
ASTYVN	aston
ASTYVNSVN	stevenson
ASTYVS	styles
ASTYVZ	astley
ASVALAP	aswalap
ASVALD	osvaldo
ASVANAY	sanjay
ASVK	ask
ASVLT	alta
ASVRS	anvers
ASVSKY	stanislavsky
ASVYSR	ashleys
ASYA	assyria
ASY	daisy
'ASYF	asif
ASYF	asif
ASYMYLYT	smyley
ATANSYV	satans
ATA	alta
ATA	alta
ATARAS	ataras
ATH	rath
ATJH	atish
ATKA	atka
ATKYNSN	atkinson
ATKYNSVN	atkinson
ATKYNZ	atkins
ATKYNZ	atkins
ATL	atle
ATLS	atlas
ATMSFR	amster
ATMZ	atems
AT	at
ATRAM	atram
ATR	atri
ATRTN	atherton
ATRY	gantry
ATRYSPS	atropos
ATRZ	atri
ATTLY	astley
ATV	at
ATVATR	aviator
ATVD	astrid
ATV	at
ATVL	atul
ATVL	atul
ATV	at
ATV	at
ATVSAN	latvian
ATVS	antevs
ATVSY	patsy
ATVVD	david
ATVVL	advil
ATVYL	atiya
ATYA	atiya
ATY	katy
ATYG	tyng
ATYLRD	aylward
ATYLRDH	aylward
ATYLYV	bayly
ATYNGR	tysinger
ATYNY	antony
ATYNZVN	teynton
ATYS	katys
ATYVL	pathyil
ATYYA	atiya
AVACA	oaxaca
AVAD	havard
AVADYA	vaya
AVALD	ragnvald
AVAN	avian
AVANZ	avian
AVASTY	almaty
AVBAJA	abuja
AVBRAYAN	bryan
AVBRDVRFR	oberdorfer
AVBRHVLZ	oberholz
AVBRHYM	abraham
AVBR	alber
AVBRTAS	albertas
AVBRY	avery
AVBRY	avery
AVBYD	savoyard
AVBYNGM	albinger
AVCARD	bacardi
AVCAR	bacar
AVCLND	auckland
AVCZ	acs
AVDDY	addy
AVDKRYK	averys
AVDKYRK	valkyrie
AVDL	adel
AVDLY	audley
AVDRA	audra
AVDRGV	aldridge
AVDVAK	adisak
AVDVN	advent
AVDV	advil
AVDYVM	raverdy
AVFNR	fafnir
AVFYNGTVN	alington
AVGAR	avogadro
AVGBVRN	pangborn
AVGLT	aoglat
AVGNH	lavigne
AVGNYV	cagney
AVGVR	alger
AVGVRY	avery
AVGVST	august
AVGVSTV	august
AVGVSTYN	augustyn
AVGYNH	zaynah
AVHALVRAN	ohalloran
AVHRMN	ahriman
AVJN	avon
AVKLND	falkland
AVKLY	stavely
AVKR	akar
AVKRAYN	averys
AVKR	akar
AVKSLY	ansley
AVKSTVN	galveston
AVKSVL	akil
AVKT	akita
AVKTS	avestas
AVKTZ	savetz
AVKYNZ	parkyn
AVKYTS	averys
AVLAFSVN	olafson
AVLA	avila
AVL	avila
AVLAYVVLA	layla
AVLD	auld
AVLDKVRN	aldrin
AVLDRAYT	aludras
AVLDRYJ	averys
AVLDZ	valdez
AVLMN	allman
AVL	avila
AVLSN	avalon
AVLSN	avalon
AVLSVN	allison
AVLSVN	allison
AVLVSTAD	ulvestad
AVLYMA	alya
AVLYNG	aveling
AVLY	stavely
AVLY	stavely
AVLYVYH	aliyyah
AVLYVYR	lyly
AVMAKY	almaty
AVMBRGR	baumberger
AVMGA	amiga
AVMLAS	avilas
AVMR	amir
AVNAT	anant
AVN	avon
AVNAYZA	santayana
AVNAYZ	anay
AVNGLYSTA	evangelista
AVNG	aveling
AVNSTY	ansley
AVNSVN	anson
AVNVSKV	avins
AVNYL	avniel
AVNYL	avniel
AVNZ	lanz
AVQVAQ	aviva
AVRAHAM	avraham
AVRAM	avram
AVRAYL	karayel
AVRAYS	averys
AVRAYZ	airay
AVRAYZ	airay
AVRBN	daverin
AVRCARD	orchard
AVRDALN	aurdalen
AVRFYVS	averys
AVRGAN	garagan
AVRHAN	avraham
AVRHAN	avraham
AVRHART	earhart
AVRHRT	earhart
AVRHV	avraham
AVRKLYVN	aurkleven
AVRKNY	orkney
AVRLANDV	garland
AVRL	averell
AVRLYNZ	marilyns
AVRMA	avram
AVRM	avram
AVRMSPVRDN	ormesporden
AVRN	lavern
AVRNVPN	aurnupen
AVR	avram
AVRSBRG	eversberg
AVRSLR	aversa
AVRTS	arts
AVRTYZ	averys
AVRVM	avrum
AVRV	marv
AVRVYL	avery
AVRY	avery
AVRYGA	arya
AVRYK	averys
AVRYL	avery
AVRYL	avery
AVRYNTS	aryans
AVRYS	averys
AVRYS	averys
AVRYS	averys
AVRY	avery
AVRYVLY	marylynn
AVRYVN	aryan
AVRYVRDAN	aryan
AVRYZ	averys
AVSAL	faisal
AVSBVRN	asbrink
AVSBVRN	asbrink
AVSLANDR	auslander
AVSLYNA	alelyunas
AVSN	arvesen
AVSN	arvesen
AVSNZ	arvesen
AVSTBANN	austbanen
AVSTHAMARN	austhamaren
AVSTLYC	astley
AVSTNDVRP	oostendorp
AVSTRANDR	ostrander
AVSTRNDR	easterner
AVSTVLYN	austvollen
AVSTVRYN	austvorren
AVSTYN	augustyn
AVSYVN	calsyn
AVSYZ	allyz
AVTAGVRV	altair
AVTA	avesta
AVTH	laith
AVTJH	atish
AVTJ	aaltje
AVTLV	pavlov
AVTLV	pavlov
AVT	ait
AVT	ait
AVTRY	avery
AVTVLYNY	allyn
AVTV	aviva
AVTYS	averys
AVVLYV	pavlov
AVVRDAL	kardal
AVVRPK	overpeck
AVYAN	abyan
AVYARS	savoyards
AVYCAY	avichay
AVYK	davy
AVYNAS	avinash
AVYNG	ayling
AVYNZ	ayn
AVYRSA	aversa
AVYS	averys
AVYSNA	alyssa
AVYVA	aviva
AVYVN	kayvon
AVZBRN	lavern
AVZGVR	ozgur
AVZMN	saltzman
AVZVNYS	albanys
AYALA	ayala
AYBAC	zayac
AYBAR	aabar
AYBL	sybil
AYBYRVNK	asbrink
AYCAS	alyces
AYCBVRN	ayckbourn
AYCYRV	cyr
AYDA	ayda
AYDA	ayda
AYDAN	ayda
AYDMN	ayman
AYDNBVRG	rydberg
AYD	ayda
AYDS	ayda
AYDVAYSVZ	mandalays
AYDVRY	audrey
AYDYD	omayyad
AYDY	ayda
AY	ray
AYF	nayfeh
AYFJH	nayfeh
AYFJ	nayfeh
AYFVFL	baffle
AYFV	mayfair
AYGAN	ayman
AYGLASTVN	gladstone
AYGLSTVN	augustin
AYGLV	ayala
AYGLY	bayly
AYGRT	maigret
AYGRTVN	agren
AYGV	ayling
AYGVR	augor
AYJH	ayah
AYJLSTVN	alston
AYJVYN	kayvon
AYK	kayak
AYKAM	jayaram
AYKARVS	ankaras
AYKBRN	ayckbourn
AYKBVRN	ayckbourn
AYKH	ayah
AYKLVZAN	sylvan
AYKN	lamykin
AYKVK	kayak
AYLANA	alana
AYLAN	ayman
AYLKA	ayala
AYLMYN	allyn
AYLPV	alpo
AYLR	aylor
AYLSA	ailsa
AYLTH	aylott
AYLVARD	aylward
AYLVR	aylor
AYLVT	aylott
AYLVT	aylott
AYLVYZA	allyz
AYLYA	rayya
AYLYDYV	bayly
AYLYN	marylynn
AYLYN	marylynn
AYLYN	marylynn
AYLYNG	ayling
AYLYN	marylynn
AYLYS	bayly
AYLYS	bayly
AYLZ	fayiz
AYM	ayman
AYMAN	ayman
AYMAN	ayman
AYMANTZ	ayman
AYMAR	aymara
'AYMN	ayman
AYMN	ayman
AYMN	ayman
AYMRY	amery
AYMVN	ayman
AYMY	amy
AYNAC	zayac
AYN	ayn
AYNA	ayn
AYNANA	ananda
AYNAN	ayman
AYNARYNV	yaryan
AYNAT	anant
AYN	ayn
AYNAYN	anay
AYNC	sync
AYNDALYS	mandalays
AYNDAYRSN	andersen
AYNDRA	andra
AYNDRAJYT	indrajit
AYNDRANYL	indranil
AYNDRLY	landry
AYNDSVRS	rynders
AYNDVY	andy
AYNGALZ	sangal
AYNG	ayling
AYNG	ayling
AYNG	ayling
AYNGLD	angle
AYNGLF	anglo
AYNGL	ayling
AYNGLS	angels
AYNGLYS	angles
AYNGLYS	angles
AYNGMAR	ingmar
AYNGMAR	ingmar
AYNGRAHAM	ingraham
AYNGRAM	anagram
AYNGRM	anagram
AYNGRSVL	maynards
AYNGRYA	angara
AYNGRYD	maynard
AYNGRYSL	gantrys
AYNGRYSVL	gantrys
AYNGVAR	ingvar
AYNGYJD	maynard
AYNHV	zaynah
AYNJH	zaynah
AYNJJNRY	antony
AYNKH	zaynah
AYNKVGNYTA	tanganyika
AYNLY	ainley
AYNMN	ayman
AYNR	rayner
AYNS	aryans
AYNS	aryans
AYNSR	rayner
AYNT	jayant
AYNTAYR	paynter
AYNT	jayant
AYNTH	zaynah
AYNTJ	katryntje
AYNTJH	katryntje
AYNTLSAT	intelsat
AYNTRNT	paynton
AYNTRNT	paynton
AYNVKSN	paynton
AYNVN	paynton
AYNVSNT	anant
AYNYSA	rayya
AYNZ	ayn
AYNZHNRY	inzhenery
AYNZ	ayn
AYNZ	ayn
AYPRSVN	aperson
AYPRT	alpert
AYR	dayr
AYRARDY	bayard
AYRAY	airay
AYRBYD	araby
AYRD	bayard
AYRDV	bayard
AYR	dayr
AYR	dayr
AYRLAYNZ	assyrians
AYRL	dayr
AYRLND	garland
AYRNST	earnest
AYRNVT	arnot
AYRP	ayers
AYRS	ayers
AYRVN	bayern
AYRVN	bayern
AYRVNSVN	aronson
AYRVVD	ayurveda
AYRVYNG	ayling
AYRVYN	yaryan
AYRVYN	yaryan
AYRVYYN	marylynn
AYRY	abery
AYRYK	masaryk
AYRYS	ayres
AYRYZARY	irizarry
AYRZ	ayers
'AYSA	maysan
AYSA	alyssa
'AYSA	maysan
AYSA	alyssa
AYS	ayse
AYSA	alyssa
AYSAK	kayak
AYSAK	kayak
AYSAKS	alyssas
AYSAMA	asama
AYSAN	maysan
AYSASK	alyssas
AYSBL	asbell
AYSFALZ	ayala
'AYSH	ayush
AYSH	ayush
'AYSH	ayush
AYSH	ayush
AYS	ayse
AYSKANDR	bystander
AYSK	ayse
AYSLT	aylott
AYSLYK	bayly
AYSMAN	ayman
AYSMN	ayson
AYSNSTAT	aisenstat
AYSPVRT	allport
AYSRAT	abstract
AYSRT	kayser
AYSRT	kayser
AYSTBRN	eastburn
AYSTLND	eastland
AYSTMAS	systems
AYSTMN	mayston
AYSTMVS	systems
AYSTRAGV	maytag
AYSTRBRVK	easterbrook
AYSTR	eyster
AYSTR	eyster
AYSTVVD	astrid
AYSTVY	rysavy
AYSTYK	bialystok
AYSTYN	mayston
AYSVN	ayson
AYSVN	ayson
AYSY	ayse
AYSYZAKY	magsaysay
AYT	amyot
AYT	amyot
AYTAMAR	aymara
AYTCV	zayac
AYTCVN	aztecan
AYTH	ghayth
AYTH	ghayth
AYTJ	marytje
AYTJ	marytje
AYTJY	marytje
AYTKN	dayton
AYTR	hayter
AYTSN	ayson
AYVA	ayala
AYVALD	ayala
AYVANZ	aryans
AYVAR	nayar
AYVAYNG	ayling
AYVGNH	rayleigh
AYV	kayvon
AYVJNH	kayvon
AYVLYN	allyn
AYVND	maryland
AYVNS	aryans
AYVRS	ayers
AYVRSVN	ayson
AYVRY	avery
AYVS	ayse
AYVS	ayse
AYVSTYS	avestas
AYVSV	ayuso
AYVSYN	ayson
AYVTYK	bayly
AYVYN	kayvon
AYZAK	yzaak
AYZAKSVN	kazakhstan
AYZCYL	aeschylus
AYZDY	addy
AYZ	allyz
AYZL	ayala
AYZMN	ryzman
AYZRVDA	ayurveda
AYZV	allyz
AZAD	azad
AZALYA	azalea
AZALY	azalea
AZANA	azana
AZAR	lazar
AZBVRN	lamborn
AZCYL	darcy
AZHR	azhar
AZLA	azlan
AZLN	azlan
AZR	lazar
AZVR	azure
AZYCL	alyce
BAABAR	baabar
BAAFJ	baefje
BABA	baba
BABA	baba
BABAH	babah
BABAR	babar
BABAR	babar
BAB	baba
BAB	baba
BAB	baba
BABK	babak
BABK	babak
BABL	babel
BABR	babar
BABT	babitz
BABV	babel
BABVRAV	baburao
BABVSKYN	babushkin
BABY	barbary
BABY	barbary
BABY	barbary
BABYKV	babak
BABYRL	babylon
BABYTZ	babitz
BACALTR	buchalter
BACARAC	bacharach
BACAS	backas
BAC	back
BACLDR	batchelder
BAD	abad
BAD	abad
BADKK	badrak
BADKVK	badrak
BADLVC	badeloch
BADMN	baderman
BADNYK	badry
BADR	badr
BADRMN	baderman
BADRYK	badry
BADVYN	bauduyn
BADVYYN	bauduyn
BADY	badry
BADYG	badry
BADYN	bauduyn
BADYN	bauduyn
BADYNGTN	baldington
BADYNGTVN	baldington
BADYVN	bauduyn
BADZ	baez
BADZYAK	budziak
BAFL	baffle
BAFY	bally
BAFY	bally
BAGA	bagga
BAGAM	baugham
BAGARLY	baggarly
BAGAY	baggarly
BAGDAN	bragdon
BAGHAM	baugham
BAGLY	bagley
BAGLY	bagley
BAGM	baum
BAGSAV	bagga
BAGVLY	bagley
BAGYD	bayda
BAGZ	baez
BAGZ	baez
BAHYH	albahah
BAJVA	bajwa
BAJYK	najya
BAKAR	baskar
BAKAS	backas
BAKAYA	bakaya
BAKLY	barkley
BAKNR	baker
BAKR	baker
BAKR	baker
BAKSKA	baskar
BAKSR	baker
BAKSY	bakaya
BAKVM	bakkum
BAKVS	bakos
BAKY	bakaya
BAKYR	bakaya
BALAK	babak
BALANDR	balendra
BALANS	balkans
BALARD	ballard
BALARY	balaye
BALAS	barlas
BALAST	ballast
BAL	baal
BAL	baal
BALBYR	balbir
BALCVNAS	balchunas
BALD	bald
BALDRD	baldred
BALDVR	baldur
BALDYNGTN	baldington
BALDYNGTVN	baldington
BALFNZ	balfanz
BALGA	baliga
BALHAM	balham
BALKA	balkan
BALKVSKY	blavatsky
BALMA	balma
BALMASDA	balmaseda
BALMR	balmer
BALNDRA	balendra
BALNY	balleny
BALSAM	balsam
BALSARA	bulsara
BALSK	basilisk
BALSLY	balsley
BALSVN	balson
BALTAKS	baltais
BALTAYS	baltais
BALTAZAR	balthazar
BALTZL	baltzell
BALV	ball
BALY	bally
BALYGA	baliga
BALYK	balaye
BALYN	balin
BALYN	balin
BALYSTYK	bialystok
BALYT	balit
BAMBRGR	baumberger
BAMN	barman
BAMSV	bamse
BANA	banan
BANABYV	barnaby
BAN	bain
BAN	bain
BAND	bandi
BANDD	banded
BANDYRDY	bandireddi
BANDZ	bandi
BANGARTZ	bongarts
BANG	bang
BANGRZ	bangor
BANKLR	bankler
BANKRAFT	bancroft
BANKRVFT	bancroft
BANKS	banks
BANKVALA	bankwalla
BANL	banjul
BANR	banker
BANTVN	banton
BANTY	blantyre
BANTYNG	banting
BANY	baney
BANY	baney
BANY	baney
BANYTA	baniya
BANYTV	baney
BANYVRA	baniya
BAP	bop
BAPTYSTA	baptista
BAPTYST	baptist
BARAKVTA	barakat
BARAS	barlas
BARASV	barlas
BARAT	barath
BARBAGALV	barbagallo
BAR	bar
BARBAS	barbas
BARBR	barber
BARBVRAK	barborak
BARBVR	barber
BARBY	barbary
BARD	bard
BARDVLVMZ	bardell
BARDYK	lombardys
BARF	barff
BARFRD	barford
BARFVRD	barford
BARFYT	barff
BARG	bargh
BARGS	bargus
BARGVS	bargus
BARH	barth
BARJYL	barry
BARKALV	barkai
BARKASFYLD	barksfield
BARKAY	barkai
BARK	bark
BARKLY	barkley
BARKRAFT	barratt
BARKR	barker
BARKSDYLY	barksdale
BARKSFYLD	barksfield
BARKVLV	barkell
BARKVS	barkus
BARLAS	barlas
BARL	baral
BARL	baral
BARLV	baral
BARNABY	barnaby
BARNAM	barnum
BARNARD	barnard
BARNAS	barnas
BARN	barn
BARND	barend
BARNSA	barnshaw
BARNSAV	barnshaw
BARNSV	barnas
BARNT	barents
BARNY	barney
BARNYK	barneys
BARQARD	barnard
BARS	barrs
BARSY	barry
BARTA	barta
BART	bart
BART	bart
BARTHVLVMYVS	bartholomeus
BARTK	bartok
BARTKVR	barthakur
BARTL	bartle
BARTL	bartle
BARTLMAS	bartelmus
BARTLMVS	bartelmus
BARTLT	bartelt
BARTLT	bartelt
BARTLY	bartley
BARTMVS	bartelmus
BARTN	barton
BARTN	barton
BARTVK	bartok
BARTVLVMVS	bartelmus
BARTVLVMYVS	bartelmus
BARTVLYNY	bartley
BARTVN	barton
BARTVNYKV	bartley
BARTY	bartley
BARTY	bartley
BARTYH	barth
BARTYS	martys
BARTZ	bartz
BARVA	barela
BARVC	barich
BARVN	barn
BARVN	barn
BARVNS	barnas
BARVNYA	barneys
BARVZ	bartz
BARYAKS	baracks
BARY	barry
BARY	barry
BARY	barry
BARY	barry
BARYNGR	barringer
BARYNGTN	barrington
BARYNGTVN	barrington
BARYS	barneys
BASA	basra
BAS	bas
BAS	bas
BASKAR	baskar
BASKRVYL	baskerville
BASKY	bosky
BASL	basel
BASMA	basma
BASN	basin
BASR	basir
BASSA	bassam
BASSN	basson
BASTARD	bastard
BAST	basit
BASTYK	battey
BASTYLVS	bastilles
BASTYN	bastien
BASTYN	bastien
BASTYN	bastien
BASTYVN	bastion
BASVAL	basil
BASV	bas
BASV	bas
BASVM	basim
BASYL	basil
BASYLYKA	bayly
BASYLYSK	basilisk
BASYLYVS	bayly
BASYN	basin
BATALS	baals
BATAN	bataan
BAT	bat
BATL	batel
BATLR	basler
BATNAT	bratina
BATN	bataan
BATRA	batra
BATRBY	barraby
BATRS	baxters
BATRSS	barsse
BATRST	bathurst
BATRVRS	barrs
BATRYS	gantrys
BATRZ	beatriz
BATY	battey
BATYL	batul
BATYNG	banting
BAVA	bavaria
BAV	bravo
BAVCMP	basecamp
BAVDN	baden
BAVDN	baden
BAVDVYYN	bauduyn
BAVDYN	bauduyn
BAVDYN	bauduyn
BAVDYSYN	bauduyn
BAVGMN	baughman
BAVKAM	baikal
BAVKVS	bakos
BAVM	balma
BAVMGARTNR	baumgartner
BAVPRS	baupres
BAVRY	barry
BAVS	beavis
BAVYZ	balaye
BAXVM	basim
BAYARD	bayard
BAY	bray
BAYDA	bayda
BAYDN	bayda
BAYFYLD	byfield
BAYKRASTAF	bickerstaffe
BAYKRZTAF	bickerstaffe
BAYLA	bayla
BAYLS	baylors
BAYLY	bayly
BAYLYNGSLY	billingsley
BAYLYNGTVN	baldington
BAYLYV	bayly
BAYLZ	bayla
BAYNVN	bayonne
BAYPRT	bayers
BAYR	bayer
BAYRD	bayard
BAYRN	bayern
BAYRN	bayern
BAYRTAY	barbary
BAYRTYH	bayreuth
BAYRVN	bayern
BAYSVT	bayse
BAYZ	bayes
BAZBY	buzby
BAZBY	buzby
BAZT	bazett
BBKAK	babak
BBYT	abbys
BCLDR	balder
BCLR	bacar
BDAL	bdale
'BDALH	abdullah
'BDALLH	abdullah
'BDALRHMAN	abdalrahman
'BDALRHMAN	abdalrahman
'BDALRHMN	abdalrahman
'BDALRHMN	abdalrahman
'BDAL'ZYR	balzer
'BDAL'ZYZ	abdulaziz
'BDHBY	abudhabi
BDKK	bekki
BDKVK	bekki
'BDL	abdul
BDLAK	badrak
BDL	bdale
BDLVC	badeloch
'BDL'ZYZ	abdulaziz
BDMY	badry
BDNAR	bednar
BDRK	badrak
BDRYK	badry
'BDVAL'ZYZ	abdulaziz
'BDVL	abdul
'BDVLRHMN	abdulrahman
BDYN	bauduyn
BDYRA	byra
BDYR	beyer
BFJ	baefje
BGDAD	baghdad
BGLY	bagley
BGNVLD	bagnold
BGVYL	bagley
BGYR	bayer
BHAMND	bahamonde
BHARA	behara
BHNAM	behnam
BHRV	bahro
BHST	baathist
BHYJA	bahija
BJLY	bally
BKA	benka
BKAR	baskar
BK	bk
BK	bk
BK	bk
BKDVR	badir
BKHVRST	backhurst
BKMN	backman
BKMN	backman
BKMYR	beckmeyer
BKR	baker
BKR	baker
BKR	baker
BKR	baker
BKS	bks
BKT	bks
BKVA	akiva
BKVF	backof
BKVK	bekki
BKVY	barkley
BKVYT	blyth
BKVYYR	bayly
BKY	becky
BKY	becky
BKYNGSAL	beckingsale
BKYNGSL	beckingsale
BKYNGSYL	beckingsale
BKYR	beyer
BKYS	beckys
BLA	bela
BLAC	black
BLAF	blal
BLAFS	olafs
BLAHA	blaha
BLAK	blaik
BLAKSVM	blacks
BLALAK	blalock
BLAL	blal
BLAL	blal
BLAM	balsam
BLAMKH	blaik
BLAMY	bellamy
BLANCARD	blanchard
BLANCH	blanche
BLANSDAN	blanstan
BLANSDN	blanstan
BLANSTAN	blanstan
BLANZDVN	blunsdon
BLAS	blas
BLASDN	blanstan
BLASK	blask
BLASR	blask
BLASY	blasi
BLASYVS	blasius
BLAVADNYK	blavatnik
BLAVYZ	blatz
BLAYT	balaye
BLAZ	blaz
BLAZK	blazek
BLAZKYYVZ	blazquez
BL	blu
BLDN	bolden
BLDRD	baldred
BLDVYJN	boldwijn
BLDVYN	bauduyn
BLDVYYN	bauduyn
BLDYNG	belding
BLDYNGTVN	baldington
BLGA	baliga
BLKA	balkan
BLK	blaik
BLKLND	blokland
BLKLY	blackley
BLKMN	blakeman
BLKMN	blakeman
BLKSVM	balsam
BLKSYR	blacksher
BLKVL	blal
BLNK	blank
BLNKHVRN	blenkhorn
BLNKV	blank
BLNKY	belenky
BLS	blas
BLTBRG	blattberg
BLTRAV	beltrao
BLV	blvd
BLVC	block
BLVHM	blohm
BLVKSVM	balsam
BLVM	blom
BLVMBRG	bloomberg
BLVMN	belvin
BLVMNFLD	blumenfeld
BLVNSDVM	blunsdon
BLVNSDVN	blunsdon
BLVNZDM	blondel
BLVRNJ	blevins
BLVSKVM	blask
BLVYN	belvin
BLVZ	blaz
BLVZVM	blom
BLYK	slyke
BLYK	slyke
BLYN	boleyn
BLYN	boleyn
BLYNDA	lynda
BLYNGASLY	billingsley
BLYNGTN	billington
BLYNKV	blank
BLYNKV	blank
BLYNKVV	bliznakov
BLYR	byer
BLYSTVN	blystone
BLYTA	blyth
BLYVYS	billys
BLYZ	allyz
BNAKSY	bakaya
BNAMAR	benamar
BNAN	banan
BNARY	binay
BN	ben
BNDANG	bandung
BNDASTVN	bandstone
BNDK	bendek
BNDLY	bandy
BNDR	bender
BNDRVB	banderob
BNDY	bandy
BNG	bang
BNG	bang
BNG	bang
BNGT	bengt
BNH	bench
BNJYMAN	benjiman
BNKR	banker
BNKR	banker
BNKS	banks
BNR	abner
BNS	bens
BNSN	bensen
BNSN	bensen
BNSVN	benson
BNT	benet
BNT	benet
BNT	benet
BNTLY	bentley
BNTN	benten
BNTN	benten
BNTV	bantu
BNTVN	banton
BNTZ	bentz
BNTZ	bentz
BNYA	baniya
BNYAMYN	beniamin
BNYFASYVS	beaufays
BNYN	bunyan
BNZ	benz
BNZN	benzene
BQYR	beyer
BRABANT	brabant
BRABY	barraby
BRACMN	brachman
BRAD	brad
BRAD	brad
BRADLY	bradly
BRADR	badr
BRADRTN	braden
BRADRTVN	braden
BRADSAV	brads
BRADY	brady
BRADYS	bradlys
BRAFVRD	bradford
BRAGHAM	brigham
BRAHAM	braham
BRAHYM	brahim
BRAK	brake
BRAKLY	bradly
BRAKNY	brackney
BRAMBAV	barabbas
BRAM	bram
BRAMR	bram
BRAN	bran
BRAN	bran
BRAN	bran
BRANDL	brandel
BRANDY	brandy
BRANN	brianna
BRANSAV	brans
BRANSDVN	brandon
BRANSKVMB	branscombe
BRANSVYK	brandys
BRANT	brant
BRANT	brant
BRARDY	brady
BRASARD	brassard
BRASAYR	brassard
BRASRZ	brashers
BRASYRZ	brashers
BRAT	brat
BRATLT	bratlie
BRATR	brater
BRATYNA	bratina
BRAVN	brain
BRAVN	brain
BRAVNFYLD	brownfield
BRAVNR	brain
BRAVNYNG	bruning
BRAVTVN	bratina
BRAVV	bravo
BRAVYC	bryce
BRAYAN	bryan
BRAY	bray
BRAYD	brays
BRAYN	bryn
BRAYNKLR	brinkler
BRAYR	bray
BRAYS	brays
BRAYS	brays
BRAYSLAV	bratislava
BRAYSVN	bryson
BRAYT	brays
BRAYTN	bryn
BRAYTVN	bratina
BRAYTVYT	bayly
BRAZVN	brazilian
BR	br
BRBVR	barber
BRCA	bearcat
BRCR	brecher
BRD	bard
BRD	bard
BRDLY	bradly
BRDLY	bradly
BRDLY	bradly
BRDN	braden
BRDN	braden
BRDN	braden
BRDSANG	birdsong
BRDSAV	berislav
BRDY	brady
BRDYK	brady
BRDYT	brady
BRFVRD	barford
BRGANTY	briganti
BRGARD	burgaard
BRGAYLV	borgailo
BRG	berg
BRG	berg
BRGDAN	bragdon
BRGLAND	berglund
BRGL	bergel
BRGMN	bergman
BRGR	berger
BRGS	borgs
BRGS	borgs
BRGSVN	bergson
BRGYVT	bright
BRHAN	burhan
BRJ	brij
BRKAH	barkah
BRKASPYR	breakspear
BRKAT	barakat
BRKAT	barakat
BRK	bark
BRK	bark
BRK	bark
BRKLY	barkley
BRKSFYLD	barksfield
BRKT	barakat
BRKVL	barkell
BRKVVYC	bryce
BRKY	berkey
BRLACR	black
BRL	burl
BRLND	borland
BRLSVN	burleson
BRLV	berislav
BRLYN	bryn
BRLYNG	burling
BRLYNG	burling
BRML	bermel
BRMN	barman
BRMN	barman
BRNADVS	bernadus
BRNAL	bernal
BRNAN	brendan
BRNARD	barnard
BRNARD	barnard
BRNARDV	bernardi
BRNARDY	bernardi
BRNARDYN	bernardin
BRNARDZ	bernardi
BRNCAVD	branchaud
BRNC	branch
BRNCLY	brenchley
BRNDAN	brendan
BRND	bernd
BRND	bernd
BRND	bernd
BRNDL	brandel
BRNDL	brandel
BRNDS	berends
BRNDVN	brandon
BRNDY	brandy
BRNDY	brandy
BRNDYS	brandys
BRNHARD	bernhard
BRNHART	barnhart
BRNHR	bernher
BRNR	bruner
BRNSAV	berislav
BRNSV	berns
BRNT	bernt
BRNT	bernt
BRNT	bernt
BRNV	brno
BRNVL	bernal
BRNY	barney
BRNY	barney
BRNYR	breyer
BRNZ	benz
BRQ	brs
BRSAV	berislav
BRS	brs
BRSFVRD	beresford
BRSLAV	berislav
BRSLR	bresler
BRSMN	bressman
BRSVN	bryson
BRSY	bray
BRT	bart
BRTLSVN	bertelson
BRTN	barton
BRTRAND	bertrand
BRTR	brater
BRTS	berts
BRTVN	barton
BRTVN	barton
BRTVN	barton
BRTY	bruty
BRTY	bruty
BRTYH	barth
BRVANHAT	braunhut
BRVARK	browarek
BRVDA	broda
BRVD	brod
BRVDFYLD	broadfield
BRVDHAST	broadhurst
BRVDLY	bradly
BRVDR	broder
BRVDRTVN	braverman
BRVHL	brohl
BRVKAV	barkai
BRVK	brevik
BRVK	brevik
BRVK	brevik
BRVK	brevik
BRVKN	broken
BRVKNR	bruckner
BRVKR	barker
BRVKS	borks
BRVKSL	barksdale
BRVKVL	barkell
BRVKZ	brevik
BRVMBRG	bromberg
BRVMBRGR	bromberger
BRVMFYLD	brumfield
BRVMLY	bromley
BRVMYJ	bromery
BRVNL	bernal
BRVNR	bruner
BRVNVYYN	bruyn
BRVNYYV	britney
BRVR	brar
BRVSRD	brossard
BRVSTR	berster
BRVSYAV	berislav
BRVTY	bruty
BRVTZMN	brutzman
BRVVR	brar
BRVYK	brevik
BRVYLV	beryl
BRVYN	bryn
BRVYNS	bryons
BRVYNYNG	bruning
BRVYR	breyer
BRVYR	breyer
BRVZ	broz
BRXARD	barnard
BRYAN	bryan
BRYAN	bryan
BRYANT	bryant
BRY	bray
BRY	bray
BRY	bray
BRY	bray
BRYBR	breyer
BRY	bray
BRY	bray
BRYDLAV	berislav
BRYDVL	bryde
BRYDY	brady
BRYDYNG	breeding
BRYGVY	bryguy
BRYJ	bryn
BRYJ	bryn
BRYJMN	bryan
BRYKASPYR	breakspear
BRYKSPYR	breakspear
BRYL	beryl
BRYM	beryl
BRYMR	barrymore
BRYMSTVN	brimstone
BRYN	bryn
BRYN	bryn
BRYNDAN	brendan
BRYND	bryn
BRYNDL	brindle
BRYNGARDNR	bringardner
BRYNGTN	barrington
BRYNGTVN	barrington
BRYNK	bryn
BRYNKMN	brinkman
BRYNR	bryner
BRYNSN	brynner
BRYR	breyer
BRYR	breyer
BRYS	brays
BRYS	brays
BRYSBYN	bryson
BRYSBYN	bryson
BRYSNV	bryson
BRYSTVL	krystal
BRYSYNDA	brisinda
BRYTA	brita
BRYT	bryant
BRYTLYNG	breitling
BRYTV	bryant
BRYTVN	bryn
BRYTYS	britneys
BRYVN	bryn
BRYVNY	bryony
BRYVR	breyer
BRYVRY	bryguy
BRYYKPR	breakspear
BRYYTVN	bruyn
BRYZA	bryan
BRZA	bereza
BSAK	bosak
BSAM	besam
BS	bs
BSBRYS	barbarys
BSKT	baskett
BSKV	besko
BSL	basel
BSMA	basma
BSMY	busby
BST	best
BSVAL	blal
BSVL	basil
BSVN	basin
BSYL	beyl
BSYM	syme
BSYRA	byra
BSYT	betsys
BTAN	bataan
BTCLDR	batchelder
BTHVN	beethoven
BTL	batel
BTMN	batman
BTRYS	brays
BTSY	betsy
BTVL	batul
BTY	betsy
BTY	betsy
BTYG	tyng
BTYYV	bayly
BTZA	betza
BVALY	bally
BVAS	blas
BVAY	bovary
BVAY	bovary
BVAYVYN	bayly
BV	bev
BVBY	abby
BVBYS	abbys
BVCA	bacar
BVCA	bacar
BVC	bic
BVCGA	boschga
BVDA	buda
BVDA	buda
BVDAPATY	vadaparty
BVDAR	bednar
BVD	blvd
BVD	blvd
BVD	blvd
'BVDHABY	abudhabi
BVDLA	bodla
BVDN	biden
BVDN	biden
BVDNMYLR	bodenmiller
BVDRA	bdira
BVDRV	badr
BVDV	blvd
BVDVR	badir
BVDVYN	bauduyn
BVDY	badry
BVDYVN	bauduyn
BVDYVYN	bauduyn
BVFALV	buffalo
BVGARD	bogaard
BVGHAM	brigham
BVGS	bugs
BVHL	buhl
BVHR	bohr
BVJY	bovary
BVKL	bokel
BVKL	bokel
BVKLY	beverly
BVKR	boker
BVKSY	bekesy
BVKVN	bakun
BVLA	bella
BVLARD	ballard
BVL	ball
BVLDN	bolden
BVLDT	boldt
BVLDVYJN	boldwijn
BVLDZR	bulldozer
BVLF	bolef
BVLN	bevin
BVLR	bieler
BVLR	bieler
BVLTAN	beltane
BVLTN	bolton
BVLTVN	bolton
BVLV	blvd
BVLVC	baltic
BVLVS	bills
BVLVYJN	boleyn
BVLYNG	billing
BVMBR	bomber
BVMBRGR	bomberger
BVM	bum
BVMGARDNR	bumgardner
BVMHARD	bomhard
BVMN	bevin
BVNANDR	bonander
BVNAR	bonar
BVNAVGLYA	bonavoglia
BVN	bevan
BVN	bevan
BVNGARD	bongard
BVNSTRA	boonstra
BVNTN	bunten
BVNVMV	bonomo
BVNVNV	bonin
BVNY	binay
BVNYFASS	bunyans
BVNYFASYVS	bunyans
BVNYFKYVS	brinkleys
BVNYFYSS	bernayss
BVNYN	bunyan
BVNYTZ	bonitz
BVQAM	bram
BVRA	bavaria
BVRAD	brad
BVRAP	brat
BVRASCY	buraschi
BVR	bir
BVRCRT	borchert
BVRDR	border
BVRDYK	brady
BVRGA	borgia
BVRG	borg
BVRGV	birgel
BVRGYVYS	beverlys
BVRJYA	beverlys
BVRKVAL	barkai
BVRKVL	barkell
BVRKVYL	barkley
BVRKY	berkey
BVRL	burl
BVRL	burl
BVRLN	berlin
BVRM	borm
BVRML	bormel
BVRMN	braverman
BVRSL	bursell
BVRST	borst
BVRSYR	breyer
BVRVS	burls
BVRYJ	bovarys
BVRYL	beryl
BVRYLLV	beryl
BVRYS	bovarys
BVRYVN	bryn
BVRYZ	bovarys
BVRZ	bartz
BVSA	busa
BVSAL	blal
BVSART	bossart
BVSARV	bulsari
BVSAYSN	biscayne
BVS	bis
BVS	bis
BVS	bis
BVS	bis
BVS	bis
BVS	bis
BVSCA	biscay
BVSCGA	boschga
BVSGA	boschga
BVSKA	bielska
BVSK	blask
BVSLY	balsley
BVSNL	bevan
BVSNY	bunny
BVSTAK	bostak
BVSTAMNT	bustamante
BVST	bost
BVSTRAM	bostrom
BVSTRVM	bostrom
BVSTVN	boston
BVSTYK	bostak
BVSVAL	bilal
BVSVL	basil
BVSVM	basim
BVSVN	basin
BVSVR	basir
BVSVYSN	boshuysen
BVSY	boisy
BVSY	boisy
BVSYK	blask
BVSYSN	boshuysen
BVSYVYSN	boshuysen
BVTARY	bovary
BVTAYS	butaysh
BVT	bot
BVT	bot
BVTCR	butcher
BVTLR	butler
BVTRL	beverly
BVTRS	butrus
BVTSYH	butaysh
BVTVN	bevin
BVTZ	bitz
BVVDVYN	bauduyn
BVVN	bevin
BVVY	beverly
BVXNY	bunny
BVY	ivy
BVYKV	boyko
BVYLN	boylan
BVYR	byer
BVYRKVYL	barkley
BVYS	bovarys
BVYS	bovarys
BVYSVYKS	bolsheviks
BVYSYV	bayly
BVYVN	boylan
BVYZY	bayly
BVZANCYV	bojanchev
BVZ	blaz
BVZKART	bozkurt
BVZMAN	bozeman
BVZVA	aviva
BVZVAL	bilal
BVZVVA	aviva
BVZVVYL	beyl
BVZYDAR	bozhidar
BVZYD	boyd
BYAKV	bak
BYAN	abyan
BYANG	byung
BYANGTAY	byungtae
BYATLYNG	beutling
BYAVYS	brays
BY	beyl
BYBL	byblos
BYBR	byer
BYCAM	beacham
BYC	bryce
BYCLY	bayly
BYCMP	basecamp
BYCYNGSYL	beckingsale
BYCZ	bryce
BYDA	bayda
BYDL	byrd
'BYD	byrd
BYDV	byrd
BYDVL	byrd
BYDY	badry
BYF	byfield
BYFJH	blyth
BYFRAST	bifrost
BYG	byung
BYGLHL	beaglehole
BYGND	bigend
BYGNVALD	ragnvald
BYGV	bryguy
BYGVRDAN	bigourdan
BYGZ	bryguy
BYHAN	beyhan
BYHYV	bayly
BYJ	beyl
BYJH	blyth
BYKA	byra
BYKARD	bayard
BYK	boyko
BYK	boyko
BYK	boyko
BYK	boyko
BYKLY	bayly
BYKN	byrne
BYKNST	byrnes
BYKRASTAF	bickerstaffe
BYKRASTAFY	bickerstaffe
BYKRASTF	bickerstaffe
BYKRASTYF	bickerstaffe
BYKR	byer
BYKRSTF	bickerstaffe
BYKRTN	byron
BYKSLR	byler
BYKVL	beyl
BYKVN	byron
BYLAL	bayla
BYLANY	billany
BYL	beyl
BYL	beyl
BYL	beyl
BYLHAR	bilhar
BYLKY	bayly
BYLNGTVN	billington
BYLR	byler
BYLR	byler
BYLR	byler
BYLS	byles
BYLV	beyl
BYLYKVK	bayly
BYLYNGASLAY	billingsley
BYLYNG	byung
BYLYNGSLY	billingsley
BYLYNGTVN	billington
BYLYNGZ	byung
BYLYNSKY	bilinsky
BYLYR	bayly
BYLZ	bayla
BYLZYBAB	beelzibub
BYMN	lymn
BYMYNG	byung
BYN	bryn
BYN	bryn
BYN	bryn
BYN	bryn
BYNDMN	lyndon
BYNFNG	bienfang
BYNG	byung
BYNH	blyth
BYNJN	bynon
BYNMDART	bainmedart
BYNQAM	behnam
BYNR	bryner
BYNS	byrnes
BYNS	byrnes
BYNVD	byrd
BYNVY	bryony
BYNY	bryony
BYNY	bryony
BYNY	bryony
BYNYYVN	bunyan
BYNZ	benz
BYNZ	benz
BYNZ	benz
BYPYN	bipin
BYRA	byra
BYR	byer
BYR	byer
BYR	byer
BYR	byer
BYR	byer
BYRBK	burbank
BYRC	byronic
BYRD	byrd
BYRD	byrd
BYRDMR	byrd
BYRDN	byrd
BYRFYS	brays
BYRG	byra
BYRGL	birgel
BYRK	byra
BYRLA	byra
BYRMN	byron
BYRNBVYM	barnaby
BYRN	byrne
BYRNH	byrne
BYRNS	byrnes
BYRTAY	bray
BYRT	byra
BYRTRYK	barry
BYRTYH	bayreuth
BYRTYH	bayreuth
BYRVT	byra
BYRYC	bryce
BYRYGANTY	briganti
BYRYNG	byung
BYRZ	byra
BYSAYV	rysavy
BYS	bayes
BYSH	butaysh
BYSKMP	basecamp
BYSL	beyl
BYSLY	bayly
BYSMARK	bismark
BYSM	bayse
BYSR	byer
BYSTANDR	bystander
BYST	myst
BYST	myst
BYSYN	bryson
BYTANKRT	bystander
BYTARD	bayard
BYT	blyth
BYT	blyth
BYTMN	batman
BYTN	bryn
BYTRAYS	brays
BYTRYK	bury
BYTZ	bitz
BYVAN	boylan
BYV	beyl
BYVCAMP	basecamp
BYVCMP	basecamp
BYVDVYN	bauduyn
BYVFYZ	bayly
BYVGAM	brigham
BYVKMP	boyko
BYVKRAFT	kraft
BYVLY	bayly
BYVLYV	bayly
BYVMNT	bryant
BYVMVNT	belmont
BYVNGS	byungse
BYVR	byler
BYVRLY	beverly
BYVRZ	byra
BYVSH	ayush
BYVTL	beyl
BYVYS	bovarys
BYVZVYL	bayly
BYYVCMP	basecamp
BYYVNYK	bryony
BYZ	beyl
BYZR	byer
BYZVANAT	byzantine
BYZVAS	sylvias
BYZVYL	bayly
BYZYR	bayly
BZVA	bevan
CAGN	cagney
CAKV	cave
CALK	chalk
CAMBRLAYN	chamberlain
CAMPLYN	champlin
CAND	candy
CANDRAN	chandran
CANDR	chander
CANDVNYA	chandonia
CANSY	candy
CANY	candy
CAPLA	capella
CAPL	capella
CAPMN	chapman
CAPRA	capra
CAPYN	clapeyron
CARD	caird
CARLTN	carlton
CARLTVN	carlton
CARLVT	calvert
CARLY	carly
CARLYH	carlys
CARLYN	carolyn
CARLZ	carla
CARNG	charng
CARTVN	carlton
CARYK	cary
CAS	cas
CASMZ	chasms
CASTYN	calsyn
CATANY	chaitanya
CAV	cave
CAVDA	chavda
CAVHAN	calahan
CAVN	calvin
CAVVYN	calsyn
CAVVYV	calvary
CAVZ	chavez
CAY	cary
CAYKN	canyon
CAYLD	called
CAYLDZ	cadiz
CAYZ	crays
CH	che
CKRD	rickard
CLATVN	clanton
CLYVS	carlys
CLYYAN	cayman
CMALY	chemaly
CMBRLYN	cambrian
CMBRZ	cambrian
CMBZY	chembezi
CNADR	chenader
CN	cain
CND	candy
CNDLR	chandler
CNSLVR	culver
CNTH	chenteh
CNY	candy
CPDY	cody
CPZ	capt
CRAG	craig
CRASKAYNT	carskadon
CRBL	cherbel
CRC	circe
CRCYL	crecy
CRPY	cherepy
CRSKYNAY	cristina
CRVBYNY	cerveny
CRVYC	carlys
CRY	cary
CRY	cary
CRYL	cheryl
CRYSKYNTY	christyntie
CRYSTAL	crystal
CRYSYNTH	christyntie
CSBRV	chesbro
CS	cs
CSNY	chesny
CSNY	chesny
CSTR	caster
CTAL	chetal
CT	cat
CTVYN	calsyn
CVA	cia
CVA	cia
CV	cave
CV	cave
CV	cave
CV	cave
CV	cave
CVDHARY	choudhary
CVKRY	calvary
CVKSY	casey
CVLKA	chwolka
CVN	calvin
CVNPYG	chunping
CVRN	chevron
CVSAK	chusak
CVVANAK	chovanak
CVY	chevy
CVY	chevy
CVYLR	cyr
CYA	scylla
CYA	scylla
CYAKY	conakry
CYANG	chang
CYBANSKY	cybanski
CY	cyr
CY	cyr
CYCSTR	chichester
CYK	cyr
CYK	cyr
CYK	cyr
CYKN	ceylon
CYKRY	conakry
CYKY	chayefsky
CYKZ	cyr
CYLDZ	cyclades
CYLT	colt
CYLTH	scythia
CYLTJ	celetje
CYLTJH	celetje
CYLY	lyly
CYLYJH	cyliax
CYLYNGVRS	challengers
CYLYNGVRT	chillingworth
CYM	cayman
CYN	coyne
CYN	coyne
CYNN	cayenne
CYNV	cyrano
CYP	cyprus
CYP	cyprus
CYPLVYDN	coplen
CYPMN	cyprian
CYPN	cyprian
CYRAG	cybermage
CYRAK	cyrano
CYSM	coys
CYSMN	cayman
CYSTY	crystal
CYSVLM	crystal
CYTA	crystal
CYTAM	crystal
CYTAN	scythian
CYT	cyr
CYT	cyr
CYTRDY	chitrady
CYTVVD	clyde
CYTVYN	clayton
CYTYK	cathys
CYV	cyr
CYV	cyr
CYZVBA	chizoba
CYZV	cyr
CYZVRV	cyr
DABAC	dalbec
DABAS	dadas
DABL	diaboli
DABNY	dabney
DABS	darbys
DABSVN	dabin
DABVS	daves
DABVYS	darbys
DABYL	daryl
DABYNSKY	dubinsky
DABYNSN	dobyns
DABYNSVN	dobyns
DABYNZ	dobyns
DADA	dada
DAD	dada
DADGYVN	dady
DADH	dade
DADK	dade
DADLY	dady
DADS	dadas
D'A	diaa
DADV	dada
DADYR	dady
DAF	dal
DAGAN	dagan
DAGAN	dagan
DAG	dag
DAG	dag
DAG	dag
DAGLY	dagley
DAGN	dagan
DAGR	dalager
DAGRTY	daugherty
DAGRZ	datri
DAGVAC	davao
DAGZ	datz
DAHAK	dahar
DAHAML	duhamel
DAHN	daphne
DAHRTY	daugherty
DAHVD	david
DAHVK	dahuk
DAJ	daatje
DAJ	daatje
DAJYVN	dayton
DAKAS	dakars
DAK	dakar
DAK	dakar
DAK	dakar
DAKHVRN	dockhorn
DAKLVZ	desalvo
DAKMN	dakin
DAKN	dakin
DAKRYNG	drying
DAKS	dakars
DAKS	dakars
DAKTRZ	dakars
DAKV	dakin
DAKVRS	dakars
DAKYNG	drying
DAKYNZ	dakin
DAKZ	datz
DALAJR	dalager
DALAN	dalian
DALAS	dallas
DALAYR	dalager
DALBK	dalbec
DALBRGR	dulberger
DALBYR	dolby
DAL	dal
DAL	dal
DAL	dal
DALFR	dulfer
DALMN	dallan
DALMS	adalma
DALMYYA	aliyyah
DALNZ	danz
DALRS	daimlers
DALRYMPL	dalrymple
DALTVN	dalton
DALY	daly
DALY	daly
DALY	daly
DALY	daly
DALYNAR	dolinar
DALYNGR	darling
DAMAR	dhamar
DAMBL	gamble
DAMLR	daimler
DAMPLTVN	dumpleton
DAMVN	damon
DAMVNTT	dumontet
DAMYAN	damian
DAMYANV	damian
DAMYLA	djamila
DAMYNGS	demings
DAMYNY	dominy
DAMYNYKAS	diamantaras
DAMYTRV	dayr
DAMYVN	damon
DANA	dana
DANALD	danald
DANA	dana
DANAVAN	donovan
DAN	dan
DANDAS	dundas
DAN	dan
DAN	dan
DAN	dan
DANDY	sandy
DANFRD	dunford
DANFY	danny
DANG	dangel
DANG	dangel
DANGTAY	dongtai
DANGVY	dagley
DANGYV	dingyi
DANGYVN	angevin
DANHAM	dunham
DANH	danih
DANJL	danial
DANKAN	danekind
DANKV	danko
DANKV	danko
DANKY	danny
DANLVP	dunlap
DANLY	daly
DANNBARGR	danenbarger
DANNLY	danny
DANR	deaner
DANSMVR	dunsmore
DANSTR	dunster
DANSY	danny
DANSYNG	sansing
DANTN	danton
DANVAN	donovan
DANY	danny
DANY	danny
DANYDYN	dayton
DANYL	daryl
DANYL	daryl
DANYL	daryl
DANYLSVN	danielson
DANYLV	daryl
DANYLZ	daryls
DANYS	dannys
DANYYLS	dannys
DANZ	danz
DAPAY	vadaparty
DAPNYK	dannys
DAPRK	draper
DAPRRY	darryl
DAPRY	vadaparty
DARANG	darling
DARA	darla
DARBY	darby
DAR	adar
DARHAM	durham
DARL	darla
DARLY	darley
DARLYNGTN	darlington
DARNAL	darnall
DARNL	darnall
DARNL	darnall
DART	dart
DARV	darvon
DARVN	darvon
DARYGVS	daryls
DARYL	daryl
DAS	das
DAS	das
DASN	dan
DASVN	darvon
DASYNG	drying
DASYVK	daisy
DAT	dart
DATH	darth
DATJH	darth
DATRY	daryl
DATSVN	dotson
DATVN	dalton
DATVYT	davy
DATY	day
DATY	day
DAVAD	david
DAVARK	davao
DAVBR	dauber
DAVD	david
DAVD	david
DAVD	david
DAV	dave
DAV	dave
DAV	dave
DAVKNYZ	dannys
DAVKYNZ	dakin
DAVN	darvon
DAVNPRT	davenport
DAVNY	davy
DAVNYNG	dancing
DAVNYNG	dancing
DAVRS	daves
DAVRYN	daverin
DAVSAN	davison
DAVS	daves
DAVSN	davison
DAVSVN	davison
DAVT	dave
DAVVD	david
DAVVD	david
DAYAL	dalal
DAYAN	jayan
DAYAN	jayan
DAYANYSYA	dionysia
DAYANYSYS	dionysus
DAYAZ	hadaya
DAYBALA	dyballa
DAYBL	daryl
DAYCYNC	duyckinck
DAY	day
DAY	day
DAYDRYC	dady
DAY	day
DAYK	dayr
DAYKSVN	dayton
DAYKY	ladasky
DAYKYNK	duyckinck
DAYKYNZ	dykins
DAYLAYGAN	malayan
DAYLVN	dylan
DAYMND	dymond
DAYN	dayton
DAYN	dayton
DAYR	dayr
DAYRDRYK	darryl
DAYR	dayr
DAYRKTVR	dayr
DAYRT	dayr
DAYS	daleys
DAYT	dayton
DAYVD	david
DAYVRJH	darth
DAYVRJH	darth
DAYVRT	dayr
DAYVRTH	darth
DAYVRTJ	divertje
DAYVRTJ	divertje
DAYVRYA	dayr
DAYVVN	dayton
DAYVYN	dayton
DBATVNYA	debathonia
DBLR	deibler
DBYT	darbys
DDFYLD	deadfield
DDJN	goddijn
DDRYK	dedrick
DDY	addy
DFRVY	defroy
DGLY	dagley
DGRAF	degraff
DGRF	degraff
DGRLVND	degerlund
DGVTARDY	degotardi
DHA	doha
DHAMAR	dhamar
DHNR	dehner
DHNRT	dehnert
DHVK	dahuk
DJAMYLA	djamila
DJLY	daly
DKAN	dekan
DKK	dekok
DKLRK	dunkirk
DKR	dakar
DKSTR	dikstra
DKYAH	radeyah
DKY	dicky
DK	dik
DLAL	dalal
DLANY	delaney
DL	dal
DLH	delhi
DLMAN	dolman
DLNY	delaney
DLRD	dallard
DLRYV	daryl
DLTN	dilten
DLTVVYA	deltuvia
DLVRA	elvira
DLVRYZ	divya
DLVYS	dollys
DLY	daly
DLYKATNY	delikatny
DLYS	daleys
DLYSYV	daleys
DMA	dema
DMA	dema
DMKAK	demcak
DMKH	drikha
DML	demler
DMLR	demler
DMN	damon
DMPSTR	dempster
DMR	delmar
DMRZ	marz
DMSQ	dimashq
DMYLA	diyala
DMYNYSVS	dionysus
DMYS	amys
DNALD	danald
DNAQY	donaghy
DNAVLT	denault
DN	dan
DNDLR	dandler
DN	dan
DNDRYJ	landrys
DNG	deng
DNHAM	denham
DNJVR	denver
DNKVALTR	denkewalter
DNKYND	danekind
DNL	danial
DNMN	denman
DNNL	dennell
DNRYJ	daryl
DNSR	dunster
DNTVN	danton
DNV	denver
DNVKS	denvers
DNYH	danih
DNYL	daryl
DNYLZ	doyle
DNYNG	enying
DNYS	dannys
DNYSVN	dionysian
DRABK	drabek
DRADR	drader
DRAGAN	dragan
DRAGANYS	draganis
DRAGN	dragan
DRAGR	drag
DRAKMN	dratman
DRAL	dralle
DRALT	dralle
DRAMATYS	dramatis
DRAM	dream
DRAP	draper
DRAPR	draper
DRAST	droste
DRATMN	dratman
DRATY	dreary
DRAVN	draine
DRAVR	drover
DRAYNH	zaynah
DRAYR	dayr
DRBS	drebes
DRBY	darby
DRCMN	drachman
DRDH	darth
DRG	drag
DRGVMYR	dragomir
DRGVN	dragon
DRGVNS	dragons
DRK	dirk
DRKSL	dirks
DRMVT	dermott
DRNAL	darnall
DRNK	drnek
DRNTR	drenter
DRSNR	dressner
DRTCN	dortchen
DRTH	darth
DRV	dr
DRV	dr
DRVDYNG	druding
DRVDYS	trudys
DRVMAND	armand
DRVMR	dreamer
DRVNY	deviney
DRVNYS	dervenis
DRVR	drover
DRVT	dart
DRVYK	drevik
DRVYT	davy
DRVZN	darvon
DRYDJY	dryden
DRYFVS	dreyfus
DRYJR	dreyer
DRYK	daryl
DRYK	daryl
DRYM	daryl
DRYMR	dreyer
DRYMZ	daryls
DRYNKS	drinks
DRYNZ	drying
DRYR	dreyer
DRYRY	drury
DRYS	daryls
DRYSKVL	driskill
DRYSKYL	driskill
DRYV	daryl
DRYV	daryl
DRYVT	daryls
DRYXA	daryls
DS	ds
DSL	desle
DSMVLYNZ	desmoulins
DSMVND	desmond
DSMYT	desmet
DSNVYRZ	desnoyers
DSRAZYRS	sayers
DSRVZYRZ	dreyer
DSTLY	dusty
DSVTV	distel
DTLFS	detlefs
DTMN	dettman
DTRYJ	daryl
DTS	dots
DTVYLR	tyler
DVA	dvina
DVAK	dipak
DVALYBAY	dowaliby
DVAN	dan
DVANYR	dayr
DVAR	edvard
DVARTH	darth
DVAYKYNK	duyckinck
DVBAY	dubay
DVBRATZ	dobbratz
DVBRYDJ	bryde
DVBRYKYN	dobrikin
DVBRYZ	daryl
DVBSVN	dobson
DVBVYS	debbys
DVBYNSVN	dobyns
DVBYNYN	bynon
DVBYR	dayr
DVCARM	ducharme
DVCAYLARD	duchaylard
DVCT	doctor
DVCYNC	duickinck
DVDA	duda
DVDAMANY	dodamani
DVD	david
DVDGVN	dodgen
DVDJ	davids
DVDL	david
DVDLY	dudley
DV	dov
DV	dov
DVFVR	duvivier
DVGAN	dogan
DVGAN	dogan
DVG	dog
DVGYVN	dylan
DVHA	doha
DVHH	doha
DVHRTY	doherty
DVHVR	dahar
DVHYRST	dewhirst
DVJN	devin
DVK	dik
DVK	dik
DVLAN	dilan
DVL	advil
DVLKYA	divya
DVLMAN	dolman
DVLR	diller
DVLY	daly
DVLYN	evelyn
DVMBA	domba
DVM	diem
DVM	diem
DVMN	devin
DVMNYKV	domeyko
DVMYKV	domeyko
DVMYKZ	domeyko
DVMYNGV	domingo
DVMYNYKAS	soyinkas
DVMYNYK	dominy
DVMYNYK	dominy
DVMYNYKS	dominicks
DVMYNYKYVS	minskys
DVMYNYN	dominy
DVMYNYVS	dominy
DVNACY	dancy
DVNA	dvina
DVNALD	donald
DVNAT	dvina
DVNATV	donati
DVNATY	donati
DVNAY	dvina
DVN	deven
DVN	deven
DVNG	ding
DVNHAM	dunham
DVNKN	dinn
DVNLY	deviney
DVNPK	devenpeck
DVNPYK	devenpeck
DVNS	devins
DVNTSK	donetsk
DVNVAN	donovan
DVNYNY	donny
DVNYS	donnys
DVPALM	depalm
DVPLR	doppler
DVPLT	doppelt
DVPRY	dupuy
DVPYVYS	pygmys
DVRA	dora
DVRAND	durand
DVRAND	durand
DVRAN	doran
DVRAN	doran
DVRAPT	durupt
DVRAS	doras
DVRASY	daisy
DVRATH	dorathee
DVRATY	dreary
DVRAVKS	dirks
DVRAYA	vaya
DVRAZYV	dorazio
DVRCAK	dorcas
DVRCN	daverin
DVRDAL	dordal
DVRFMAN	dorfman
DVRHAM	durham
DVRKN	dorken
DVRKYN	dorken
DVRL	dorel
DVRLD	edvard
DVRMA	dorma
DVRND	durand
DVRND	durand
DVRN	daverin
DVRN	daverin
DVRRANS	dirran
DVRST	dorset
DVRSY	dorsey
DVRSY	dorsey
DVRTCN	dortchen
DVRT	dart
DVRTH	darth
DVRTJ	divertje
DVRTJH	divertje
DVRTVN	daverin
DVRTY	dorthy
DVRTY	dorthy
DVRVC	doric
DVRVTY	verity
DVRVYN	darvon
DVRY	dory
DVRYNDA	dorinda
DVRYS	daryls
DVRYS	daryls
DVRYSVMY	rysavy
DVS	daves
DVSKV	dusko
DVSN	davison
DVSTALYK	dostalik
DVSTY	dusty
DVTA	delta
DVVAYKYNK	duyckinck
DVVL	advil
DVY	davy
DVYKYNK	duyckinck
DVYKYNK	duyckinck
DVYN	dyna
DVYNDR	devender
DVYNY	deviney
DVYNYNG	pyongyang
DVYR	dayr
DVYSR	dyer
DVYT	davy
DVYTV	davy
DVYVYR	dayr
DVYYKYNK	duyckinck
DVZAT	duzat
DVZYYR	dayr
DYAB	diab
DYA	diya
DYA	diya
DYALA	diyala
DYAMANTARAS	diamantaras
DYAMDY	dady
DYAMVND	dymond
DYANA	dyna
DYAN	dylan
DYAZ	diaz
DYBAT	dyballa
DYBATH	debathe
DYBATVNYA	dyballa
DYB	yb
DYBL	dyballa
DYBT	dyballa
DYBTVNYA	lyubovny
DYBV	dyballa
DYBYT	debbys
DYCYR	cyr
DYDA	dyna
DY	day
DY	day
DY	day
DYDRYSZ	dyers
DYDRYX	dyers
DYDYRYCS	diederichs
DYGAN	dogan
DYGAZMN	deguzman
DYGH	dighe
DYGNARV	degennaro
DYGRAF	degraff
DYGRF	degraff
DYGRV	dyer
DYGV	drying
DYGVYD	dagley
DYKANYNK	dykins
DYKAVTY	delikatny
DYK	dykes
DYK	dykes
DYKL	dykes
DYKNS	dykins
DYKNZ	dykins
DYKNZ	dykins
DYKSAY	dykes
DYKS	dykes
DYKSN	dykins
DYKSTRA	dikstra
DYKSVN	dykins
DYKSVN	dykins
DYKV	dykes
DYKV	dykes
DYKY	dykes
DYKY	dykes
DYKYNZ	dykins
'DYL	daryl
DYLAN	dylan
DYLAYR	dayr
DYL	daryl
DYLMA	dilma
DYLN	dylan
DYLNY	dylan
DYLR	dayr
DYLVRS	dyers
DYLY	daly
DYLY	daly
DYLYNGR	dellinger
DYLYNGTN	darlington
DYLYP	dilip
DYLYP	dilip
DYLYV	daly
DYMAD	dymond
DYMA	dima
DYMA	dima
DYMARS	demars
DYMARST	demarest
DYMARYP	dimaryp
DYMAS	dumas
DYMASK	dumas
DYM	dymond
DYMN	dymond
DYMRS	dyers
DYMSAK	adisak
DYMVK	dymond
DYMYNG	drying
DYMYTAR	dimitar
DYMYTRY	dimitry
DYMYTRYS	dimitry
DYMYTRYV	dimitry
DYMYTRYV	dimitry
DYMYTRYVS	dimitry
DYNA	dyna
DYNA	dyna
DYNA	dyna
DYNAMYT	dynamite
DYNBYM	denebeim
DYN	dyna
DYN	dyna
DYN	dyna
DYNG	drying
DYNGLV	drying
DYNGSVR	dingsor
DYNGY	dingyi
DYNGY	dingyi
DYNL	dyna
DYNLR	dinler
DYNN	dyna
DYNPYK	dunphy
DYNR	dyna
DYNS	dylans
DYNS	dylans
DYNSMVR	dunsmore
DYNT	dyna
DYNV	dyna
DYNY	dyna
DYNYNGR	deininger
DYPAK	dipak
DYPAYVLA	dyballa
DYPAYVLV	pavlov
DYPBVY	dipboye
DYPLD	dippold
DYPRSYV	gypsy
DYPRTR	deporter
DYPYTRV	dipietro
DYR	dayr
DYR	dayr
DYR	dayr
DYRDRK	deirdre
DYRDRYK	dierderick
DYRK	dirk
DYRK	dirk
DYRKS	dirks
DYRVKV	drevik
DYRVRTJ	divertje
DYSANTV	desanto
DYSAV	dyna
DYSAY	odyssey
DYS	dyers
DYSGY	odyssey
DYSMVND	dymond
DYSNT	dysons
DYSTL	distel
DYTJY	sytje
DYTMAR	dietmar
DYTR	dyer
DYTVRZ	dyers
DYTVTALA	ditutala
DYVA	dylan
DYVAKARVNY	divakaruni
DYVANATAN	devanathan
DYVAN	dylan
DYVAR	dylan
DYVAYN	dylan
DYVAYN	dylan
DYVAYZR	dayr
DYVHA	doha
DYVN	dylan
DYVNH	dylans
DYVNPK	devenpeck
DYVNYDA	dyna
DYVRT	dyers
DYVRT	dyers
DYVRTH	darth
DYVRTJ	divertje
DYVRTJH	divertje
DYVRTJH	divertje
DYVVSR	sylvester
DYVYA	divya
DYVY	davy
DYVYD	davy
DYVYD	davy
DYVYD	davy
DYVY	davy
DYVYDSVN	davidson
DYVYDYAN	davidian
DYVYLDH	hudaydah
DYVYS	divya
DYVYSN	dyson
DYVYSVN	dyson
DYVYT	davy
DYYALA	diyala
DYZNY	donny
DYZR	dyer
DYZVN	dyson
DZ	datz
DZGAGNH	desgagne
FABLR	faber
FABRH	fabre
FABRV	fabro
FABRYS	fabris
FABYANV	abyan
FACS	fac
FAD	fadl
FADL	fadl
FADNBRG	fudenberg
FADVR	fadl
FADYLA	fadila
FADYL	fadil
'FAF	afaf
FAGAN	fagan
FAGANS	fagans
FAJN	fan
FAJYVAR	magyar
FAKS	farkas
FALCVK	falchuk
FALK	falk
FALKNR	faulkner
FALKRSVN	fulkerson
FALKV	falk
FALKVNR	faulkner
FALN	fallon
FALSAM	balsam
FALTAK	foltak
FALTLS	faultless
FALTVN	fatin
FALVN	fallon
FALY	farley
FALYVT	salyut
FALZ	faiz
FAMYVS	fays
FANDRYC	fandrich
FANG	fanger
FANGVS	franglais
FANTS	frans
FARA	farag
FARAG	farag
FARAGV	farag
FARAT	farag
FARKAS	farkas
FARL	farley
FARLY	farley
FARMR	farmer
FARSBRG	forsberg
FARST	fast
FARTK	furtek
FARVANYA	farwaniyah
FARVANYAH	farwaniyah
FARVGYA	farrugia
FARVK	farouk
FARVK	farouk
FARVQ	farooq
FARVZ	fairuz
FARYD	farid
FARY	farry
FARYHA	fariha
FARYVR	farry
FASBRG	forsberg
FAS	fast
FAS	fast
FASL	fasel
FATYMA	fatima
FATYS	fays
FAVAZ	fawaz
FAVL	fauvel
FAVNS	fagins
FAVNS	fagins
FAVST	fast
FAVST	fast
FAVST	fast
FAVST	fast
FAVZYA	faiza
FAVZY	fuzzy
FAVZYYA	fawziyya
FAXRY	farry
FAYF	fay
FAYK	faye
FAYLS	fays
FAYN	fayne
FAYNK	fayne
FAYNLY	bayly
FAYNRTY	finerty
FAYNSTVN	mayston
FAYNTVN	paynton
FAYRBANK	fairbank
FAYRVZ	fayiz
FAYT	fays
FAYYZ	fayiz
FAYZA	faiza
FAYZ	fayiz
FAYZ	fayiz
FAYZL	fayiz
FAZA	faiza
FAZ	faiz
FAZL	faizel
FAZYA	fawziyya
FAZY	fay
FAZY	fay
FBRV	fabro
FCNR	fechner
FDL	fadl
FDR	feder
FDR	feder
FDRL	federle
FDRMN	federman
FDVR	fedor
FDYLA	dylan
FDYL	fadil
FHD	fahd
FHT	fichte
FK	falk
FLAGLLY	flaglelee
FLAHRTY	flaherty
FLAKYGR	flygare
FLARDYNGA	flardinga
FLAT	flat
FLAT	flat
FLAVKA	felawka
FLAY	finlay
FLAYGYR	flygare
FLAYS	fays
FLDMAN	feldman
FLDMAR	feldmar
FLDMN	feldman
FLDR	felder
FLDSPAR	feldspar
FLJ	fletje
FLK	falk
FLKYNZ	flynn
FLMR	feldmar
FLSTY	flesti
FLTH	faith
FLTJ	fletje
FLTJH	fletje
FLTYV	fly
FLVCH	fluche
FLVDYN	flodin
FLVRA	flora
FLVR	flor
FLVR	flor
FLVRK	florek
FLVRNS	florines
FLVRS	flores
FLVRY	flory
FLVRYN	florys
FLVRZ	alvarez
FLVT	flat
FLVVRZ	alvarez
FLVYD	floyd
FLYJH	blyth
FLYKS	flynns
FLYKYNGR	flickinger
FLYM	fly
FLYMYNG	fleming
FLYNDRZ	flinders
FLYNT	flynn
FLYNY	flynn
FLYSZ	florys
FLYVRY	flory
FLYZARDV	felizardo
FMMTH	faith
FMT	fms
FMTJ	femmetje
FMYA	freya
FNCARC	fenchurch
FNDR	fender
FN	fan
FN	fan
FNG	feng
FNGR	fanger
FNR	elfner
FNSKY	funky
FNTVN	fenton
FNTYMAN	fentiman
FNVYK	finleys
FNY	fanny
FNYS	fenyes
FRA	afra
FRAGVRGYA	frageorgia
FRAM	frame
FRAMSAN	framson
FRAMSVN	framson
FRANDSN	frandsen
FRAN	fran
FRANGAKYS	frangakis
FRANKL	frankel
FRANKL	frankel
FRANKLYN	franklin
FRANKV	frank
FRANKV	frank
FRANKVY	franny
FRANKVYS	frannys
FRANKVYZ	franklin
FRANS	frans
FRANSR	franser
FRANSSYDTJ	franscyntje
FRANSVYZ	frannys
FRANSYKA	fransiska
FRANSYNTAY	franscyntje
FRANSYNTH	franscyntje
FRANSYNTJH	franscyntje
FRANSYNTY	franscyntje
FRANSYNTYH	franscyntje
FRANSYNTZ	franscyntje
FRANSYSKA	fransiska
FRANSYSKA	fransiska
FRANSYSKAS	fransiska
FRANSYSKVS	fransiska
FRANSYSYVS	frannys
FRANTYSK	frantisek
FRANTZN	frantzen
FRAQ	mafraq
FRARY	farry
FRASR	fraser
FRAST	fast
FRASTY	grasty
FRAYDA	faraday
FRAYDMAN	fridman
FRAYDMN	fridman
FRAYDY	faraday
FRAY	friday
FRAYGRSA	fritgersa
FRAYTGRSA	fritgersa
FRAZR	frazer
FRAZYR	frazer
FRAZYYR	frazier
FRDA	freda
FRDAYNND	ferdinand
FRD	fred
FRDKYN	fradkin
FRDRKYNG	frederking
FRDRYK	fredrik
FRDRYK	fredrik
FRDRYK	fredrik
FRDRYK	fredrik
FRDRYKV	fredrik
FRDT	freds
FRDYA	freya
FRDY	friday
FRDY	friday
FRDYG	ferdig
FRG	farag
FRGT	forget
FRGVSN	ferguson
FRH	farah
FRJ	fri
FRJN	fran
FRLANG	furlong
FRLY	farley
FRM	fermi
FRNANDS	fernandes
FRNANDV	fernando
FRNANDZ	fernandez
FRNASYSKAS	fransiska
FRNASYSKAZ	fransiska
FRNC	france
FRNK	frank
FRNK	frank
FRNKH	franke
FRNKL	frankel
FRNKL	frankel
FRNKLYN	franklin
FRNKSVN	frankson
FRNKVYS	frannys
FRNKVYZ	funky
FRNSAYNT	franscyntje
FRNS	ferns
FRNSNYT	frannys
FRNSNYT	frannys
FRNSVYS	frannys
FRNSYNTY	franscyntje
FRNSYSKA	fransiska
FRNSYSKA	fransiska
FRNZL	frenzel
FRQ	frs
FRR	furr
FRSR	fraser
FRTYK	fertik
FRVANYAH	farwaniyah
FRVANYH	farwaniyah
FRVK	frink
FRVK	frink
FRVMYN	fridman
FRVNYAH	farwaniyah
FRVZ	fritz
FRYBRG	rydberg
FRYDA	freda
FRYDBRGR	friedberger
FRYD	frye
FRYDGYR	fridgeir
FRYDH	forsyth
FRYDL	friedl
FRYDMAR	friedmar
FRYDMN	fridman
FRYDMN	fridman
FRYDRYK	fredrik
FRYDYN	fridays
FRY	fry
FRY	fry
FRYHA	fariha
FRYKS	fryes
FRYLND	maryland
FRYLYNG	marylynn
FRYLYNGR	freilinger
FRYLZ	fayiz
FRYMAL	freemal
FRYMVT	freyermuth
FRYNGTVN	farrington
FRYNK	frink
FRYNK	frink
FRYR	fry
FRYR	fry
FRYRMAT	freyermuth
FRYS	freys
FRYS	freys
FRYS	freys
FRYTAG	freitag
FRYTAS	freyas
FRYT	fry
FRYTGRSA	fritgersa
FRYTN	fritton
FRYTS	fryes
FRYTV	fry
FRYTVL	fry
FRYTZYVS	fritzius
FRYVALD	freiwald
FRYVVGL	freivogel
FRYZ	frye
FRYZR	frazer
FRYZR	frazer
FSDAL	fosdal
FST	fast
FSYG	fasig
FTC	fetch
FTCN	fetchen
FTRA	fetra
FTR	fetra
FVD	fed
FVJY	fly
FVJYTA	fujita
FVJYVKA	fujioka
FVKV	falk
FVLDZ	valdez
FVLGAM	milgram
FVLKANYS	falklands
FVLK	falk
FVLKS	folkes
FVLMN	fullman
FVLN	fallon
FVLR	flor
FVLR	flor
FVLY	fly
FVMRTVN	fumerton
FVNDAL	fundal
FVNDV	fondo
FVNGN	fongen
FVNG	feng
FVNKY	funky
FVNTNVT	fontenot
FVN	fin
FVNYVK	fink
FVRBS	forbes
FVRBZ	fairuz
FVRD	ford
FVRDHAM	fordham
FVRDSANDN	furdesanden
FVRJY	frey
FVRK	fork
FVRLANG	furlong
FVRMN	forman
FVRMN	forman
FVRNR	franser
FVRNY	franny
FVRNY	franny
FVRNYR	fourneyron
FVRR	furr
FVRRV	furr
FVRSAYT	forsyth
FVRSAYT	forsyth
FVRSBLAM	forsblom
FVRSBRG	forsberg
FVRS	frs
FVRSYL	forsyth
FVRT	forte
FVRTS	forts
FVRY	fry
FVSNG	fosseng
FVT	flat
FVTRR	furr
FVTS	fiats
FVTYNVS	flynns
FVY	fly
FVYS	fays
FVYY	fly
FVZARD	fozzard
FVZY	fuzzy
FVZYH	forsyth
FXRYA	freya
FXRY	fry
FXRYYA	fakhriyya
FXYR	fay
FYABAN	fiabane
FYAKSY	yanks
FYASKVNARV	fiasconaro
FYBR	faber
FYDALGV	fidalgo
FYDL	fadl
FYDLR	fidler
FYDVR	fidler
'FYF	afif
FYGARD	figard
FYGVRA	figura
FYHAN	beyhan
FYK	faye
FYKS	fayes
FYLAKS	mylars
FYL	zyl
FYLK	falk
FYLPAT	flat
FYL	zyl
FYL	zyl
FYLPS	felipes
FYLR	byler
FYLVS	sylvias
FYLVZ	fayiz
FYLYAS	filias
FYLY	lyly
FYLYP	lyly
FYLYPS	felipes
FYLYPS	felipes
FYLZ	fayiz
FYMTJH	freyermuth
FYMYJH	wafiyyah
FYNAN	feynman
FYNAN	feynman
FYNC	sync
FYN	fayne
FYN	fayne
FYNK	fink
FYNKL	finkle
FYNLY	finlay
FYNLY	finlay
FYNLY	finlay
FYNSTAD	finstad
FYNY	fundy
FYNYN	flynn
FYNYS	fannys
FY	fay
FYPS	fays
FYRBNKS	fairbanks
FYRBRYN	yerbury
FYR	fay
FYRHRST	fairhurst
FYRMA	firma
FYRN	fern
FYRVDR	ayurveda
FYRVK	fork
FYRVZ	fayiz
FYRVZ	fayiz
FYSBYN	fosbury
FYS	fays
FYS	fays
FYSK	fisk
FYSR	fays
FYTA	fitta
FYTC	fitch
FYTZJRALD	fitzgerald
FYTZVL	fitzwell
FYVR	flygare
FYVSTL	feustel
FYZA	faiza
FYZ	fayiz
FYZH	fayiz
FYZL	fayiz
FZYA	freya
GABA	gaba
GABARA	gabara
GABBL	gabel
GABLR	gabler
GABRYLH	galbraith
GABRYLH	galbraith
GABRYYLSVN	gabrielsson
GABVR	gabler
GABYN	gabon
GACR	gacrux
GADBRY	gadbury
GADBT	gadbois
GADBVRY	gadbury
GADBVYS	gadbois
GADFRVYD	godfroid
GADFRY	godfrey
GADGL	gudgel
GADMN	godman
GADRV	gadi
GADSN	gadsden
GADSVARD	goddard
GADVYN	gladys
GADY	grady
GADYJN	gladys
GADYL	gadil
GAF	graf
GAF	graf
GAFNY	gaffney
GAFRAN	ghufran
GAFYN	gaffin
GAGNH	gagne
GAHRTY	gaherty
GAJNH	ganesh
GAJR	gair
GALA	galea
GALAGHR	gallagher
GALAGR	gallagher
GALAHAD	galahad
GALAN	galvan
GALANT	gallant
GALATYN	gallaty
GALAVY	galbavy
GALBAVAY	galbavy
GALC	gaelic
GALDN	galen
GAL	gaal
GAL	gaal
GAL	gaal
GAL	gaal
GALJ	gali
GALKV	galko
GALN	galen
GALP	galpin
GALPYN	galpin
GALT	galatea
GALV	gall
GALVLA	galila
GALVSN	galvan
GALVVY	galbavy
GALVY	galbavy
GALYBRT	galibert
GALY	galley
GALY	galley
GALY	galley
GALY	galley
GALYLA	galila
GALYLH	gayle
GALYLH	gayle
GALYTY	gallaty
GALYVN	galvan
GALYZYA	galizia
GAMAK	gamal
GAMAL	gamal
GAMBYNV	gambino
GAML	gamal
GAML	gamal
GAMRV	gamero
GAMRVS	gaeris
GAMVN	galvan
GAMYJ	gamay
GAMYSH	samiyah
GANAPATY	ganapathy
GANAR	ganatra
GANATRA	ganatra
GANAVAN	ghanaian
GANDLC	gundlach
GANDRSVN	gunderson
GANDRZYK	gonderzik
GANDVRP	glandorf
GANDY	gandy
GAN	gan
GANG	gang
GANG	gang
GANGVLY	gangolli
GANL	granli
GANRVS	gantrys
GANS	gans
GANSVN	ganesan
GANTRAM	guntram
GANTR	ganter
GANTR	ganter
GANTR	ganter
GANTRP	gantert
GANTRT	gantert
GANTVRP	gantert
GANTVRPH	gantry
GANTY	gantry
GANVN	granvin
GANVYL	gandy
GANYR	gonyer
GANYSAN	ganesan
GANZAK	ganzak
GANZALZ	gonzalez
GAPTA	gupta
GAPYSTY	gopisetty
GARADVAN	garagan
GARAFALV	garofalo
GARANS	guaranis
GARBH	garth
GARBY	garry
GARDNR	gardner
GARDYNR	gardner
GARFYLD	garfield
GARFYNKL	garfinkel
GARLYK	garlick
GARMZ	garms
GARN	garon
GARNR	garner
GARNT	garnett
GARNY	garry
GARSKY	gursky
GARSS	gass
GARSVL	garshol
GARSYA	gary
GART	garth
GARTMN	gartmann
GARTRYJ	garrys
GARTYN	gartin
GARVD	garrod
GARVFALV	garofalo
GARVLA	arvola
GARVTV	garito
GARYK	gary
GARYK	gary
GARYS	garrys
GARYTV	gary
GASARD	gossard
GAS	gas
GASKAT	gaskin
GASKVN	gaskin
GASKVYN	gaskin
GASKVYYN	gaskin
GASKYN	gaskin
GASKYNZ	gaskins
GASLR	gashler
GASLR	gashler
GASLYK	gatsbys
GASLYNG	gatling
GASPAR	gaspar
GASPR	gaspar
GASTA	gatta
GASTAVS	gustavs
GASTAVVS	gustavs
GASTLAV	gastli
GASTLV	gastli
GASTYLV	gastli
GASTYN	grasty
GASTYNYV	gascony
GASVL	gastli
GASY	grasty
GASYK	grasty
GASYNK	gascoyne
GATA	gatta
GAT	gat
GAT	gat
GATHARD	gotthard
GATKVMB	gatcombe
GATLYB	gateley
GATLY	gateley
GATLYN	gatlin
GATMN	gartmann
GATMN	gartmann
GATRYJ	gantrys
GATSF	gates
GATS	gates
GATS	gates
GATVYN	gatlin
GATYS	gantrys
GATYZ	gatz
GATZ	gatz
GATZVYLR	gayler
GAVAZNY	gavazzeni
GAV	gavin
GAVRD	goverd
GAVR	gair
GAVTYR	gallaty
GAVYNDAN	govindan
GAVYND	govind
GAVYN	gavin
GAYA	gaya
GAYAT	gaya
GAYBS	gayles
GAYDA	gayda
GAYDRY	gadbury
GAYDVAL	gayda
GAYDV	gayda
GAYGL	gayle
GAY	gay
GAYLR	gayler
GAYLVN	galvan
GAYMN	gayman
GAYMVND	gayman
GAYNL	gaynell
GAYNVR	gaynor
GAYNVR	gaynor
GAYR	gayler
GAYT	gay
GAYVN	gayman
GAYYTZ	gatz
GAZK	ganzak
GAZMN	gaiman
GBY	gilby
GDARD	goddard
GDBRY	gadbury
GDK	gdansk
GDRALT	gaudrault
GDR	gd
GDYRA	goya
GDYRH	gerth
GDYR	dayr
GDYS	gladys
GF	gift
GFRAN	ghufran
GLAS	gilas
GLASKV	glass
GLASYR	glaser
GLASYYR	glaser
GLATZ	glatz
GLAYR	gloyer
GLDASTYYN	gladstone
GLDBRG	goldberg
GLDBRGR	goldberger
GLDFSMAN	geldefsman
GLDFSMN	geldefsman
GLDFVT	goldfoot
GLD	gold
GLDKMP	goldkamp
GLDMN	goldman
GLDR	golder
GLDYNG	golding
GLDZMN	goldman
GLDZVRSY	glovers
GLF	gulf
GL	gil
GLNDVRF	glandorf
GLN	glen
GLRYK	gilroy
GLS	gils
GLSYRZ	gloyer
GLTR	gelter
GLVB	galibi
GLVJ	galvan
GLVRYA	gloria
GLVVY	galbavy
GLYB	glynn
GLYC	alyce
GLYCMN	glicksman
GLYK	slyke
GLYKSMN	glicksman
GLYN	glynn
GLYNZ	glynn
GLYSVN	glynn
GLYVS	gladys
GLYZR	gloyer
GMBL	gamble
GMG	gamage
GML	gamal
GML	gamal
GMYJ	pigmys
GNAGY	gnagy
GNKS	genks
GNVSYS	nevskys
GNYSYLDA	gnishilda
GNZALS	gonzales
GNZALS	gonzales
GNZALZ	gonzalez
GNZALZ	gonzalez
GNZ	ganzak
GPH	gopher
GPJ	gepje
GRAB	grable
GRABNAR	grabnar
GRABN	graben
GRABYNR	grabiner
GRAD	grad
GRAF	graf
GRAFT	graft
GRAG	garagan
GRAGTY	geraghty
GRAHAM	graham
GRAHAM	graham
GRAH	grah
GRAHRNA	grahorna
GRALYN	gralian
GRAMSS	gramsas
GRANBRGR	grunberger
GRANDASTRVM	grandmaster
GRAND	grand
GRAN	gran
GRANTAM	grantham
GRANT	grant
GRANVYN	granvin
GRANYT	grant
GRANZYV	granzeau
GRARDYN	gerardin
GRASKYN	grasty
GRASR	graser
GRATR	grater
GRAV	gorav
GRAV	gorav
GRAV	gorav
GRAV	gorav
GRAYM	gray
GRAYNGR	grainger
GRAYSLDYZ	gradys
GRAYSYLD	grasty
GRAYVAS	grivas
GRAYY	gray
GRAYYNGR	grainger
GRAYYV	gray
GRBS	gerbes
GRBYAH	gharbiyah
GRBYH	gharbiyah
GRDAN	gordan
GRDN	gordan
GRDNR	gardner
GRDY	grady
GRFYT	graft
GRG	garg
GRG	garg
GRG	garg
GRGVR	gregor
GRGVR	gregor
GRHARD	gerhard
GRHART	gerhart
GRHART	gerhart
GRJVAYSN	greyson
GRKV	grov
GRL	girl
GRLY	gurley
GRLYK	grilk
GRMAK	germack
GRMBAN	gremban
GRM	gorm
GRNANDR	grenander
GRND	grand
GRNDMSTR	grandmaster
GRNDYDYR	grandidier
GRN	gran
GRNGR	granger
GRNJR	garner
GRNJR	garner
GRNLY	grindley
GRNSYNG	grensing
GRNT	grant
GRNVYL	grenville
GRNYCR	ternyck
GRNY	gurney
GRQTY	grasty
GRSAPH	graphite
GRSDVRF	gersdorf
GRS	gris
GRS	gris
GRSLDYS	gradys
GRSR	graser
GRSTL	gerstl
GRSTY	grasty
GRSTYNN	grasteinen
GRTA	greta
GRTCN	gretchen
GRT	grit
GRT	grit
GRTRVD	gertrude
GRTRVYD	geertruyd
GRVBY	garvey
GRV	grov
GRVGVRY	gregory
GRVHVL	grohol
GRVLAYT	gourlay
GRVLYT	geervliet
GRVM	grimm
GRVNR	groner
GRVNVALD	groenveld
GRVNYNK	groenink
GRVS	graves
GRVSJVHAN	grossjohann
GRVSK	grosek
GRVSR	graser
GRVSY	garvey
GRVT	grit
GRVT	grit
GRVTHAVS	grothause
GRVVR	grover
GRVVY	groovy
GRVYNCM	gorinchem
GRVYN	garvey
GRVYNLND	groenland
GRVYNVLD	groenveld
GRYBH	grah
GRYBL	grable
GRYBYH	gharbiyah
GRYF	graf
GRYF	graf
GRYFR	graifer
GRYFR	graifer
GRYFR	graifer
GRYFY	griffy
GRYFYS	griffy
GRYFYTS	griffiths
GRYFYTZ	griffy
GRYG	grog
GRY	gary
GRYGR	gregor
GRYGVR	gregor
GRYKV	gromyko
GRYLK	grilk
GRYLNBK	grillenbeck
GRYNBRG	greenberg
GRYNDLY	grindley
GRYNG	drying
GRYNGH	greenough
GRYN	greyson
GRYNGR	granger
GRYNHAM	grinham
GRYNJ	tryntje
GRYNJR	gaynor
GRYNSVN	grinsven
GRYNVALD	groenveld
GRYNV	granvin
GRYNVP	greenop
GRYNVVD	groenveld
GRYNYAS	guyanas
GRYNYJ	tryntje
GRYPNKRL	griepenkerl
GRYR	gary
GRYSAYLD	griswald
GRYS	garrys
GRYSLD	griswald
GRYSLDYS	griseldis
GRYSMVR	grismore
GRYSR	garrys
GRYST	grist
GRYSVALD	griswald
GRYSVLD	griswold
GRYSVN	greyson
GRYSYLD	griswold
GRYSYLDH	grishilde
GRYT	gary
GRYTS	garrys
GRYTZ	gritz
GRYTZN	greyson
GRYTZVN	gerritzon
GRYVL	gary
GRYVLYT	geervliet
GRYVNVD	groenveld
GRYYN	greyson
GRYYNVALD	groenveld
GRYZLY	grizzly
GRYZVN	greyson
GSAN	gan
GS	gs
GSKVYN	kevyn
GSKVYNH	gaskins
GSKYN	gaskin
GSKYNS	gaskins
GSKYNZ	gaskins
GSTAVVS	gustavs
GST	grist
GSTL	gastli
GTYS	gettys
GVADA	gayda
GVANG	gang
GVAN	galvan
GVAN	galvan
GVANYAV	guanyao
GVARD	girard
GVBL	goble
GVBYN	gilby
GVCAN	anglican
GVDA	gilda
GVDA	gilda
GVDA	gilda
GVDAL	goudal
GVDARD	goddard
GVDATA	gudata
GVDAT	gudat
GVDAYNAF	dyna
GVD	gd
GVDGR	goodger
GVDHV	gandhi
GVDL	godel
GVDMAN	godman
GVDMN	godman
GVDNAF	gena
GVDRAM	avram
GVDRAN	gudrun
GVDRV	golder
GVDRV	golder
GVDRYC	guidry
GVDSN	godson
GVDSVN	godson
GVDVYN	goldwyn
GVDVYN	goldwyn
GVDYNG	golding
GVDYN	goldwyn
GVDYR	gladys
GVDYVAYN	dylan
GVDYVYN	goldwyn
GVGAN	goegan
GVGR	geiger
GVGVAN	galvan
GVHD	gohde
GVH	goh
GVHYN	sheyn
GVKYANV	guyana
GVLAND	goland
GVLAN	golan
GVLDYNG	golding
GVL	govil
GVLSBY	gilby
GVLT	geervliet
GVLVMB	golomb
GVLY	gully
GVMZ	gomez
GVMZ	gomez
GVNAR	gunnar
GVNNA	glenna
GVNTVRP	gunthorpe
GVNVT	glenlivet
GVNY	gony
GVNZALS	gonzales
GVNZALS	gonzales
GVNZALV	gonzalo
GVNZALZ	gonzalez
GVPALA	gopala
GVPALAN	gopalan
GVPTA	gupta
GVPTH	gopinath
GVPVL	gopala
GVPYNAT	gopinath
GVRALAVALA	goralwalla
GVRAL	gural
GVRALP	guralp
GVRAN	gran
GVRAPARTAP	gurupartap
GVRASPY	grasty
GVRAV	gorav
GVRBRG	gorberg
GVRDF	goverd
GVRD	goverd
GVRD	goverd
GVRDN	gordan
GVRDYN	gordin
GVRGAN	garagan
GVRGANZ	garagan
GVR	ingvar
GVR	ingvar
GVRKY	gorky
GVRL	girl
GVRLY	gurley
GVRM	gorm
GVRMT	gourmet
GVRNAL	gornall
GVRNY	gurney
GVRTVN	gartin
GVRV	gorav
GVRVSAMY	gurusamy
GVRVYTZ	gritz
GVRY	gary
GVRYK	gary
GVRYNCM	gorinchem
GVRYNDR	gurinder
GVRYNG	drying
GVRYNMN	glynn
GVRYS	goreys
GVSF	gotseff
GVS	graves
GVSTAV	gustav
GVSTAVS	gustavs
GVSTAVVS	gustavs
GVSTLV	gastli
GVSVL	giselle
GVSVYL	gayle
GVSY	gipsy
GVTHARD	gotthard
GVTJS	gootjes
GVTLYB	gotley
GVTY	getty
GVTYK	gettys
GVVDGR	goodger
GVVDYNG	golding
GVVRD	goverd
GVVVSYS	ogilvys
GVVYNDR	govinder
GVYAT	guyatt
GVYDV	gayda
GVY	garvey
GVYKARYS	garrys
GVYLAM	gillam
GVYL	gayle
GVYL	gayle
GVYL	gayle
GVYLRMV	gayler
GVYN	glynn
GVYN	glynn
GVYVDA	gayda
GVYYDV	gayda
GVYYJR	gloyer
GVYYLYM	lyly
GVYYN	glynn
GVZVYTZ	glatz
GYANASY	guyanas
GYAT	guyatt
GYBSN	gibson
GYBSVN	gibson
GYBVNY	lyubovny
GYBVNZ	gabons
GYBVR	gabler
GYDRY	guidry
GYDV	gayda
GYDVN	gayda
GYDZ	gayda
GYFT	gift
GY	gay
GYGR	gymer
GYJSBRTAS	gijsbertus
GYJSBRTVS	gijsbertus
GYLAGLY	gillogly
GYLAM	gillam
GYLAM	gillam
GYLBAY	galbavy
GYLBRT	gilbert
GYLFRD	guilford
GYLFVRD	guilford
GYL	gayle
GYL	gayle
GYL	gayle
GYL	gayle
GYLMN	gayman
GYLMN	gayman
GYLMR	gymer
GYLN	gayle
GYLNR	gayler
GYLPYN	gypsys
GYLR	gayler
GYLRM	gayler
GYLRMV	gayler
GYLRVY	gilroy
GYLRY	gilroy
GYLSPAY	gypsy
GYLSPY	gypsy
GYLT	gayle
GYLVT	gayle
GYLYAM	gillam
GYLY	lyly
GYLY	lyly
GYLYS	gypsys
GYLYS	gypsys
GYLYTA	geleta
GYLYZ	allyz
GYLYZ	allyz
GYML	gymer
GYMNV	gayman
GYMNZ	gayman
GYN	gwyn
GYNKZ	genks
GYNSBRG	ginsberg
GYNTN	glynn
GYNTVN	glynn
GYPJH	gypsy
GYPN	egyptian
GYRARD	girard
GYR	gymer
GYR	gymer
GYRHART	gerhart
GYRTRVYD	geertruyd
GYRTSN	geertsen
GYRVLAYT	gourlay
GYRVLYT	geervliet
GYSBRTVS	gijsbertus
GYS	guys
GYSH	gish
GYSYLDA	gayda
GYTARD	guitard
GYT	egypt
GYT	egypt
GYTGY	geitgey
GYTLMN	gitlin
GYTLYN	gitlin
GYTN	egyptian
GYTNYK	gitnick
GYTS	egypts
GYTVMR	gymer
GYTVND	govind
GYVF	gulf
GYVLYTY	gallaty
GYVN	gwyn
GYVVANY	sylvan
GYVVN	sylvan
GYVYN	glynn
GYVZ	gayle
GYYANKVLA	guyana
GYZAV	giza
HABA	haba
HABRDR	habereder
HABR	haber
HABR	haber
HABRKAM	abram
HABRLC	haberlach
HABRMN	haberman
HABRT	habert
HABS	ahabs
HABVRA	habura
HABVRG	hamburg
HABYN	harbin
HABZ	haba
HACHALTR	hochhalter
HACYNSVN	jaclyns
HACYNZ	jaclyns
HACYSVN	hyson
HADGZ	hardings
HADLND	hadland
HADLSTVN	huddleston
HADLY	hadley
HADRAMAT	hadramawt
HADRAMAVT	hadramawt
HADSN	hardison
HADSVN	hardison
HADSVN	hardison
HADVBA	habiba
HADYA	hadaya
HADY	hardy
HADYL	hadil
HAFBK	hafer
HAFMN	haman
HAFMN	haman
HAFMN	haman
HAFNYLYNG	haniyya
HAFR	hafer
HAFSAH	hafsah
HAFS	hafs
HAGA	haga
HAGAN	hagan
HAGARD	haggard
HAGARD	haggard
HAGDAL	hugdahl
HAG	haga
HAGKYNZ	hagen
HAGLR	hagler
HAGLYN	hagelin
HAGMN	hageman
HAGMN	hageman
HAGN	hagan
HAGR	hagar
HAGS	changs
HAGSVN	hagan
HAGTN	hagan
HAGYN	hagin
HAHTAHA	huhtala
HAJ	haj
HAJKYNZ	harkins
HAJR	hajar
HAJRZ	hajar
HAJS	haj
HAJYR	hajar
HAJZ	haj
HAKABAY	huckaby
HAKDT	hackett
HAK	hak
HAK	hak
HAKLY	hackley
HAKNYS	haneys
HAKSA	hakka
HAKSAV	hakka
HAKS	hanks
HAKSL	hanks
HAKSV	hanks
HAKVLYNN	hakulinen
HAKVYL	harvey
HAKY	shakya
HAKYNG	hacking
HALAM	hallam
HALAN	harlan
HALAT	halat
HALDR	haldre
HALFLDR	holfelder
HALGR	haleger
HAL	hal
HAL	hal
HALKDYS	halkedis
HALK	chalk
HALKNR	holkner
HALM	halm
HALMN	halon
HALND	harland
HALN	halon
HALPYN	halpin
HALR	halar
HALR	halar
HALRT	hallert
HALSTD	halsted
HALST	halsted
HALTGRN	hultgren
HALTSYNGR	holtsinger
HALTVN	healton
HALTZ	hiltz
HALVB	halab
HALYBRTVN	halliburton
HALYDY	haydu
HALYFYLD	halford
HALY	haley
HALY	haley
HALYMN	hollyman
HALYVL	haley
HALZR	halar
HAMACY	hamachi
HAMAH	hamah
HAMANS	hamans
HAMANZ	hamans
HAMARKVYYST	hammarquist
HAMBYG	hamburg
HAMBYJ	shambat
HAMD	hamad
HAMFRY	harry
HAMFRYZ	hafiz
HAMFRYZ	hafiz
HAMH	hamah
HAML	hamel
HAML	hamel
HAMMANZ	hammans
HAMNS	hamans
HAMPRYVN	hamparian
HAMPSAYR	hampshire
HAMPSYR	hampshire
HAMPTVN	hampton
HAMR	hamer
HAMSAYR	thallmayer
HAMVND	hammond
HAMVNDZ	hammonds
HAMY	hay
HAMYL	hamel
HAMYLTN	hamilton
HAMYLTVN	hamilton
HANAFVRD	hannaford
HANA	hanaa
HANBVT	hanebuth
HANDL	handel
HANDRSVN	chandran
HANG	chang
HANGRFVRD	hungerford
HAN	han
HANKH	hanukkah
HANKLR	hunkler
HANKZ	hanks
HANSAKR	hunsaker
HANSN	hansen
HANSN	hansen
HANSR	hansher
HANSVN	hanson
HANSVN	hanson
HANT	thant
HANTYNGTVN	huntington
HANV	hani
HANYA	haniyya
HANYFA	hanifa
HANY	haney
HANYH	haneys
HANYMN	hanan
HAPKARFT	hopcraft
HAPKRAFT	hopcraft
HAPKRFT	hopcraft
HAPKYNZ	hopkins
HAPR	harper
HAPSVN	hopson
HARALD	harald
HARALDSN	haraldsen
HARARY	harry
HARATZ	haratz
HARBD	harbud
HARBR	harber
HARBR	harber
HARBR	harber
HARBRN	harburn
HARBRYJ	charbrays
HARBVD	harbud
HARBVR	harbor
HARBYG	harbidge
HARBYJ	charbrays
HARDN	harden
HARDYMN	hardiman
HARDYNG	harding
HARDYN	hardy
HARDYSVN	hardison
HARGRAVZ	hargreaves
HAR	har
HARKL	harkin
HARKR	harker
HARKVM	harkcom
HARKYN	harkin
HARKYNZ	harkins
HARLD	harald
HARLD	harald
HARL	sharl
HARLND	harland
HARLN	harlan
HARLV	harv
HARMAN	harman
HARMANVS	harmanus
HARMN	harman
HARMNVS	harmanus
HARMVTV	haramoto
HARMZ	harms
HARNR	harincar
HARP	harpe
HARPR	harper
HARPVLD	harpold
HARR	harry
HARRYG	harrys
HARSA	harsha
HARS	hares
HARS	hares
HARTAG	hartog
HARTAH	hurtah
HARTFYLD	hartfield
HART	hart
HART	hart
HARTL	hartel
HARTLP	hartlep
HARTLY	hartley
HARTMN	hartman
HARTR	harter
HARTVL	hartel
HARTVYL	hartley
HARTYGAN	hartigan
HARVARD	harvard
HARV	harv
HARVHYSA	haruhisa
HARVLD	harold
HARVL	harvell
HARVN	harlan
HARVN	harlan
HARVNY	harvey
HARVY	harvey
HARYCN	haricken
HARYHARAN	hariharan
HARYKN	harkin
HARYNKAR	shankar
HARYS	harrys
HARYSVN	harrys
HARYV	harry
HARYZ	harrys
HASAKAH	hasakah
HASAL	hassall
HASBRVK	hasbrouck
HASBY	husby
HAS	haas
HAS	haas
HASKAL	haskel
HASK	haskel
HASKL	haskel
HASKL	haskel
HASKYNZ	hoskins
HASLVM	haslum
HASMN	hasan
HAST	haste
HASTTLR	hostetler
HASTVN	hastings
HASTYNGZ	hastings
HASYK	halsey
HATAP	hartlep
HATCSVN	hutcheson
HATCYNSVN	hutchinson
HATCYNZ	hatcher
HATCYSVN	hutcheson
HAT	hart
HATLNDNSYS	holtlandensis
HATLY	hartley
HATM	hatem
HATMYKR	hatmaker
HATR	harter
HATRL	hatrell
HATVN	haven
HATVN	haven
HATVRY	harry
HAVARD	havard
HAVDVN	haven
HAVGTAYLYNG	houghtailing
HAV	harv
HAV	harv
HAV	harv
HAVK	haik
HAVK	haik
HAVKR	chalker
HAVKYN	haven
HAVKYNZ	haynes
HAVL	havel
HAVLY	halley
HAVLZ	havel
HAVN	haven
HAVN	haven
HAVS	hals
HAVSR	havard
HAVTVN	haven
HAVTYLYNG	ayling
HAVTYN	haydn
HAVVLA	havola
HAVVNN	hann
HAVY	harvey
HAVYS	hays
HAYBRD	hayward
HAYBZ	hafiz
HAYC	hays
HAYDAR	haidar
HAYD	haydn
HAYDMN	haydn
HAYDN	haydn
HAYGDAN	haydn
HAYKY	chayefsky
HAYLND	hyland
HAYLT	haylett
HAYLVRD	duchaylard
HAYLY	bayly
HAYM	hay
HAYNGH	shanghai
HAYN	haydn
HAYN	haydn
HAYNLY	haynie
HAYNS	haynes
HAYNS	haynes
HAYNY	haynie
HAYNZ	haynes
HAYNZ	haynes
HAYPLY	bayly
HAYR	hayter
HAYRVNYMVS	hieronymus
HAYSLVP	hyslop
HAYSVN	hyson
HAYTR	hayter
HAYTS	hays
HAYTZ	hayter
HAYVARD	havard
HAYVKYNSVN	hawkinson
HAYVKZ	chavez
HAYVL	havel
HAYZ	hays
HAYZ	hays
HAZN	hazen
HBNTVN	hebenton
HBRN	harburn
HBRVQ	harv
HBVRN	harburn
HBYBA	habiba
HBYBH	gharbiyah
HDAD	haddad
HDAK	hak
HDAVY	davy
HDAYA	hadaya
HDAYA	hadaya
HDAYDAH	hudaydah
HD	head
HDLND	hadland
HDLND	hadland
HDLVND	hedlund
HDLY	hadley
HDRAMAVT	hadramawt
HDRAMVT	hadramawt
HDRMAT	hadramawt
HDRYK	hedrick
HDSA	rhodesia
HDS	hades
HDYA	hadaya
HDYDA	hudaydah
HDYDH	hudaydah
HDYH	shadiyah
HDYL	hoyle
HDYN	sheyn
HFRVN	heffron
HFSA	hafsah
HFSAH	hafsah
HFS	hfs
HFSH	hafsah
HGARTY	hegarty
HGLND	hagland
HGTYLYNG	hertling
HGY	hegyi
HGY	hegyi
HGYR	huyer
HHMN	hehman
HJR	hajar
HJRY	hajery
HK	hak
HKR	harker
HKR	harker
HKSAV	hokusai
HKSV	hanks
HKT	hak
HKTVR	hitler
HKYM	hakim
HKYNG	hacking
HKZN	hekezen
HLAB	halab
HLAL	helal
HLAN	hulan
HLAVYN	hlavin
HLB	halab
HLBLYNG	helbling
HLBYG	helbig
HLBYNG	helbing
HLD	heald
HLDN	holden
HLFMN	helfman
HLGA	helga
HL	hal
HLKANT	hellekant
HLK	helke
HLLR	haller
HLMN	helman
HLMN	helman
HLMNSTAYN	helmenstine
HLMR	hilmer
HLMZ	hamza
HLMZ	hamza
HLNA	helena
HLND	hind
HLNDR	thelander
HLN	helen
HLN	helen
HLR	halar
HLSTRVM	ahlstrom
HLT	helt
HLTLANDNSYS	holtlandensis
HLTLNDNSYS	holtlandensis
HLTVN	hilton
HLV	hall
HLVJ	hlavin
HLVM	halm
HLY	holy
HLY	holy
HLYNDN	lyndon
HLYVL	hoyle
HLZGNG	holzgang
HLZMN	holzman
HMAH	hamah
HMAM	hamam
HMANS	hamans
HMANZ	hamans
HMAR	dhamar
HMBAYJ	himalaya
HMBYJ	huby
HMDAN	hamdan
HMD	ahmad
HMH	hamah
HML	hamel
HMP	hempe
HMPSAYR	hampshire
HMPSR	hampshire
HMRA	hamra
HMR	hamer
HMR	hamer
HMR	hamer
HMSTD	hemstede
HMSYRH	shimayah
HMYD	hyde
HMYLTN	hamilton
HMYLTVN	hamilton
HMZA	hamza
HMZ	hamza
HMZH	hamah
HNA	hanaa
HNA	hanaa
HNAN	hanan
HNCLYF	hinchley
HND	hand
HNDL	handel
HNDRSN	henderson
HNDRSVN	henderson
HNDRYCVZ	hendrica
HNDRYCY	hendrica
HNDRYKA	hendriks
HNDRYKAS	hendriks
HNDRYK	hendriks
HNDRYKH	hendriks
HNDRYKJ	hendrikje
HNDRYKJH	hendrikje
HNDRYKS	hendriks
HNDRYKS	hendriks
HNDRYKS	hendriks
HNDRYKSH	hendrikse
HNDRYKSN	hendrickson
HNDRYKSVN	hendrickson
HNDRYKVS	hendriks
HNDRYKY	hendriks
HNDY	handy
HNDZ	hands
HN	han
HN	han
HNJ	hentje
HNJY	haney
HNKL	henkel
HNKS	hanks
HNL	henle
HNLY	heinly
HNNFNT	hennenfent
HNRYK	henrys
HNRYT	henrys
HNSLY	hensley
HNSN	hansen
HNT	hunt
HNTH	chenteh
HNTJ	hentje
HNTJH	hentje
HNTYG	hentig
HNYA	haniyya
HNYFA	hanifa
HNYFH	nayfeh
HNYGAN	henegan
HNYG	shenyang
HNY	haney
HNY	haney
HNYJ	haneys
HNYK	haneys
HNYNGSN	shenyangs
HNY	haney
HNZ	hinz
HPKRAFT	hopcraft
HPLR	hepler
HQYR	huyer
HRABY	hrabi
HRAK	horak
HRAN	horan
HRANYKY	hranicky
HRAYZYNG	thurayya
HRBAYJ	charbrays
HRBRT	herbart
HRBVRT	herbart
HRBYJ	huby
HRDASFYLD	herdsfield
HRD	herd
HRD	herd
HRDSFYLD	herdsfield
HRDZFYLD	herdsfield
HR	har
HRLAYNDYZ	harland
HRLNDYS	herlindis
HRLVY	harley
HRLYNDYS	herlindis
HRMAN	harman
HRMAN	harman
HRMAN	harman
HRMAN	harman
HRMANS	hermans
HRMN	harman
HRMN	harman
HRMN	harman
HRMN	harman
HRMNVS	hermans
HRMNYVS	harmanus
HRMS	harms
HRMVSV	harms
HRMZ	hormuz
HRNAKY	hranicky
HRNANDZ	hernandez
HRNDVN	herndon
HRN	horn
HRN	horn
HRN	horn
HRNKR	horner
HRNSBAY	hornsby
HRRA	herrera
HRSFAL	horsfall
HRT	hart
HRTLYNG	hertling
HRTVK	harte
HRV	harv
HRVN	harlan
HRVNYMVS	hieronymus
HRVS	harv
HRVY	harvey
HRYK	harrys
HRYKN	shryne
HRYNG	shryne
HRYNGSAV	phrygia
HRYS	harrys
HRYSVN	hyson
HRYT	chrystal
HRYVL	sheryl
HSAKA	hasakah
HSAKAH	hasakah
HS	hs
HS	hs
HSH	harsh
HSKAH	hasakah
HSKH	hasakah
HSMANS	heismans
HSMNS	heismans
HSNA	hasna
HSN	hosn
HSN	hosn
HST	haste
HSTR	hester
HSTYNGZ	hastings
HSYMANZ	hyman
HSYN	haydn
HSYN	haydn
HSYN	haydn
HSYN	haydn
HTCR	hatcher
HTKVKS	hakkas
HTRYK	hetrick
HTZLR	hetzler
HVADLY	hadley
HVA	shiva
HVAR	havard
HVBR	huber
HVBRMN	hoberman
HVBVRVG	heiberg
HVBVRV	harv
HVBVRVQ	harv
HVCYNSVN	hutchinson
HVDAYDAH	hudaydah
HVDGY	hegyi
HVD	hviid
HVDKYNS	hodgkins
HVDKYNZ	hodgkins
HVDSN	hodson
HVDSVN	hodson
HVFGARD	hofgaard
HVFRD	halford
HVFRYN	ghufran
HVFT	hooft
HVGAN	hogan
HVGARD	hugard
HVGARD	hugard
HVGARTY	hogarty
HVG	hg
HVG	hg
HVG	hg
HVGLND	hagland
HVGNBVM	hoogenboom
HVGN	hogan
HVGS	hgs
HVGTAYLYNG	houghtailing
HVGTYLYNG	houghtailing
HVGV	heigl
HVGVYN	hlavin
HVHNSVN	hohensohn
HV	harv
HV	harv
HVK	hak
HVKN	haven
HVLAND	heiland
HVLDN	holden
HVLDZVRS	holders
HVL	havel
HVL	havel
HVLKAMB	halab
HVLKNR	holkner
HVLM	holm
HVLMN	hellman
HVLMZ	hiltz
HVLNDNSYS	holtlandensis
HVLRVYD	holroyd
HVLS	hells
HVLSTN	holsten
HVLTLNDNSYS	holtlandensis
HVLYMN	hollyman
HVLZN	holzen
HVLZVARS	khazars
HVMAK	hallmark
HVM	halm
HVM	halm
HVMN	helman
HVNG	hong
HVNYGBRG	honigberg
HVP	hipp
HVP	hipp
HVPR	harper
HVQTYLYNG	hertling
HVQYM	hovey
HVRGAN	horgan
HVRKAN	horkan
HVRN	horn
HVRNR	horner
HVRSFVRD	horsford
HVRST	horst
HVRTMN	hartman
HVRTR	harter
HVRVAT	horvat
HVRVT	horvat
HVRVVYTZ	haratz
HVRVYTZ	haratz
HVRYGMV	phrygia
HVRYHAN	hourihan
HVRY	hilary
HVRYNG	shoring
HVRYV	hilary
HVS	hovis
HVSMN	heisman
HVSTVN	huston
HVTN	haven
HVVART	havarti
HVVN	hlavin
HVVR	havard
HVYA	helyar
HVYBRG	hoiberg
HVYD	hyde
HVYGN	huygens
HVYJN	hyun
HVYMAN	hyman
HVYNG	hong
HVYSR	huyser
HVYT	chevys
HVYTYNK	hoitink
HVYYSKN	hyson
HVZ	hz
HYBAX	hyman
HYBRG	khybers
HYBRT	hobart
HYBVRN	hebborn
HYCMN	hyman
HYCNS	hymens
HYDAJAT	hidajat
HYDLAND	hyland
HYDN	haydn
HYDN	haydn
HYDNR	haydn
HYDR	hydra
HYDRYC	hydra
HYDRYS	hydras
HYFA	haifa
HYFLR	heffler
HYFTZ	heifetz
HYGARTY	hogarty
HYGL	heigl
HYGN	huygens
HYGRMN	hegermann
HYGVNT	huygens
'HYH	ghayth
HY	hay
HYJDAN	hyman
HYJMN	hyman
HYKARV	shiyekar
HYK	hak
HYKMN	hyman
HYKSVN	hyson
HYKV	zhukov
HYKY	chayefsky
HYKY	chayefsky
HYLBRY	hillberry
HYLDBRAND	hildebrand
HYLD	hyland
HYL	hoyle
HYL	hoyle
HYL	hoyle
HYL	hoyle
HYL	hoyle
HYLKR	hilker
HYLMR	hilmer
HYLNBRND	hillenbrand
HYLND	hyland
HYLND	hyland
HYLNTH	haylett
HYLRY	hilary
HYLS	phylos
HYLSNTYGR	hilsenteger
HYLSVN	hyson
HYLT	haylett
HYLTH	ghayth
HYLT	haylett
HYLTJ	heyltje
HYLTJH	heyltje
HYLTJH	heyltje
HYLTJ	heyltje
HYLTN	hyland
HYLYARD	hillyard
HYLY	holy
HYLYRSTYN	hellerstein
HYLYS	haleys
HYLYTH	blyth
HYLZ	hiltz
HYM	hyman
HYMN	hyman
HYMN	hyman
HYMSTD	hemstede
HYNCLY	hinchley
HYNCY	chauncy
HYND	hyland
HYNDRYKA	hendriks
HYNGAN	henegan
HYNG	hong
HYN	hyun
HYNJ	hynes
HYNLY	heinly
HYNR	hynes
HYNS	hynes
HYNS	hynes
HYNS	hynes
HYNSVN	heymanson
HYNTVN	hinton
HYNTZ	heintz
HYNV	hynes
HYNVNN	hyvonen
HYNVZ	hinz
HYNZ	hinz
HYNZ	hinz
HYNZ	hinz
HYNZ	hinz
HYNZ	hinz
HYPGRYV	hipgrave
HYP	hyslop
HYPS	hays
HYRAY	hydra
HYRDGN	heerdegen
HYRD	hayward
HYRLY	hurley
HYRN	hyun
HYRNH	harsh
HYRN	hyun
HYRT	hirt
HYRVNYMAS	hieronymus
HYRVNYMVS	hieronymus
HYRVTA	hirota
HYSAN	hyson
HYS	hays
HYSKVKS	hoskins
HYSKVT	hesketh
HYSLAP	hyslop
HYSL	hyslop
HYSLVP	hyslop
HYSMANS	tysmans
HYSMNS	hymens
HYSR	huyser
HYTN	hyun
HYTR	hayter
HYTR	hayter
HYTS	hays
HYTSVN	hyson
HYTVN	hyson
HYTZ	hitz
HYTZ	hitz
HYVARD	havard
HYVGN	hyvonen
HYV	hay
HYVKYNZ	hyvonen
HYVM	hyman
HYVNGAN	henegan
HYVNSV	hynes
HYVVYT	hakluyt
HYVZ	chavez
HYVZR	holzer
HYYN	hyun
HYZ	hays
HYZMAN	hyman
HYZMANS	heezemans
HYZMNS	hymens
HYZMNZ	hymens
HYZYMNZ	hymens
HZLTVN	hazelton
HZMNZ	heinz
JABJH	babah
JAB	joab
JAB	joab
JAD	jared
JAD	jared
JAD	jared
JAGARD	jagard
JAG	jang
JAGR	jager
JAGV	jago
JAHMANH	jahmane
JAHNS	johns
JAKAMYNTH	jacomyntie
JAKSVN	jackson
JAKVAS	javas
JAKVBH	jarash
JAKVB	jake
JAKVBJH	jacobje
JAKVBJ	jacobje
JAKVBS	jarvis
JAKVBSVN	jakobsson
JAKVBSVN	jakobsson
JAKVBY	jacoby
JAKVBZ	jarvis
JAKVMYNTAY	jacomyntie
JAKVMYNTYH	jacomyntie
JAKVMYNTY	jacomyntie
JAKVMYT	hakluyt
JAKVS	jakes
JAKVYZ	jacklyn
JAKVZ	jake
JAKYVZ	jackys
JALA	jala
JALVNN	jalonen
JAMVNA	jamuna
JANA	jana
JANARDHAN	janardhan
JANATVN	jonathon
JANCS	janices
JANG	jang
JANG	jang
JANG	jang
JANGNYKL	tanganyika
JANGR	jang
JANGTAYY	january
JAN	jan
JAN	jan
JAN	jan
JAN	jan
JANK	jahnke
JANK	jahnke
JANKYNSVN	jenkinson
JANSH	jans
JANS	jans
JANSJH	jansje
JANSJ	jansje
JANSKY	jansky
JANSN	jansen
JANSN	jansen
JANSVN	jansen
JANSVN	jansen
JANTH	manith
JANT	janet
JANT	janet
JANTJ	jaantje
JANTVJ	jaantje
JANTYH	jansky
JANVTH	manith
JANVT	janet
JANVTJH	janotje
JANY	jansky
JANYKA	janecka
JANZ	janzen
JANZ	janzen
JAP	japan
JAPJH	jaepje
JAPJ	jaepje
JARAS	jarash
JARBVT	jarbot
JARDYN	jardine
JARS	jarvis
JART	jarbot
JARVALA	jarwala
JARVYS	jarvis
JARYTJN	marytje
JASCK	jaschek
JAS	jans
JASPR	jasper
JASPRZ	jaspers
JASTAM	justham
JASTAS	shastas
JASTJH	justje
JASTJ	justje
JAST	ojaste
JASTJY	jansky
JASTYH	jansky
JASTYN	jason
JASTYN	jason
JASTYN	jason
JASTYN	jason
JASTYS	katys
JASVA	java
JASVYNDR	jasvinder
JATJY	tjaatje
JATYNDR	jatinder
JAVF	java
JAVYD	javed
JAVYKA	jataka
JAVYR	javier
JAYAN	jayan
JAYANT	jayant
JAYARAM	jayaram
JAYN	jayan
JAYN	jayan
JAYNVR	jayne
JAYP	jay
JBHH	albahah
JBH	josh
JBYR	byer
JDY	jody
JF	jeff
JF	jeff
JFKK	jiok
JFRY	jeffry
JFRYZ	jeffrys
JHAMANH	jahamane
JHANG	jhang
JHAN	jehan
JHAR	johar
JHMANH	jahmane
JHRA	jahra
JKBS	jobs
JK	jake
JKMN	jakeman
JKMN	jakeman
JKSVN	jackson
JKVBS	jobs
JKVBSVN	jakobsson
JKVBZ	skiba
JKYN	jacklyn
JLA	jala
JLAL	jalal
JL	jul
JLJ	jeltje
JLNY	jinny
JLTH	blyth
JLT	jeltje
JLTJH	jeltje
JLVMARK	jelvemark
JMAL	jamal
JMAL	jamal
JMAR	jamar
JML	jamal
JML	jamal
JMML	jamil
JMVLA	jamulla
JMYLA	mylar
JMYLAH	jamilah
JMYLA	mylar
JMYL	jamil
JMYLH	jamilah
JMYLH	jamilah
JMYL	jamil
JNAH	jenah
JNA	jana
JNDRYAV	landrys
JNDRYC	landrys
JNG	jang
JNG	jang
JN	jan
JNK	junk
JNK	junk
JNKS	jenks
JNKS	jenks
JNKYNSVN	jenkinson
JNKZ	jenks
JNT	janet
JNTJS	jaantje
JNTRY	gantry
JNYFR	jenifer
JNYKH	jenah
JNYK	jennys
JNYNGZ	enying
JNYRV	enyart
JNYSYLDA	gnishilda
JPSN	japan
JPY	jay
JRADA	jerada
JRALD	jerald
JRARD	jared
JRARD	jared
JRARDY	raverdy
JRGNZ	jergens
JRHARD	erhard
JRMYAS	jeremys
JRMY	jeremy
JRMYK	jeremys
JRMYS	jeremys
JRS	jrs
JRSTL	gerstl
JRTRVD	jarrod
JRVNYMVS	jeronimus
JRVNYVS	jinnys
JRVYS	jarvis
JRYNG	drying
JRYNGR	bryner
JRYTSMA	jorritsma
JRYTY	bruty
JRYTZVN	ryzman
JSF	josef
JSPR	jasper
JSTR	jester
JSTVN	justin
JSYKA	asoka
JSYK	psyko
JTRV	jarvis
JTSAM	jetsam
JVAB	joab
JVANA	jana
JVANDR	juvander
JVANG	jang
JVAN	jovian
JVAN	jovian
JVANYTA	juanita
JVAV	java
JVAY	jay
JVBAL	jubal
JVBJ	jobje
JVB	job
JVB	job
JVBYN	robyn
JVDAS	judas
JVD	javed
JVDY	jody
JVDY	jody
JVF	jeff
JVF	jeff
JVFL	jill
JVGLA	jougla
JVHANA	johanna
JVHAN	jehan
JVHANSN	johansen
JVHANSN	johansen
JVHANSVN	johansen
JVHANSVN	johansen
JVHANSVN	johansen
JVHANY	johnny
JVHANZ	juhani
JVHANZ	juhani
JVLAY	jay
JVL	jill
JVL	jill
JVLTZ	oltz
JVLYANTH	jayant
JVLYANTJH	juliaantje
JVLYANTJ	juliaantje
JVLYANT	jayant
JVLYANY	jelleyman
JVLYF	joly
JVLY	joly
JVLY	joly
JVLY	joly
JVNAS	jonas
JVNGAN	jungian
JVNGANZ	junghans
JVN	jin
JVN	jin
JVN	jin
JVNV	ivanov
JVNY	jinny
JVNYN	jinan
JVNYVR	jinny
JVPRV	joppru
JVRAH	jurah
JVRA	java
JVRAN	jirman
JVRAVLV	jouravlev
JVRGNZ	jurgens
JVRJ	jivaro
JVRJN	jirman
JVRJN	jirman
JVRJYA	oriya
JVRJYV	jory
JVRK	jurek
JVRVYTZ	jory
JVRY	jory
JVRYNG	drying
JVRYSMA	jorritsma
JVRYTSMA	jorritsma
JVS	javas
JVSLYN	evelyn
JVSTH	justham
JVSTJ	justje
JVSTY	misty
JVSVA	java
JVSVYG	levavy
JVSYP	josip
JVTLYN	evelyn
JVVN	jovian
JVYDYP	joydeep
JVYNR	joyner
JVYNR	joyner
JVYSF	joys
JVYS	joys
JVYT	jayant
JVYT	jayant
JVZA	juza
JVZF	juza
JVZFVS	jeffs
JVZP	juza
JVZY	jay
JVZYH	najiyah
JVZY	jay
JVZY	jay
JYAF	jayan
JYA	jayan
JYAKVB	yake
JYAN	jayan
JYANY	jayan
JYAVRDANY	jayaraman
JYBSVN	jayson
JYBYNS	robyns
JYGANG	jigang
JY	jay
JY	jay
JYJSBRTVS	gijsbertus
JYKMN	jakeman
JYLAM	jayaram
JYLBRT	joubert
JYL	jekyll
JYLT	jayant
JYLYAN	jayan
JYLZ	jekyll
JYM	jaymes
JYML	jekyll
JYMSVN	jayson
JYMY	jimmy
JYMYNY	jiminey
JYMZ	jaymes
JYMZ	jaymes
JYMZ	jaymes
JYNAKYRAMAN	janakiraman
JYNG	tyng
JYN	jayan
JYN	jayan
JYN	jayan
JYN	jayan
JYN	jayan
JYNS	jaynes
JYNTVN	teynton
JYNYK	junk
JYNZ	jayne
JYPH	joesph
JYRARDYN	jayawardene
JYRMASKA	germuska
JYRVSK	jarviss
JYSH	josh
JYS	joys
JYSR	joys
JYSTR	eyster
JYSVZ	jayson
JYTA	jitta
JYVK	yok
JYVRDANV	jordan
JYVVANY	sylvan
JYVVYL	rysavy
JYVYL	lyly
JYZAN	jizan
JYZN	jayan
JYZSBRTVS	gijsbertus
JZYRH	jurah
KAB	kalb
KABRYLV	karayel
KACLYNG	jaclyns
KACV	kacalek
KACVN	bacon
KACY	lacy
KACYH	karachi
KADLASK	kailas
KADMN	kadin
KADMVS	kaldis
KADN	kaden
KADRYBYSYK	kadribasic
KADRYKYS	karyns
KADV	kado
KADYN	kadin
KAFRY	karty
KAFY	kay
KAFYN	kalyan
KAGBVRN	pangborn
KAGL	kagle
KAGL	kagle
KAGLYN	katelyn
KAGSAL	ragsdale
KAGSVL	kagle
KAHAN	kahane
KAHVN	kahane
KAKALK	kapalka
KAKANDS	oaklands
KA	aka
KAKBRYD	ackroyd
KAKDKAR	kakodkar
KAKRAFT	kraft
KAKRYL	karayel
KAKSHD	karakash
KAKTVS	kharkovs
KAKY	katy
KAKYVLA	kayla
KAKYVR	katiyar
KALA	kalia
KALAFATAS	kalafatas
KALAFVT	kalafut
KALAHAN	kalahari
KALANAN	kalpana
KALATVR	kalathur
KALBAVT	kabal
KALB	kalb
KALB	kalb
KALBRYJ	allbery
KALBYDA	kulbida
KAL	kale
KALDL	kaldis
KALDVL	kalevala
KALDVL	kalevala
KALDYS	kaldis
KALHYN	kathryn
KALHYNH	kathryns
KAL	kale
KALKAN	kalkan
KALKLASVR	kailas
KALMAN	kalman
KALMN	kalman
KALMN	kalman
KALMYS	kalmyk
KALPAK	kalpak
KALPANA	kalpana
KALPS	kalpesh
KALPYN	kalyan
KALR	kar
KALRTY	karty
KALRY	karty
KALSGH	kalish
KALSVN	karlsson
KALSYN	kalyan
KALT	kalt
KALTVN	kaitlin
KALV	kalev
KALVM	kalev
KALVNLV	kalevala
KALVRT	calvert
KALVYN	kalyan
KALYA	kalyan
KALYAN	kalyan
KALYANY	kalyan
KALYARV	katiyar
KALY	kalyan
KALYGY	kalyan
KALYLA	kayla
KALYNSAN	kalyan
KALYNT	kalyan
KALYNZ	kalyan
KALYS	kodalys
KALYS	kodalys
KALYSYAK	kalisiak
KALYYVS	khayyams
KAMACV	kamal
KAMALA	kamala
KAMAL	kamal
KAMAMA	kamala
KAMAR	kamdar
KAMAT	kamath
KAMB	kamb
KAMBS	kalbs
KAMBYTZ	kamiya
KAMBYY	kamiya
KAMBZ	kamb
KAMDAR	kamdar
KAMHVLZ	kamholz
KAM	kam
KAM	kam
KAML	kamal
KAMLN	kamelen
KAMLYS	kamiya
KAMN	kamen
KAMNS	kamens
KAMPAGNA	campagna
KAMPAR	kompar
KAMPBL	kampala
KAMP	kampe
KAMPR	kamper
KAMPTVN	brampton
KAMPVS	kampalas
KAMPYLV	kampala
KAMPYVTR	kamper
KAMR	kramer
KAMRVD	kamerud
KAMRVN	karin
KAMRVS	kramers
KAMSKAYA	kamskaya
KAMSTAK	kalisiak
KAMYA	kamiya
KAMYNG	karyns
KAMYN	kalyan
KAMYV	kamiya
KANAKAKVRN	kanakakorn
KANA	kana
KANAK	kanak
KANAL	kanal
KANAL	kanal
KANAN	kansan
KANAVA	kanaka
KANBVY	barnaby
KAN	kan
KANDAYV	kanda
KANDLY	kandell
KANDV	kandi
KANDVYYT	kandinsky
KANDY	randy
KANFR	kantor
KANFYLD	arnfield
KANG	kang
KANG	kang
KANG	kang
KAN	kan
KANKNT	anant
KANLN	kansan
KANLY	manley
KANLY	manley
KANN	kansan
KANR	kanter
KANRLY	early
KANRVY	karty
KANSL	kanal
KANSTABARYS	constabaris
KANSTABV	konestabo
KANTARA	cantara
KANTH	kants
KANT	kant
KANT	kant
KANTRA	kanter
KANTR	kanter
KANTRL	kanter
KANV	kan
KANVRY	gantry
KANYA	tanya
KANYF	kandolf
KANYG	kang
KANYNGHAM	cunningham
KANYS	katys
KANYSNA	kansans
KANYTZ	kants
KANYVN	kayvon
KANZY	kanze
KAPA	kappa
KAPANGA	kapanga
KAP	karp
KAPK	kalpak
KAPLAN	kaplan
KAPLN	kaplan
KAPLYNK	kaplenk
KAPNR	kapner
KAPRAL	kapral
KAPS	kaposi
KAPSVN	kapson
KAPVR	kanpur
KAPYLA	kapila
KARABVLVT	karabulut
KARAGR	kariger
KARAHR	karachi
KARA	kara
KARANJLV	karan
KARAN	karan
KARARA	karras
KARASA	karas
KARAS	karas
KARASKV	karak
KARASV	karas
KARAYL	karayel
KARBAJAL	carbajal
KARBALA	karbala
KARBN	karan
KARBVNLY	karbala
KARBVNYA	karina
KAR	kar
KARDAL	kardal
KARDL	kardal
KARDL	kardal
KARDLYS	kardelis
KARDNAS	karinas
KARDYNALY	kardal
KARGYL	argyle
KARHART	earhart
KARKARN	karan
KARKAS	karakash
KARLAYL	karayel
KARL	karl
KARL	karl
KARLKVYST	karlquist
KARLS	karls
KARLSVN	karlsson
KARLTVN	karlsson
KARLTVN	karlsson
KARLVS	karls
KARLVT	karls
KARLYN	karyn
KARLYN	karyn
KARMAN	karmann
KARMVDY	carmody
KARMVNA	karina
KARMYCAYL	karayel
KARN	karn
KARN	karn
KARNLYAN	kalyan
KARNR	karner
KARNRY	karner
KARNYA	karina
KARNY	karty
KARNY	karty
KARNZ	karn
KARP	karp
KARPLAS	karplus
KARPNTR	kapner
KARPNTYR	carpenter
KARSTNSN	carstensen
KARSTNZ	kirstens
KARSVN	karlsson
KARSVN	karlsson
KART	kmart
KARTNR	karner
KARTRAYT	karty
KARTR	karr
KARTVYZ	karty
KARTY	karty
KARTYK	karty
KARTYR	karty
KARTYS	karty
KARVLYN	karyn
KARVR	karr
KARVSV	karls
KARVSV	karls
KARVYN	karyn
KARYAGA	kirinyaga
KARY	karty
KARY	karty
KARYDA	karida
KARYDYAN	karridian
KARYH	karyn
KARYJR	katryntje
KARY	karty
KARYLV	karayel
KARYRA	karras
KARYS	karyns
KASAK	kalisiak
KASAMA	kasama
KASAM	kasama
KASANVVA	casanova
KASARA	kasahara
KASAT	kasat
KASGRVH	karish
KASL	karl
KASLMN	kalman
KASM	kasama
KASMN	klansman
KASMYCY	smyley
KASNR	kastner
KASNYR	kastner
KASPRZAK	kasprzak
KASRTYNV	karyn
KASRYL	karayel
KASTA	katta
KASTANV	kattan
KASTLV	kast
KASTLV	kast
KASTNR	kastner
KASTNR	kastner
KASTRCM	kasterchem
KASTRGYN	kathryn
KASTR	kastner
KASTRV	kasturi
KASTRYKAM	kasterchem
KASTRYKVM	kasterchem
KASTRYVM	kasaty
KASTVL	kast
KASTVRY	kasaty
KASTY	kasaty
KASTYLV	kasaty
KASTYN	kasaty
KASVF	kasouf
KASVN	kasun
KASY	kasey
KASYNG	karyns
KASYNLY	bayly
KASYNSKY	kandinsky
KASYV	kasey
KATA	katta
KATALANV	atalanta
KATAN	kattan
KATARYN	kathryn
KATB	kateb
KATBRT	kabir
KATCY	katy
KATKART	patkar
KATL	kati
KATL	kati
KATLMN	katleman
KATLR	kantor
KATLYR	katiyar
KATN	katen
KATR	kateri
KATRNTJ	katryntje
KATRYJ	katryntje
KATRYJN	kathryn
KATRY	kathryn
KATRYNA	katrina
KATRYNA	katrina
KATRYN	kathryn
KATRYN	kathryn
KATRYN	kathryn
KATRYN	kathryn
KATRYN	kathryn
KATRYNTH	katryntje
KATRYNTJH	katryntje
KATRYNTJ	katryntje
KATRYNTY	katryntje
KATVALA	kalevala
KATVPYS	katys
KATY	katy
KATYNG	keating
KATZ	katz
KAVASYN	cavasin
KAVAYY	kasaty
KAV	kave
KAV	kave
KAVDLYNG	katelyns
KAVDYL	kayla
KAVH	kaveh
KAVH	kaveh
KAV	kave
KAVLY	kalyan
KAVLY	kalyan
KAVLYNG	kalyan
KAVN	keaven
KAVRZ	kara
KAVS	kalis
KAVSTN	kastein
KAVYTA	kavita
KAYA	kaya
KAYAK	kayak
KAY	kay
KAYK	kayak
KAYLAS	kaylas
KAYL	kayla
KAYN	karyn
KAYN	karyn
KAYNY	karyn
KAYPR	kuyper
KAYRAS	kaylas
KAYRD	bayard
KAYRVF	kayvon
KAYSR	kayser
KAYT	kay
KAYT	kay
KAZDAN	kazdan
KAZGRYF	kingery
KAZMAYR	kazmaier
KAZVHYRV	kazuhiro
KAZVNVZY	kazans
KAZY	katy
KAZYR	katiyar
KAZYRR	katiyar
KBAKYAN	kabakian
KBAKYBV	kabakibo
KBANYS	albanys
KBRG	ekberg
KBR	akbar
KBYR	byer
KBYR	byer
KCNG	kecheng
KDAVR	kedar
KD	kid
KDL	kardal
KDL	kardal
KDR	kedar
KDYM	kolyma
KDYN	kevyn
KDYRA	keidra
KDYR	dayr
KDYSYA	odysseys
KDYSYH	odysseys
KFART	kmart
KHV	keshav
KK	kok
KLABVRN	lamborn
KLAF	kalafut
KLAG	klug
KLAG	klug
KLAGSTVN	langston
KLAK	kalpak
KLAMN	klansman
KLAMR	klammer
KLANFYLD	clanfield
KLANSY	klans
KLANTVN	kantian
KLARJH	klaartje
KLARK	karak
KLARK	karak
KLAR	kellar
KLARTAY	karty
KLARTH	earth
KLARTJH	klaartje
KLARTJ	klaartje
KLARTJY	klaartje
KLART	kmart
KLARTY	karty
KLARYJ	klaartje
KLASA	klassa
KLASJ	klassa
KLASJH	slash
KLASMYR	klausmeier
KLASN	klassen
KLASNR	klausner
KLAT	klatt
KLATZ	katz
KLAVDYA	kaya
KLAVDY	lavey
KLAVSY	blavatsky
KLAVYTR	kayser
KLAYN	karyn
KLAYN	karyn
KLAYR	layer
KLAYSJ	klauss
KLAYSVN	kayvon
KLAYSVN	kayvon
KLAYTVN	kayvon
KLAZ	blaz
KLAZVRA	klazura
KLAZYNG	karyns
KLBAY	kilby
KLB	kalb
KLBRN	kilbane
KLBVRN	kevran
KLBVRN	kevran
KLBY	kilby
KL	akl
KLDNY	kolodny
KLDVL	kuldell
KLDVY	kidby
KLFLT	kalafut
KLKAR	kelkar
KL	akl
KL	akl
KLMANZ	klemans
KLMBV	kamb
KLMN	kalman
KLMP	klemp
KLNFYLD	linfield
KLN	klan
KLN	klan
KLNR	kellner
KLRTAY	karty
KLRTY	karty
KLRVS	karls
KLT	kalt
KLTN	keltner
KLTNR	keltner
KLVB	kalb
KLVBK	kloubek
KLVKYNAS	kloukinas
KLVLY	kelly
KLVMPNR	clumpner
KLVNFRV	kellner
KLVSN	kelvin
KLVTH	kalish
KLVYNN	kelvinen
KLYBR	klyber
KLYBRN	klyber
KLY	kelly
KLY	kelly
KLYF	eklof
KLYFRD	klyber
KLYFT	kalafut
KLYFTVN	kalyan
KLYK	kalmyk
KLY	kelly
KLY	kelly
KLYLA	kayla
KLYMR	klyber
KLYMVF	kolyma
KLYNGRVT	klingler
KLYNK	kalyan
KLYN	kalyan
KLYN	kalyan
KLYNSVRG	kleinsorge
KLYNZ	kalyan
KLYR	klyber
KLYR	klyber
KLYR	klyber
KLYR	klyber
KLYRTYH	blyth
KLYS	kelleys
KLYSH	kalish
KLYTVN	kalyan
KLYVY	lyly
KMA	kama
KMAL	kamal
KMAL	kamal
KMBRY	kimberey
KMBS	kalbs
KMBZ	kamb
KMDR	kamdar
KMFVYS	emilys
KMFYLD	camfield
KM	kam
KMKR	kemker
KMLLV	kamil
KMPASTR	kempster
KMPBL	kampala
KMP	kemp
KMP	kemp
KMPR	kamper
KMPSTR	kempster
KMPVS	kempis
KMPY	empey
KMR	kmart
KMR	kmart
KMR	kmart
KMRVN	marvin
KMSPTR	kempster
KMSTR	kempster
KMYLAH	kamilah
KMYLA	kayla
KMYLH	kamilah
KMYR	emyr
KNAMVRY	kanamori
KNAVAY	kennaway
KNDAL	kendal
KNDL	kendal
KNDRYK	kendrick
KNDV	kandi
KNDVLF	kandolf
KNDY	kennedy
KNDYG	kendig
KNDY	kennedy
KNG	kang
KNG	kang
KN	kan
KN	kan
KN	kan
KNNYNG	kenning
KNPVL	knispel
KNRAD	konrad
KNRAD	konrad
KNRAD	konrad
KNRADVS	konrads
KNRAT	konrad
KNRDYNG	konerding
KNR	kanter
KNSYNGTV	kensingto
KNTA	kenta
KNTARV	kentaro
KNVB	knob
KNVFYNKH	knufinke
KNVL	knievel
KNY	keny
KNY	keny
KNYKRBKR	knickerbacker
KNYNGTVN	kennington
KNYN	kenyan
KNYSKY	kerensky
KNYVN	kenyon
KNYVN	kenyon
KNZ	kenz
KPJH	kapje
KPL	kapila
KPLY	kepley
KPR	koper
KPRT	kiepert
KPTAN	kapetan
KPYSTRAN	capistran
KRAB	krab
KRA	kara
KRACLY	tracy
KRACLY	tracy
KRACN	karaca
KRACR	kraack
KRAKART	krakatoa
KRAKFRD	bradford
KRAKFVRD	bradford
KRAK	karak
KRAK	karak
KRAKT	krakatoa
KRAMARY	kramer
KRAMHVRN	kramers
KRAMR	kramer
KRANDLMYR	crandlemire
KRANSVYK	krasnoyarsk
KRANSVYYK	krasnoyarsk
KRANZVYK	krasnoyarsk
KRAP	karp
KRAPR	draper
KRAQTVN	kristin
KRARAS	karas
KRASBY	ratsaby
KRAS	karas
KRASN	krasen
KRASYK	krasnoyarsk
KRATR	kratzer
KRATRZ	kratzer
KRATYGR	krattiger
KRATZR	kratzer
KRAVFVRD	trafford
KRAVL	ravel
KRAVLY	ravey
KRAVN	karan
KRAVN	karan
KRAVSVN	krasen
KRAY	karayel
KRAYDR	rayer
KRAYG	kraig
KRAYG	kraig
KRAYJ	kraaij
KRAYJ	kraaij
KRAY	karayel
KRAYSVL	karayel
KRAZN	kazan
KRAZYR	kratzer
KRBLA	karbala
KRBL	kerbel
KRBSR	krebser
KRBTRY	kirby
KRBVNYL	kirby
KRBYT	kirbys
KRC	kroc
KRDAL	kardal
KRDLA	karla
KRDL	kardal
KRDRY	kerry
KRFT	kraft
KRFTVN	krafts
KRG	krug
KRG	krug
KRGR	kerger
KRGR	kerger
KRHANG	kerhong
KRH	kresh
KR	kr
KRK	kirk
KRKRAFT	kraft
KRKRAFT	kraft
KRLY	orly
KRLYVS	orlys
KRMR	kramer
KRMYK	kalmyk
KRMYT	kermit
KRNAY	bernays
KRNFRD	cranford
KRN	karn
KRN	karn
KRN	karn
KRNL	kringle
KRNLYS	brinkleys
KRNLYVS	brinkleys
KRNS	kerns
KRNSVYK	kerenskys
KRNVL	kringle
KRNYZ	krenz
KRNZ	krenz
KRPS	karplus
KRRAY	kerry
KRS	krs
KRS	krs
KRS	krs
KRSKYNTYH	forsyth
KRSLYK	kerslake
KRSN	krasen
KRSNR	krasner
KRSNR	krasner
KRSNV	kresna
KRSPV	karp
KRST	krista
KRSTN	kerstin
KRSTS	kristas
KRT	kert
KRTLND	kirkland
KRTR	krister
KRTYN	karyn
KRTZR	kratzer
KRVASH	karakash
KRVASZ	karlas
KRVB	krob
KRVCFVRD	rockford
KRV	kirov
KRVD	kurd
KRVG	krug
KRVKFVRD	rockford
KRVK	krok
KRVKN	karvinen
KRVL	karl
KRVM	kram
KRVM	kram
KRVMH	nkrumah
KRVM	kram
KRVM	kram
KRVMN	kriman
KRVMR	kromer
KRVMY	kalmyk
KRVMYTS	kermits
KRVNHYM	arnhem
KRVNY	cerveny
KRVNZ	kronz
KRVPYK	kropik
KRVSBY	krissy
KRVSCN	kruschen
KRVS	kris
KRVSH	karish
KRVSN	krasen
KRVSN	krasen
KRVTYV	kristy
KRVVD	kurd
KRVYL	karayel
KRVYN	kevyn
KRVYR	kevyn
KRVZ	kronz
KRVZYR	kratzer
KRY	krey
KRYCFYLD	krystals
KRY	krey
KRYDA	karida
KRYDR	ryder
KRYGAN	kerrigan
KRYG	krug
KRYG	krug
KRYGR	kriger
KRYGR	kriger
KRY	krey
KRYK	krok
KRY	krey
KRY	krey
KRYLA	kayla
KRYLAS	kaylas
KRYL	karayel
KRYLYZ	marylynn
KRYM	kram
KRYMN	karyn
KRYN	karyn
KRYN	karyn
KRYN	karyn
KRYNZ	kronz
KRYPYV	krystal
KRYQR	breyer
KRYR	krey
KRYSAN	krystal
KRYSAYNTAY	krystal
KRYS	korys
KRYSC	krasic
KRYS	korys
KRYS	korys
KRYSH	kresh
KRYSJH	kresh
KRYS	korys
KRYS	korys
KRYSP	korys
KRYSPN	bryson
KRYSPYJN	krisoijn
KRYSPYN	kristys
KRYSSAYNTYH	krystals
KRYSTA	krystal
KRYSTA	krystal
KRYSTAL	krystal
KRYSTAL	krystal
KRYSTAL	krystal
KRYST	krystal
KRYSTLR	krystal
KRYSTMN	kristin
KRYSTMN	kristin
KRYSTN	krystal
KRYSTR	krystal
KRYSTV	krystal
KRYSTVF	krystal
KRYSTVFR	krystal
KRYSTVFRSVN	krystals
KRYSTVN	krystals
KRYSTVN	krystals
KRYSTYANA	kristian
KRYSTYAN	kristian
KRYSTYAN	kristian
KRYSTYANSN	krystals
KRYSTY	kristy
KRYSTY	kristy
KRYSTYJNTH	kristijntje
KRYSTYJNTJH	kristijntje
KRYSTYJNTJ	kristijntje
KRYSTYNA	kristina
KRYSTYN	kristys
KRYSTYNH	kristys
KRYSTYN	kristys
KRYSTYN	kristys
KRYSTYN	kristys
KRYSTYNTY	kristijntje
KRYSVAYJN	krisoijn
KRYSVJYN	rysavy
KRYSVYJN	krisoijn
KRYSVYN	rysavy
KRYSVZN	bryson
KRYSY	krissy
KRYSY	krissy
KRYSY	krissy
KRYSZ	korys
KRYTR	krystal
KRYVAS	krystals
KRYVASZ	krystals
KRYVN	karyn
KRYVSN	kayvon
KRYVVNVZ	kronz
KRYYK	kayak
KRZNA	karina
KSAVAN	kesavan
KSAV	keshav
KSAY	kasaty
KS	ks
KSK	kesek
KSKYN	keskin
KSL	kislo
KSL	kislo
KSLN	keshlan
KSLR	kessler
KST	kast
KSTLAK	kostelak
KSTL	kristol
KSTLVT	kislevs
KSTNR	kastner
KSTRAP	kastrup
KSTR	kester
KSTRCM	kasterchem
KSTRSVN	kesterson
KSVAN	kesavan
KSVN	kesavan
KSYDY	sydney
KSYM	syme
KSYM	syme
KTAN	ketan
KTARA	kotara
KTB	kateb
KTCAM	ketcham
KT	ket
KT	ket
KTLAR	kellar
KTL	ketil
KTL	ketil
KTLT	kalt
KTLY	ketley
KTNZRV	kastner
KTSYMATYDS	catsimatides
KTVLA	ketola
KTVYN	kevyn
KTY	katy
KTY	katy
KTYL	kettyle
KTZ	katz
KVAAYNTN	paynton
KVAKNBAS	kansas
KVAKNBVS	klans
KVA	akiva
KVAL	val
KVALSYK	kalmyk
KVANBAY	sanjay
KVANG	kang
KVANG	kang
KVANG	kang
KVAN	kevran
KVANLAN	klansman
KVANRAD	konrad
KVANRAD	konrad
KVANRADT	vanzandt
KVANRADVS	konrads
KVANRDT	vanzandt
KVANRYD	vandry
KVANTVN	kantian
KVARSKY	kovarski
KVARTZYTH	karty
KVASMAN	klansman
KVAST	kast
KVASYM	kasey
KVATRYN	kathryn
KVAVRYNG	karyns
KVAYLYSY	kaylas
KVAYMAN	ayman
KVAYNTANA	santana
KVAYNTVN	paynton
KVAYT	kuwayt
KVBA	skiba
KVB	kalb
KVB	kalb
KVBLA	kubla
KVBN	kevin
KVBSA	kobsa
KVBV	kibo
KVBV	kibo
KVBYB	kilby
KVBYLAH	lylah
KVBYLA	kayla
KVCAR	kuchar
KVC	kick
KVCRAN	kevran
KVCY	vicky
KVCYH	koch
KVDAMAH	qudamah
KVDAMA	kama
KVDVGNV	kadin
KVDY	kidby
KVGANDA	konganda
KVGLAN	klan
KVGLYN	evelyn
KVGVMA	kogoma
KVHAN	khan
KVHN	kuhn
KVJH	kaveh
KVJYAS	srivijayas
KVKAL	kokal
KVKALYK	kalmyk
KV	kave
KVKBRN	kevran
KVK	kok
KVKFYLD	kikuyu
KVK	kok
KVKNBAS	kansas
KVKNJ	kevens
KV	kave
KVK	kok
KVKRYL	karayel
KVKSVN	kesavan
KVKTAVAY	koktavy
KVKVNN	karvinen
KVKVRK	kirk
KVKYA	kaya
KVLASA	kolasa
KVL	kevlar
KVL	kevlar
KVLKA	kolkka
KVLMN	kellman
KVLN	kevin
KVLN	kevin
KVLN	kevin
KVLNV	kevin
KVLR	kevlar
KVLSAR	kevlar
KVLS	kills
KVLSVN	kelvin
KVLT	kalt
KVLTY	kelty
KVLVL	kalevala
KVLYCALA	kolichala
KVLY	kelly
KVLY	kelly
KVLYHA	koliha
KVLYN	kevyn
KVLYNG	kevyn
KVLYNGVVD	slangsvold
KVLYNS	katelyns
KVLYNZ	kevyn
KVLYR	kevlar
KVLYS	kelleys
KVMAR	kumar
KVMARV	kumar
KVMBR	kimberey
KVMPTVN	kapetan
KVMR	kumar
KVMR	kumar
KVMVRV	kimura
KVMVRYTA	komorita
KVN	keven
KVNG	king
KVNG	king
KVNKA	kanaka
KVN	keven
KVN	keven
KVNRAD	konrad
KVNRAD	konrad
KVNRADVS	konrads
KVNRAT	konrad
KVNRAT	konrad
KVNRAYT	kraft
KVNRYAT	kenyatta
KVNT	kint
KVNV	keven
KVNVPKA	konopka
KVNVR	invar
KVNVVR	invar
KVNYNG	enying
KVPJANZ	kalpana
KVPJ	kapje
KVP	kip
KVPLN	kaplan
KVPLND	lapland
KVPLS	koppels
KVPNZ	kenz
KVPR	koper
KVPR	koper
KVPS	kips
KVRADYNY	kevran
KVRAM	kram
KVRAN	kevran
KVRAN	kevran
KVRAPATY	koorapaty
KVRBT	kiribati
KVRBYN	kirbys
KVR	kovar
KVRDAS	kordas
KVRDS	kordas
KVRDYK	raverdy
KVRDZ	kurd
KVRKAM	kram
KVRKVL	kirk
KVRL	karl
KVRLY	beverly
KVRN	kevran
KVRNLH	kornele
KVRNLVS	kringles
KVRNLYS	beverlys
KVRNLYVS	beverlys
KVRNLYVSN	kenyan
KVRNLYZ	krenz
KVRNVAL	transvaal
KVRNYVL	karayel
KVRNZ	krenz
KVRP	korp
KVRSL	krs
KVRSLV	kislev
KVRSN	kevran
KVRSTN	kirsten
KVRT	kurt
KVRTH	keerthi
KVRTL	kurt
KVRTLND	kirkland
KVRTLNT	kevran
KVRTRAYT	rattray
KVRTZ	klotz
KVRVNLA	karina
KVRVYN	karyn
KVRYA	korys
KVRY	kory
KVRY	kory
KVRYDVR	ryder
KVRYGAN	kerrigan
KVRY	kory
KVRY	kory
KVRYLA	kayla
KVRYL	karayel
KVRZAYN	kevran
KVSADA	kanda
KVSAK	kusack
KVSAY	kasaty
KVSH	kish
KVSJH	kish
KVSJ	krisje
KVSKY	nevsky
KVSKYMAKY	koskimaki
KVSLV	kislev
KVSMANS	klansmans
KVSMANZ	kinsman
KVSMAS	kamas
KVSMNS	klansmans
KVSNKV	kosenko
KVSTA	kosta
KVSTA	kosta
KVSTANZA	costanza
KVST	kast
KVSTN	kosten
KVSTRMN	kusterman
KVSTYLV	kristy
KVSTYS	kristys
KVSVGH	keogh
KVSYN	kevyn
KVSYRA	syria
KVSZ	kievs
KVTA	kavita
KVTCAY	avichay
KVT	kit
KVTCY	kitch
KVTJANZ	kattan
KVTLA	kotla
KVTMAYR	mayr
KVTNY	keny
KVTRVNYV	katrin
KVTY	kelty
KVTZ	kutz
KVVAR	kevlar
KVV	kiev
KVVS	kievs
KVYALSKY	rogalsky
KVYALYK	kalmyk
KVY	kevyn
KVYCY	vicky
KVYK	kalmyk
KVYKNBAS	kloukinas
KVYKNBVS	keynes
KVYL	kyle
KVYL	kyle
KVYL	kyle
KVYLYN	evelyn
KVYMN	kevyn
KVYN	kevyn
KVYN	kevyn
KVYN	kevyn
KVYN	kevyn
KVYN	kevyn
KVYN	kevyn
KVYN	kevyn
KVYNRAD	konrad
KVYNRAD	konrad
KVYNRAD	konrad
KVYNRAT	kevyn
KVYNRAYT	kevyn
KVYNRDVS	konrads
KVYNRYDVS	konrads
KVYNRYT	kevyn
KVYNTANA	quintana
KVYNTN	kevyn
KVYNT	kevyn
KVYNTVN	teynton
KVYPR	kuyper
KVYRYN	karyn
KVYSMAN	tysmans
KVYST	krystal
KVYT	kyte
KVYT	kyte
KVYYKL	kalmyk
KVYYLYN	evelyn
KVYYMAN	lyman
KVYYMN	kevyn
KVYYNLN	kevyn
KVYYNTANAR	quintanar
KVYYNTVN	kyrgyzstan
KVYY	kevyn
KVYYST	kyrgyzstan
KVYYT	kyte
KVYYTZ	klotz
KVYZMN	ryzman
KVZN	kevin
KVZV	kazi
KVZY	kevyn
KVZY	kevyn
KVZYN	kevyn
KYALASA	kailasa
KYASVN	yasin
KYAT	yat
KYB	klyber
KYBH	kyushu
KYBL	sybil
KYBL	sybil
KYBLR	kibler
KYBLR	kibler
KYBV	klyber
KYCN	kocian
KYCRV	lycra
KYCYN	jaclyn
KYD	kid
KYD	kid
KYDL	kyle
KYDRA	hydra
KYF	kyle
KYF	kyle
KYFR	klyber
KYFR	klyber
KYGAN	keyuan
KYGYNZ	kyrgyzstan
KYHL	kohl
KYHV	kyushu
KYJV	kyle
KYKBRD	klyber
KYKBRYD	bryde
KY	kay
KY	kay
KY	kay
KY	kay
KYK	kayak
KYKVMA	kikuma
KYLAN	dylan
KYLBAY	kilby
KYLBRV	klyber
KYLBY	kilby
KYLBYN	kilby
KYLG	kilg
KYLGVR	kilgore
KYLH	kyle
KYLHVRN	kielhorn
KYL	kyle
KYL	kyle
KYL	kyle
KYLPK	kalpak
KYLR	kyle
KYLR	kyle
KYLR	kyle
KYLRMT	killermet
KYLT	kyle
KYLY	lyly
KYLYVN	kalyan
KYLZ	kyle
KYMBAL	kimball
KYMBRLY	kimberly
KYMBRY	kimberey
KYM	kolyma
KYM	kolyma
KYMPA	kompar
KYMV	kolyma
KYMVN	kayvon
KYMVRA	aymara
KYMZ	kolyma
KYNA	dyna
KYNAN	keynesian
KYNANN	keinanen
KYNARD	kinard
KYN	karyn
KYNCN	kinchen
KYNGASTVN	kingston
KYNGFAY	kingfai
KYNGRY	kingery
KYNGSFVRD	kingsford
KYNGSTVN	kingston
KYNGZTN	kyrgyzstan
KYNH	keyne
KYN	karyn
KYN	karyn
KYN	karyn
KYN	karyn
KYN	karyn
KYN	karyn
KYN	karyn
KYN	karyn
KYNKNN	keinknen
KYNKYD	kinky
KYNMN	kinman
KYNMN	kinman
KYNRSLY	kinnersley
KYNSLA	keynesian
KYNSL	karyns
KYNSMN	kinsman
KYNSVN	keynesian
KYNT	kint
KYNT	kint
KYNTL	kintel
KYNY	keny
KYNY	keny
KYNYNY	kenny
KYNYVN	kinyon
KYNZ	kenz
KYNZMAN	ryzman
KYNZY	kinky
KYP	skype
KYP	skype
KYP	skype
KYPLYNG	kipling
KYPYNG	kipling
KYRA	byra
KYRAN	koran
KYRAS	kyrus
KYRBAY	kirby
KYRBY	kirby
KYR	kyrus
KYRK	kirk
KYRTA	krystal
KYRTY	karty
KYRVN	kayvon
KYRYL	karayel
KYRYSY	korys
KYSA	krystal
KYS	katys
KYS	katys
KYS	katys
KYS	katys
KYSLV	kislev
KYSNRVS	kishinevs
KYSR	kayser
KYSR	kayser
KYSTVFR	eyster
KYSVN	kayvon
KYSY	rysavy
KYSYDY	sydney
KYSY	rysavy
KYSYNJR	kushnir
KYSYN	kosygin
KYTAGVCY	kitaguchi
KYTAMVRA	kitamura
KYTC	kitch
KYTCN	kitchen
KYT	kyte
KYT	kyte
KYT	kyte
KYT	kyte
KYT	kyte
KYTL	krystal
KYTLY	ketley
KYTS	kyotos
KYTY	katy
KYTYNG	tyng
KYV	kyle
KYVCY	rysavy
KYV	kyle
KYVK	kayak
KYVKYVLYS	ryukyus
KYVMR	kovar
KYVNG	kayvon
KYVNG	kayvon
KYVNG	kayvon
KYVS	kyles
KYVSMATV	krystal
KYVYVALY	kivivalli
KYVZVN	kayvon
KYZR	kizer
KZMNZ	kenz
'LAALDYN	alaaldin
LABAT	labatt
LABDN	labdon
LABDVN	labdon
LABKYN	lubkin
LABLA	labella
LABL	labella
LAB	lamb
LABRAD	labroad
LABRYVLA	labriola
LABSR	labore
LABYN	abyan
LACLN	lachlan
LACNS	laocoons
LACYNY	lacys
LADASKY	ladasky
LADR	lander
LADRVT	laderoute
LADVN	landin
LADVVYKA	divya
LADVVYKVS	gladys
LADVYG	gladys
LADYK	ladak
'LADYN	gladys
LADYVYL	advil
LAFAM	latham
LAFAVNTYN	lafountaine
LAFGRYN	lofgren
LAFVRKAD	labroad
LAFY	laffey
LAGRLYNG	lagerling
LAGRSTRVM	lagerstrom
LAGVMVRVF	langmuir
LAGVN	lagoon
LAHLMA	lahelma
LAHYJ	lahij
LAJ	lahij
LAJRBRG	lagerberg
LAKAY	laky
LAKH	lakesha
LAKLH	lakisha
LAK	slak
LAK	slak
LAK	slak
LAK	slak
LAKR	sakr
LAKS	laakso
LAKSV	laakso
LAKSYN	laky
'LAKVABAH	alaqabah
LAKVTVRH	laith
LAKVVD	lakewood
LAKY	laky
LAKY	laky
LAKYSA	leakeys
LALKYN	allyn
LAL	lal
LALS	lais
LALY	laly
LALYT	laly
LAMARK	lamark
LAMASTVS	lamastus
LAMBARD	lombard
LAMBARDV	lombardi
LAMBDA	lambda
LAMBLY	lamboley
LAMBRN	lamborn
LAMBRT	lambert
LAMBRVS	lambros
LAMBVLY	lamboley
LAMBVRN	lamborn
LAMBVRN	lamborn
LAM	lam
LAM	lam
LAMPLAYT	lamplight
LAMPN	lampen
LAMPY	lampi
LAMPYT	lampitt
LAMRS	lamars
LAMVRS	lamars
LAMYKYN	lamykin
LANA	lana
LANDAGR	lundager
LANDASTRVM	lundstrom
LANDAYR	landauer
LANDBRG	lindberg
LANDGRN	lindgren
LANDGRYN	landrys
LANDKVYYST	landrys
LAND	land
LANDL	landahl
LAND	land
LANDMN	landman
LANDN	landen
LANDR	lander
LANDRS	landers
LANDRVM	landrum
LANDRY	landry
LANDRZ	landry
LANDYN	landin
LANDYN	landin
LANDYS	landrys
LANGDVN	langdon
LANG	lang
LANG	lang
LANG	lang
LANGLY	langley
LANGNZ	langnes
LANGSA	langs
LANGSAV	langs
LANGSTVN	langston
LANGSV	langs
LANGV	lang
LANGYR	langley
LANJ	lana
LANKA	lanka
LANKART	lonkart
LANKSTAF	longstaff
LANKTVN	lankton
LAN	lan
LAN	lan
LAN	lan
LAN	lan
LANR	lander
LANR	lander
LANSDYL	landry
LANSFRD	lunsford
LANS	alans
LANSTZ	lantz
LANSYNG	lansing
LANTA	atlanta
LANT	lantz
LANTLVSAMAD	lantlosamade
LANTRMAN	lanterman
LANTZ	lantz
LANTZ	lantz
LANVM	lannom
LANVSY	lanny
LANY	lanny
LANY	lanny
LANZ	lanz
LAPASV	lapaso
LAP	lap
LAPLAYN	laplaine
LAP	lap
LAPVRD	laird
LAPVRS	aprs
LAPVRT	laporta
LAPVTA	laputa
LAPVVRS	aprs
LAPYDARY	lapidary
LAPYSKV	lapaso
LARA	lara
LARALY	laralee
LARDYNGA	flardinga
LARJA	lara
LARJ	learjet
LARN	larren
LARNS	larsens
LARNS	larsens
LARSN	larsen
LARSN	larsen
LARSVN	larson
LARTR	larter
LARVC	alaric
LARVKVYH	larrys
LARV	marv
LARVRL	larurel
LARYF	larry
LARYSA	larrys
LARYVYR	lariviere
LARZ	marz
LASKALA	lascala
LASKA	laska
LASKARY	baskar
LASK	laska
LASKVS	laskos
LAS	las
LAS	las
LAS	las
LASNYK	lasnik
LAST	last
LASTRA	lastra
LASTR	lastra
LASTRY	lastra
LASTYNG	lansing
LASVN	larson
LASYNGR	losinger
LATALA	latala
LATA	latta
LATAM	latham
LATBRY	lathbury
LATBVRY	lathbury
LATKYNZ	slatkin
LAT	last
LATZ	glatz
LAVANDH	laplands
LAVAYN	malayan
LAVD	laud
LAV	slav
LAV	slav
LAVLS	laval
LAVMN	slavin
LAVNKA	hlavenka
LAVNYVS	lannys
LAVRAY	lavery
LAVRNS	laverns
LAVSTAD	lovstad
LAVTN	latin
LAVTVN	latvian
LAVYGNH	lavigne
LAVYN	lavey
LAVYT	lavey
LAVZAK	lazar
LAYAN	malayan
LAYBS	laylas
LAYBZ	playboy
LAYDVYNA	ladonna
LAYDYA	lydia
'LAYDYN	alaaldin
LAYHV	ayah
LAYKZ	lamykin
LAY	laly
LAYL	layla
LAY	laly
LAYMAK	lamark
LAYMB	lamb
LAYND	lynda
LAYNG	laing
LAYN	lanyon
LAYN	lanyon
LAYRD	laird
LAYTBRN	clayton
LAYTMN	layamon
LAYTNYNG	lansing
LAYV	layla
LAYV	layla
LAYV	layla
LAYVLY	lyly
LAYVRYTSN	lauritsen
LAYVSAY	livesay
LAYVVY	playboy
LAYVY	lavey
'LAYYN	malayan
LAZARA	lazara
LAZARD	lazard
LAZARV	lazar
LBANRD	libannord
LBANVRD	libannord
LBDAN	ibadan
LBDVN	labdon
LBN	laban
LBRYNYDYS	brandys
LBVN	lebon
LBVR	alber
LBVRT	albert
LCLH	loch
LCMN	alcmena
LCMR	alcmere
LCNR	lechner
LDFVRD	ledford
LDJ	leda
LDK	ladak
LDVAYDJ	levavy
LDVYK	levys
LF	alf
LFLR	leffler
LFTVS	loftus
LG	leg
LHAN	lehan
LHLH	lehle
LHMAN	lehman
LHMAN	lehman
LHMN	lehman
LHMN	lehman
LHNRR	lehnerer
LHRNTZ	lohrentz
LHRYAN	lehrian
LHYJ	lahij
LHY	leahy
LJ	elsje
LKAMBR	lambert
LKRN	karn
LKRVS	kris
LKS	likes
LKSN	elkan
LKVST	lovstad
LKY	laky
LMBRN	lamborn
LMBRN	lamborn
LMBRT	lambert
LMBVRNH	lamborn
LMBVRN	lamborn
LMBVRN	lamborn
LMBVVRN	lamborn
LM	alm
LMP	lamp
LMPYNG	lamping
LMRZ	marz
LMVN	ilmin
LMYR	palmyra
LNDAHL	landahl
LNDAVR	landauer
LND	land
LNDRY	landry
LNDRZ	landry
LNDVAY	lindsay
LNDY	lindy
LNDYN	lindy
LNDYNV	lindy
LNDZ	lodz
LNGLY	langley
LNGLYNG	lengeling
LNGMYD	langmaid
LNGMYD	langmaid
LNGSS	langs
LNGSTN	langston
LNGSTVN	langston
LNKY	slinky
LNLVSAMAD	lantlosamade
LNLVZAMYD	lantlosamade
LNNDN	landen
LNRT	lehnert
LNS	lens
LNSVN	lanson
LNTLVSAMAD	lantlosamade
LNTLVSAMYD	lantlosamade
LNTYN	lentin
LPARD	lepard
LPART	leppart
LPLA	leppla
LP	lap
LPVRS	alperts
LPVRTA	laporta
LPVVRS	louvres
LRAP	lap
LRBZ	lerbs
LRD	lord
LRMN	lerman
LSARD	lessard
LSLY	lesley
LSR	laser
LSR	laser
LST	last
LSYAK	lesiak
LTBRY	lathbury
LTJY	latoya
LTRYJ	tryntje
LTV	latvia
LVALAY	malay
LVATS	levants
LVAYNGH	zaynah
LVAYNJ	levant
LVAYN	lanyon
LVBV	lvov
LVBVTYN	libyan
LVBYN	libyan
LVC	slavic
LVDMN	lodman
LVDVRF	ludorf
LVDVVYKA	divya
LVDVVYKAS	divya
LVDVYJK	levavy
LVDVYKA	divya
LVDVYKAS	dykes
LVDVYK	levavy
LVDVYKS	levys
LVDVYKVS	levys
LVDVYSVS	levys
LVFARV	lofaro
LVFASV	lofaso
LVFBARV	lofaro
LVFR	loafer
LVFSTRVM	lofstrom
LVGH	leigh
LVGNDRA	logendra
LVGZ	alvarez
LVJYK	lavey
LVKA	sluka
LVKARD	lockard
LVKAS	vikas
LVK	lok
LVK	lok
LVK	lok
LVK	lok
LVK	lok
LVK	lok
LVKN	loken
LVKS	slovaks
LVKSTVN	galveston
LVKV	lvov
LV	alva
LV	alva
LV	alva
LVMAS	limas
LVMBARDV	lombardi
LVML	laval
LVM	lim
LVMN	loveman
LVNAN	slovenian
LVNAV	lina
LVNDAN	lindman
LVND	lind
LVNDVN	landin
LVNJ	alvins
LVN	alvin
LVN	alvin
LVNLY	lonely
LVNMV	ivanov
LVNYG	long
LVNY	lindy
LVNY	lindy
LVNY	lindy
LVNYNGDAL	lonningdal
LVNZ	lunz
LVNZ	lunz
LVPATKYN	lupatkin
LVP	lap
LVPR	luper
LVPRSTY	lopresti
LVPYN	lyn
LVPZ	lopez
LVRA	elvira
LVRA	elvira
LVRC	lorch
LVRD	lord
LVRJYV	lavery
LVRNA	lorna
LVRN	lavern
LVRNS	laverns
LVRNT	levant
LVRNTZN	lorentzen
LVRNZ	lorenz
LVRNZN	lorenzen
LVRNZV	lorenzi
LVRNZY	varney
LVRTVN	lorton
LVRTY	varty
LVRY	lavery
LVRY	lavery
LVRY	lavery
LVRY	lavery
LVRY	lavery
LVSANTVS	losantos
LVS	luvs
LVS	luvs
LVSMVR	loosmore
LVSRV	lvov
LVSSKV	luvss
LVST	list
LVSTR	lister
LVSTY	lusty
LVSYH	livesay
LVSY	livesay
LVSY	livesay
LVSY	livesay
LVSYTV	livesay
LVTBG	luttbeg
LVTMPYV	lotempio
LVTR	lister
LVTYNZ	lyn
LVTZ	lutz
LVVRA	elvira
LVVRJAT	lauverjat
LVVT	lvov
'LVY	levy
'LVY	levy
LVYD	loyd
LVY	levy
LVY	levy
LVYNDN	lyndon
LVYNG	loyang
LVYN	lyn
LVYN	lyn
LVYNSVN	levinson
LVYS	levys
LVYSYLY	lyly
LVYSYVR	levys
LVYYNGH	aliyyah
LVYYNG	loyang
LVYYSALY	livesay
LVYYZV	allyz
LVYZ	allyz
LVZANV	lozano
LVZYR	layer
'LYA	alya
'LY	sly
'LYA	alya
'LYA	alya
'LYA	alya
LYA	alya
'LY	sly
'LY	sly
LYAM	layamon
LYANG	loyang
LYANZ	lanz
LYAV	alya
LYBANNRD	libannord
LYBANVRD	libannord
LYBCN	liebchen
LYBL	lyell
LYBLYT	lyly
LYBMN	lymn
LYBRCAK	lyrical
LYBRG	nyberg
LYBRN	leybourne
LYBRTY	liberty
LYBRYK	librik
LYBSKAMB	kamb
LYBSN	alyson
LYBVRN	leybourne
LYBVYTZ	lyubovny
LYBYD	lyly
LYBY	lyly
LYCARSVN	licharson
LYCFYLD	litchfield
LYC	alyce
LYCMR	lycra
LYCTN	lichten
LYCVRVYYS	lycurgus
LYDAL	myrdal
LYDA	lydea
LYD	loyd
LYDMAN	lyman
LYDN	leyden
LYDN	leyden
LYDRAK	lydea
LYDRDRAP	leiderdorp
LYDRDRP	leiderdorp
LYDRDRVP	leiderdorp
LYDRDVRP	leiderdorp
LYDR	layer
LYDVR	lydia
LYDVYNA	dyna
LYDYA	lydia
LYDYA	lydia
LYFAYV	lefaive
LYGYV	lyly
LYHY	lyly
LYK	slyke
LYKYVRY	lyubovny
LYLA	layla
LYLA	layla
LYLA	layla
LY	ely
LYLBK	lilback
LY	ely
LY	ely
LY	ely
LY	ely
LY	ely
LYLY	lyly
LYLY	lyly
LYLYND	leelynde
LYLYNTAL	lilienthal
'LYMA	lyman
'LYM	lyme
'LYMA	lyman
LYMBAX	lyman
LYMBVRG	limburg
LYM	lyme
LYMN	lymn
LYMR	lyme
LYMYNG	lymans
'LYN	allyn
LYNAN	lynn
LYNARS	lyndas
LYNDAL	lynda
LYNDAN	lyndas
LYNDBK	lindback
LYNDBRG	lindberg
LYNDGARD	lindgard
LYNDGRN	lindgren
LYNDHLM	lindholm
LYND	lynda
LYND	lynda
LYNDL	lyndel
LYNDL	lyndel
LYNDMN	lyndon
LYNDMN	lyndon
LYNDN	lyndon
LYNDNMVT	lindenmuth
LYNDR	lynda
LYNDRMN	linderman
LYNDRVTS	lynds
LYNDSY	lynds
LYNDVN	lyndon
LYNDZ	lynda
LYNDZY	lynda
LYNGAS	lyndas
LYNGLY	lingley
LYNHAN	linehan
LYNH	lynch
LYNKH	lynch
LYNK	lyn
LYNKLN	lynn
LYNKVLN	lynn
LYNKVYS	slinkys
LYN	lyn
LYN	lyn
LYN	lyn
LYN	lyn
LYN	lyn
LYN	lyn
LYN	lyn
LYNSTRAT	lysistrata
LYNVAL	lindvall
LYNVNN	lynn
LYNVRA	lyra
LYPARD	lepard
LYPKYN	lipkin
LYPSKAMB	lipscomb
LYPSKMB	lipscomb
LYPSKM	elysium
LYPSKVMB	lipscomb
LYPSKVMP	lipscomb
LYPST	lipset
LYPYJ	lyly
LYR	lyra
LYR	lyra
LYRN	lyn
LYRYKAL	lyrical
LYRYK	lyly
LYSBTH	lysbethje
LYSBTJH	lysbethje
LYSBTJ	lysbethje
LYSBTJY	lysbethje
LYSKANV	elysian
LYSKMB	elysiums
LYSKN	alyson
LYSKY	liskey
LYS	elyse
LYSN	alyson
LYSN	alyson
LYSTR	eyster
LYSTVN	blystone
LYSVN	alyson
LYSVN	alyson
LYSY	lyly
LYSYN	alyson
LYT	lytle
LYTL	lytle
LYTLTVN	littleton
LYTLY	lyly
LYTMN	lymn
LYTN	leyton
LYTRL	lytle
LYTV	lytle
LYTVN	leyton
LYTVN	leyton
LYTVYN	leyton
LYVA	layla
LYVANDN	lyndon
LYVANDVN	lyndon
LYVAYN	lyman
LYVBVNY	lyubovny
LYVH	lylah
LYV	lyle
LYV	lyle
LYV	lyle
LYV	lyle
LYV	lyle
LYVNARD	maynard
LYVNARDV	maynard
LYVNDVN	lyndon
LYVNGVD	livengood
LYVN	lyn
LYVNL	lyndel
LYVNSBRY	lounsbery
LYVNVRA	lyra
LYVNZ	lyons
LYVVH	lylah
LYVV	lyell
LYVY	lyly
LYVYNGSTVN	livingston
LYVYN	lyly
LYVYN	lyly
LYVYS	levys
LYVYV	lyly
LYVYVS	levys
LYVYVY	levavy
'LYYAH	aliyyah
LYYL	lyly
LYYVVH	aliyyah
LYZA	lyra
LYZA	lyra
LYZARD	lizard
LYZARDZ	lizards
LYZBTY	lyubovny
LYZ	allyz
LYZN	lymn
LYZR	layer
LYZVT	allyz
MABANAG	mabanag
MABAY	malay
MABY	mawby
MAC	mac
MACTLD	machteld
MADABA	madaba
MADAKS	madrass
MADJ	madej
MADLYN	madelyn
MADLYN	madelyn
MADLYN	madelyn
MADN	madon
MADRVN	madrone
MADSN	madsen
MADVN	madon
MADVRAY	madras
MADYGAN	madigan
MADY	mady
MADYS	mandys
MADYSVN	madison
MADYV	mady
MAFRY	maffray
MAFYN	mayan
MAGAGNA	magagna
MAGARD	maggard
MAGDALYNTH	magdaleentje
MAGD	magda
MAGLYRV	magyar
MAGR	mager
MAGRVDR	magruder
MAGS	maggs
MAGVAYR	magyar
MAGVYR	magyar
MAGYL	magyar
MAHADVAN	mahadevan
MAHAJAN	mahajan
MAHALT	mahault
MAHALY	mahaly
MAHA	maha
MAHAVLT	mahault
MAHTV	mahto
MAHVLT	mahault
MAHVT	mahto
MAJV	maj
MAJY	marjory
MAJYV	marjory
MAKARAYG	macaraeg
MAKAYVLY	magsaysay
MAKK	markku
MAKLAQLYN	malayan
MAK	mak
MAK	mak
MAK	mak
MAKRYJ	marytje
MAKSVL	makil
MAKSY	mackay
MAKSYM	mackay
MAKSYMYLYAN	marylynn
MAKV	markov
MAKVMBR	macomber
MAKVNVCY	mackinac
MAKVSY	markley
MAKY	macky
MAKYNVN	maryann
MAKYRAS	mayras
MAKYSAK	maysan
MAKZYM	markey
MALAMVD	malamud
MALAN	malan
MALBRG	malberg
MALD	malde
MALDN	malde
MALKVK	mallick
MALKVM	malcolm
MALN	malan
MALNR	malnar
MALRVNY	maroney
MALTYN	martyn
MALVN	mallin
MALVNY	maloney
MALYGAN	malayan
MALYK	malays
MAMA	mama
MAMFVRD	mumford
MAMN	maiman
MAMRT	mamet
MAMY	amy
MANAMA	manama
MANA	mana
MANA	mana
MANBR	manber
MANC	manca
MANDAL	mandal
MANDA	manda
MANDAR	mandar
MANDAVYL	mandaville
MANDL	mandl
MANDR	mandar
MANDY	mandy
MANGAN	mangan
MANGLANY	manglani
MANGR	manager
MANGYN	mangin
MANJYT	manjit
MANJYT	manjit
MANKA	lanka
MANK	mayank
MANKRT	munkert
MANKS	maniskas
MANKVS	maniskas
MANKY	many
MANLY	manley
MANMA	manama
MAN	man
MANRV	marv
MANSN	manson
MANSTR	mansur
MANSYL	many
MANSYNGR	munsinger
MANTA	manetta
MANTL	mantle
MANTNZ	mantegna
MANTRAS	diamantaras
MANTVR	mantor
MANTYKS	mandys
MANTY	mantey
MANVLY	manley
MANVLY	manley
MANV	mani
MANV	mani
MANV	mani
MANV	mani
MANVRY	manoury
MANX	manx
MANYJA	manija
MANYKS	meanys
MANY	many
MANY	many
MANYNG	manning
MANYSKAS	maniskas
MANYS	meanys
MANYT	many
MANYV	many
MANZ	lanz
MAPARTYDA	malpartida
MAPLZ	maple
MARALY	marley
MARANY	marani
MARAT	marat
MARAZAS	marazas
MARBAC	marbach
MARBL	marble
MARC	marc
MARCYNDV	maricondo
MARDR	marder
MARDVC	marc
MARFY	mary
MARGALTA	margarita
MARGALYTY	magsaysay
MARGANTH	marregante
MARGANT	marregante
MARGARTA	margarita
MARGARYTA	margarita
MARGARYTAY	margarita
MARGARYTJH	margarietje
MARGARYTJ	margarietje
MARGARYTJ	margarietje
MARGARYTJY	margarietje
MARGARYT	margaret
MARGARYT	margaret
MARGARYT	margaret
MARGARYTY	margarito
MARGLYN	marilyn
MARGRTA	margarita
MARGRYJH	margerys
MARGRYTA	margarita
MARGRYTH	margretha
MARGRYTH	margretha
MARGRYTJ	margrietje
MARGRYTJY	margrietje
MARGRYT	margerys
MARGRYTYH	margretha
MARGVLYN	marilyn
MARGVLYS	margolis
MARGVLYVKS	marilyns
MARJNT	martijntje
MARKHAM	markham
MARKLY	markley
MARK	mark
MARK	mark
MARKS	marks
MARKSN	marks
MARKSTYNR	marksteiner
MARKV	markov
MARKV	markov
MARKVM	markham
MARKVPVLY	markley
MARKVS	marks
MARKVS	marks
MARKVS	marks
MARKVYT	markley
MARKVYZA	markley
MARKVZ	markov
MARKYL	markey
MARKY	markey
MARKYNGTVN	tarkington
MARKYYVS	markey
MARLA	marla
MARLAT	marlatt
MARL	marla
MARLY	marley
MARLYN	marilyn
MAR	mar
MARN	marin
MARPL	marple
MARRL	marrs
MARSAL	marsala
MARSLA	marsala
MARSL	marsala
MARSLV	marsala
MARSLYNV	marilyn
MARS	mars
MARS	mars
MARSTVN	marston
MARSY	marty
MARTL	martel
MARTLND	martland
MARTN	marten
MARTNTJY	martyntje
MARTYJN	martyn
MARTYJN	martyn
MARTYJNTJH	martyntje
MARTYJNTJY	martyntje
MARTY	marty
MARTY	marty
MARTYNH	martyn
MARTYNJ	martyntje
MARTYNJ	martyntje
MARTYN	martyn
MARTYN	martyn
MARTYNSN	martinsen
MARTYNTH	martyntje
MARTYNTH	martyntje
MARTYNTJH	martyntje
MARTYNTJ	martyntje
MARTYNT	martyntje
MARTYNT	martyntje
MARTYNV	martyn
MARTYNVS	martyn
MARTYNZ	martyn
MARTYNZ	martyn
MARTYNZ	martyn
MARTYZN	martyn
MARTYZNTJ	martyntje
MARTZ	martz
MARVAHA	maratha
MARVCY	marcy
MARV	marv
MARVN	marvin
MARVN	marvin
MARVNY	maroney
MARVYN	marilyn
MARVYN	marilyn
MARVYT	marvit
MARXAM	marxism
MARYA	maryann
MARYANA	mariana
MARYAN	maryann
MARYGANTH	marregante
MARYGANT	marregante
MARYH	marsh
MARYJH	marytje
MARYJH	marytje
MARYJKN	marijken
MARYJ	marytje
MARYJNT	maryann
MARYKANDV	maryland
MARYKN	martyn
MARYLYN	marylynn
MARY	mary
MARY	mary
MARYN	martyn
MARYNV	martyn
MARYSH	marsh
MARYS	marys
MARYSVN	marys
MARYTH	maratha
MARYTH	maratha
MARYTJ	marytje
MARYTJ	marytje
MARYTJY	marytje
MARYTJY	marytje
MARYT	marytje
MARYT	marytje
MARYV	mary
MARYVS	marys
MARYYANY	marylynn
MARYZ	marys
MARZK	marek
MARZ	marz
MASAHYRV	masahiro
MASARA	masaru
MASATAKA	masataka
MASATV	masato
MASAYV	masaryk
MASBRG	malberg
MASKARY	masaryk
MASKL	maskell
MASK	masek
MASKYAS	matyas
MASLD	masud
MASLLY	malloy
MASNA	masna
MASNA	masna
MASRMN	masserman
MASTN	mastan
MASTYR	masters
MASVN	masin
MASYK	masaryk
MASY	massey
MASYMV	massimo
MASYN	martyn
MATAKV	matako
MATA	mata
MATANA	matana
MATAR	matar
MATAY	malay
MATJKA	matejka
MATLV	matlin
MAT	mat
MATSVDA	matsuda
MATSVMVTV	matsumoto
MATSVN	matson
MATVLA	matula
MATV	mat
MATVR	matar
MATVS	mats
MATYNV	martyn
MATYS	martys
MATYS	martys
MATYV	marty
MATYVS	matyas
MAVBAY	malay
MAVBY	mawby
MAV	marv
MAV	marv
MAV	marv
MAVN	marvin
MAVPYN	malayan
MAVR	mavers
MAVRS	mavers
MAVSR	mauser
MAX	max
MAYFYLD	mayfield
MAYKLYS	marleys
MAYKLZN	maryellen
MAYK	mayank
MAYKN	mayan
MAYKVHN	mayeen
MAYKVK	mayank
MAYLN	maryland
MAY	may
MAY	may
MAYMVN	mayan
MAYNDRT	marylander
MAYN	mayan
MAYN	mayan
MAYNR	maynard
MAYR	mayr
MAYR	mayr
MAYR	mayr
MAYR	mayr
MAYR	mayr
MAYRN	mayan
MAYRS	mayras
MAYRYK	masaryk
MAYRZ	mayra
MAYSAL	mayall
MAYSA	maysan
MAYSL	mays
MAYSTYK	mayston
MAYTAG	maytag
MAYTHAM	latham
MAYT	maytag
MAYT	maytag
MAYTY	marty
MAYVHAY	mahaly
MAYV	may
MAYZ	maya
MAZRA	mazera
MBARK	mubarak
MCLD	machteld
MCTLD	machteld
MDABA	madaba
MDAVR	kamdar
MDBA	madaba
MDH	madah
MDLYN	madelyn
MDNYK	mendyke
MDNYT	madinat
MDRK	medrek
MDRR	maderer
MDS	mds
MDSN	madsen
MDSVN	madsen
MDVNA	medina
MDYNA	dyna
MDYNH	madinah
MDYNH	madinah
MDYN	madelyn
MDYNNY	donny
MDYNT	madelyns
MDYSVN	dyson
MDYSVN	dyson
MFRG	marge
MFRK	mark
MFRVK	mark
MGDALNT	magdalena
MGDALYNTJ	magdaleentje
MGDALYYNTJH	magdaleentje
MGDA	magda
MGDAYNTJ	magdaleentje
MGLAGLYN	malayan
MGLAT	aoglat
MGNAN	magnan
MGNASN	magnan
MGNH	magesh
MGNY	many
MGR	mager
MGY	magyar
MGY	magyar
MGY	magyar
MGYNL	maginel
MGYS	magyars
MGYSY	magsaysay
MGYV	magyar
MHADVAN	mahadevan
MHAMA	muhamma
MHARAK	mubarak
MHL	mehl
MH	mah
MHMA	muhamma
MHRAH	mahrah
MHRA	mithra
MHRG	marge
MHRH	mahrah
MHRK	mehrkens
MHRM	harms
MHVYT	mahaly
MJDL	majdal
MJ	maj
MJYA	maya
MJYD	majid
MJYKAL	mayall
MJYK	mayank
MKAH	mekkah
MKALYR	mayr
MKA	mika
MKARDL	kardal
MKDALN	medan
MKDRMVT	kermit
MKDVLND	midland
MKDVNALD	macdonald
MKDVNALD	macdonald
MKDVYL	mady
MKFARLND	mcfarland
MKFARLYN	marilyn
MKFRLYN	marilyn
MKGAVYN	mcgavin
MKGRAT	mcgrath
MKGVVAN	meglan
MKGVYRK	magyars
MKGVYR	magyar
MKGYRY	margery
MKH	mekkah
MKH	mekkah
MKHNRY	mchenry
MKKAH	mekkah
MKKAN	mekkah
MKKARTY	karty
MKKARTY	karty
MKKAVN	moravan
MKKNA	mickna
MKKNY	keny
MKKNZY	mckenney
MKKRKN	morken
MKLAGLYN	katelyn
MKLAQLYN	katelyn
MKLARN	maclaren
MKLAVLYN	marilyn
MKLAVLYN	marilyn
MKLAVVGYNG	malayans
MKLYN	marilyn
MKLYN	marilyn
MK	mak
MK	mak
MKMAHAN	mcmahan
MKMAHVN	macmahon
MKMAHVN	macmahon
MK	mak
MKMANYS	tammanys
MKMVLN	melvin
MKMYLAN	mikoyan
MKNAT	mickna
MKNYL	many
MKNYL	many
MKRA	mara
MKRAYH	moray
MKRAY	moray
MKRDY	krey
MKRVN	mervin
MKRYS	marys
MKSFYLD	masefield
MKSN	masin
MKSYMV	moiseyev
MKTAVYS	koktavy
MKVC	makuch
MKVTV	makoto
MKVY	milky
MKVY	milky
MKYL	kyle
MKY	milky
'ML	amal
MLA	malta
MLANDR	melander
MLANY	many
MLAYYR	mayr
MLBAY	melby
MLCR	melcher
MLCYR	melcher
MLKA	melka
MLKVLM	micklem
MLKVM	micklem
MLMN	melman
MLN	emlen
MLR	malur
MLTH	malthus
MLV	melva
MLVN	melvin
MLVR	malur
MLYBV	emilys
MLYDY	melody
MLY	emily
MLYNGR	mellinger
MLYN	malayan
MLYNY	maloney
M'MA	mama
MMH	mah
MMTA	mamta
MNAMA	manama
MNAMH	minamo
MNARD	menard
MNDL	mandl
MNDL	mandl
MNDL	mandl
MNDR	mandar
MNDVZA	mendoza
MNDYBL	mandible
MNDYK	mendyke
MNDY	mandy
MNDZ	mendez
MNFVL	manfull
MNGAN	mangan
MNGH	singh
MNG	meng
MNGS	mangus
MNHART	menhardt
MNH	menth
MNJYVN	mayan
MNK	monk
MNKVSV	monks
MNKYVS	minskys
MNMA	manama
MNNYNG	manning
MNRV	minerva
MNSA	mansa
MNSN	manson
MNSTRYNA	menestrina
MNSVR	mansur
MNSVR	mansur
MNSVR	mansur
MNSVRY	minsky
MNTL	mantle
MNT	mont
MNTQH	mintaqah
MNTSR	mantor
MNTSYNN	mantsinen
MNTY	monty
MNTZR	mentzer
MNYJR	minyard
MNYKS	minsks
MNY	many
MNY	many
MNYNG	enying
MNYN	many
MNZR	mentzer
MNZS	menezes
MNZYZ	mandys
MPL	maple
MPL	maple
MQBRH	moqbara
MQRBY	moreby
MQSVD	maqsood
MRANDA	maranda
MRDYS	martys
MRDYT	mady
MRHAVS	marshas
MRJYNYV	martyn
MRKL	merkel
MRKLY	markley
MRKNT	morken
MRKR	mark
MRNDA	maranda
MRNY	many
M'RQ	mafraq
MRSR	mrs
MRSRYA	merry
MRSRYV	merry
MRTN	marten
MRTNZ	martinez
'MR	amir
MRVAH	marvas
MRVAN	moravan
MRYGAN	morgan
MRYJ	marytje
MRYK	masaryk
MRYKS	marys
MRYMAN	maryland
MRY	mary
MRY	mary
MRYMN	rymon
MRYNLY	marylynn
MRYS	marys
MRYT	marytje
MRZ	marz
MSALXY	malay
MSA	mesa
MSANDR	mesander
MSBARN	mashburn
MSKS	omsks
MSKYN	miskin
MSLYN	roslyn
MSMAN	mossman
MSR	misra
MSS	mass
MSTAN	mastan
MST	mast
MST	mast
MSTRZ	mistry
MS'VD	masada
MSYF	mayfair
MSYNA	myrna
MSYNGR	messinger
MSYN	mayan
MSYVS	moiseyevs
MTANA	matana
MTLYN	martyn
MT	mt
MT	mt
MTNA	matana
MTNA	matana
MTRNC	metternich
MTRNYC	ternyck
MTRV	marv
MTRYNC	martyn
MTSGR	metzger
MTSVMVTV	matsumoto
MTSVN	matson
MTVR	matar
MTYN	martyn
MTYN	martyn
MTYV	marty
MTYV	marty
MTYV	marty
MTYVS	matyas
MTYVS	matyas
MTYVSVN	maysan
MTYVZ	matyas
MTZGR	metzger
MTZYNG	metzing
MVALR	malur
MVANZR	malnar
MVBAY	bombay
MVBLY	mobley
MVDGYL	moudgill
MVD	md
MVDY	mady
MVDY	mady
MVFAD	milad
MVGANTY	moganti
MVHAMA	muhamma
MVHAN	mohan
MVHR	mohar
MVKASA	mukasa
MVK	mok
MVKRYJ	marytje
MVLANDR	molander
MVLDN	velden
MVLK	milks
MVL	mill
MVLN	milan
MVLR	millar
MVLR	millar
MVLVY	molly
MVLYGAN	milligan
MVLY	emily
MVLYNARY	maynard
MVMFVRD	mumford
MV	marv
MVNAGAN	monagan
MVNAK	minarik
MVNAKV	mintaka
MVNAZ	mintz
MVNDFRANS	mondfrans
MVNDVR	mondor
MVNKAR	menkar
MVNK	monk
MVNKS	monks
MVNKZ	mintz
MVN	min
MVN	min
MVNRV	minerva
MVNS	mins
MVNTAG	montag
MVNTAGV	montag
MVNTALBANV	montalbano
MVNTA	monta
MVNTANARV	montanaro
MVNTANV	montano
MVNTGMRY	montgomery
MVNTGVMRY	montgomery
MVNT	mont
MVNTRAL	montreal
MVNTRV	minter
MVNTVYA	montoya
MVNTYJV	montys
MVNVLYT	manleys
MVNYZ	mintz
MVNZLR	muenzler
MVRABYTV	morabito
MVRAD	murad
MVRAL	murali
MVRALS	morales
MVRALT	muralt
MVRA	mira
MVRANDV	miranda
MVRAN	moran
MVRANV	marani
MVRAS	miras
MVRAVAN	moravan
MVRAY	moray
MVRAYNS	mayans
MVRC	marc
MVRDAC	mirach
MVRDAK	marduk
MVRFY	mury
MVRHAVS	marshas
MVRHAVS	marshas
MVRKL	morkel
MVRKN	morken
MVRLAN	morlan
MVRL	morel
MVRL	morel
MVRL	morel
MVRLYJ	marleys
MVRLY	morley
MVRMAN	moorman
MVR	mir
MVRNYNG	morning
MVRS	mavers
MVRS	mavers
MVRS	mavers
MVRSTAD	maurstad
MVRTAN	martian
MVRTN	marten
MVRTVN	martin
MVRTYMR	mortimer
MVRTYMR	mortimer
MVRTY	marty
MVRTYMVR	mortimer
MVRV	marv
MVRVNY	moroney
MVRVYL	marvell
MVRYL	mury
MVRY	mury
MVRY	mury
MVRYN	martyn
MVRYSN	mauryan
MVRYSVN	bryson
MVRYSVN	bryson
MVRYTA	morita
MVSAL	missal
MVSANA	mana
MVSFYS	missys
MVSLA	musella
MVSMN	mossman
MVS	mavis
MVSVN	masin
MVSVY	missy
MVSYG	missys
MVSY	missy
MVSYR	mayr
MVSYVN	sylvan
MVSZ	maviss
MVTA	malta
MVTANA	matana
MVT	marvit
MVTVR	motor
MVTVRZ	marz
MVTYSV	mistys
MVVR	mavers
MVYL	mylar
MVY	ivy
MVYNYHAN	moynihan
MVYNZ	mayne
MVYR	mayr
MVYSAN	maysan
MVYS	mays
MVYSS	mysts
MVYSVN	maysan
MVYZ	allyz
MVYZVN	mayan
MVZYNA	mozina
MVZZ	mize
MYAV	maya
MYAYNDRT	marylander
MYCALYS	carlys
MYCA	mycenae
MYCAN	mycenaean
MYCAYLYS	carlys
MYCL	lyrical
MYCLTJN	micheltjen
MYCLTN	mycenae
MYCLTYN	jaclyn
MYCLYS	macys
MYCN	mycenae
MYDLBRV	middlebro
MYDLTN	middleton
MYDLTVN	middleton
MYD	myrdal
MYDR	myer
MYDY	mady
MYGN	mayan
MYGNRAN	magnan
MYGNRY	mignerey
MYGR	myer
MYGR	myer
MYGVYL	bryguy
MYHALYK	mahaly
MYHAN	moynihan
MYJR	myer
MYJRY	marjory
MYKAK	mayank
MYKALK	myrdals
MYKA	myra
MYKAS	myras
MYKAYL	mayall
MYKAYYL	mayall
MYKAYYLYZ	marylynn
MYKAYYLZ	kayla
MYKK	mikki
MYKLACLN	maclachlan
MYKLJN	lamykin
MYKLM	micklem
MYKLSN	mikkelsen
MYKLSVN	mickelson
MYK	kalmyk
MYKNA	myrna
MYKR	myer
MYKS	myers
MYKS	myers
MYKS	myers
MYKT	myst
MYKVK	myrick
MYKVLYK	smyley
MYKV	lamykin
MYKYNG	mekong
MYKYNZ	marylynn
MYKZ	myra
MYLAD	maryland
MYLAM	mylar
MYLAM	mylar
MYLAN	maryland
MYLARA	mylars
MYLARD	mylars
MYLAR	mylar
MYLASYS	malays
MYLBRT	milbert
MYLDRD	mildred
MYLGRAM	milgram
MYLKS	myles
MYLKV	myles
MYLKY	milky
MYLMAN	melman
MYLMAN	melman
MYLMV	mylar
MYLN	maryland
MYLNR	mylar
MYLNVR	mylar
MYLNYVM	smyley
MYLR	mylar
MYLSTVN	mayston
MYLT	myst
MYLT	myst
MYLTN	multan
MYLVARD	millard
MYLV	mayall
MYLVS	myles
MYLVT	myst
MYLYANZ	malayans
MYLYGAN	malayan
MYLYKN	marylynn
MYLY	smyley
MYLY	smyley
MYLY	smyley
MYLYND	marylynn
MY	amy
MYMAS	myanmars
MY	amy
MY	amy
MYMY	smyley
MYNA	myrna
MYNA	myrna
MYNAMV	minamo
MYNARD	maynard
MYNARD	maynard
MYNARYK	masaryk
MYNDRT	meindert
MYNGV	tyng
MYNKY	minsky
MYN	mayan
MYN	mayan
MYN	mayan
MYN	mayan
MYN	mayan
MYNRAL	mineral
MYNR	maynard
MYNRVA	minerva
MYNRZ	maynard
MYNSR	maynard
MYNSTRL	minstrel
MYNSY	minsky
MYNTAKAH	mintaqah
MYNTAKVA	mintaka
MYNTKA	mintaka
MYNT	myst
MYNTR	minter
MYNTVN	minton
MYNTZ	mintz
MYNVARYNG	mainwaring
MYNYARD	minyard
MYNY	many
MYNZ	myrna
MYNZ	myrna
MYPL	maple
MYRA	myra
MYRA	myra
MYRANKR	miranker
MYRFLD	mayerfeld
MYR	emyr
MYRMAK	mirmak
MYR	emyr
MYR	emyr
MYR	emyr
MYRS	myers
MYRSY	myers
MYRTY	marty
MYRVA	myra
MYRVL	myrtle
MYRVT	myrtle
MYRYDYT	myrdal
MYRZ	myra
MYRZ	myra
MYRZ	myra
MYSA	maysan
MYSA	maysan
MYSAN	maysan
MYSAT	myst
MYSLAV	mylar
MYSL	myst
MYSL	myst
MYSM	myst
MYSN	maysan
MYSRA	myra
MYSTRY	mistry
MYSTYK	mistys
MYSVNR	maysan
MYSYK	masaryk
MYTAL	myrdal
MYTAVA	amitava
MYTCL	mystic
MYTCM	mystic
MYTNYK	mayank
MYTRVVYK	masaryk
MYTSL	mysts
MYTV	myst
MYTV	myst
MYTVN	mayston
MYTVNN	maryann
MYV	amy
MYVS	myles
MYVSN	maysan
MYVVZ	mylar
MYVZ	mylar
MYVZR	mylar
MYYH	myth
MYYR	mayr
MYYRS	myers
MYZ	amys
MYZ	amys
MYZVN	myron
MYZYRA	mayra
MZDH	mazdeh
MZYK	mayank
MZYVN	mayan
NAB	nabil
NABL	nabil
NABYL	nabil
NADAN	nevadan
NADANSVN	nathanson
NADVLNY	nadolny
NADYG	nadig
NAF	knaff
NAF	knaff
NAF	knaff
NAFZA	nafeeza
NAGASAKY	nagasaki
NAGASYVA	nagasiva
NAGNT	nugent
NAGY	nagy
NAHAM	ingraham
NAJR	nair
NAJYAH	najiyah
NAJYA	najya
NAKAGAKY	nakagaki
NAKAMVRA	nakamura
NAKASVRA	nakasora
NAKASYMA	nakashima
NAK	snake
NAKSVN	anakin
NAKVYYN	jacklyn
NAL	neal
NALYK	kalmyk
NAM	nam
NANDVANY	nandwani
NANLY	nunley
NAN	nan
NANS	nans
NANSY	nans
NANTVN	naunton
NAP	knapp
NAP	knapp
NAPTVN	napton
NAPVLYTANV	napolitano
NARAD	narad
NARDN	nardone
NARDV	nardi
NARDY	nardi
NARLA	narla
NARSAVAG	narsavage
NARV	narla
NASAV	narsavage
NAS	nas
NAS	nas
NATAN	nathan
NAT	nat
NATSN	nats
NAVAR	navarre
NAVARV	navarro
NAVAS	navas
NAV	nave
NAV	nave
NAVYA	najya
NAVYLV	naylor
NAYA	nayar
NAYDV	ayda
NAYFH	nayfeh
NAYFLR	naylor
NAYKRBYKR	ayckbourn
NAYKS	nyikos
NAYKS	nyikos
NAYKVLAS	niklas
NAYLR	naylor
NAYLZ	naylor
NAYMAH	naimah
NAYRMN	jayaraman
NAYT	anay
NAYT	anay
NAZAHA	nazahah
NAZARYTYAN	nazaretian
NAZARYV	nazario
NBATAY	nabatiye
NBATYH	nabatiye
NBATY	nabatiye
NBL	nabil
'NBR	anbar
NBRS	nebres
NDA	nida
NDKARNY	nadkarni
NDN	neden
NDVD	nedved
NDYN	andys
NFAN	enfant
NFDV	nid
NFJAN	neefjan
NFL	knefel
NFYSA	nyasa
NFYZA	nafeeza
NFZA	nafeeza
NGTYV	nagy
NGY	nagy
NHAVS	navas
NHNH	nahnah
NJAF	najaf
NJF	najaf
NJVA	neva
NJYAH	najiyah
NJYA	najya
NJYH	najiyah
NKLAS	niklas
NKLS	niklas
NKNZ	niknaz
NKV	nev
NKV	nev
NL	anil
NLKYN	nelkin
NLS	nils
NLSN	nelsen
NLT	nat
NMAZY	namazi
NPAN	pan
NP	np
NPL	nepal
NPR	napier
NPTVN	napton
NPVRA	napora
NRAD	narad
NRDNFLT	nordenfelt
NRS	nairs
NRTRVP	northrop
NRVP	norup
NRY	nery
NRY	nery
NSLY	ansley
NSNAL	snail
NSVA	neva
NSVM	anselm
NSYDA	nashida
NSYHA	nasiha
NSYH	nayfeh
NSYRA	syria
NTAKR	nethacker
NTRTVN	norton
NTYFA	nathifa
NTYHA	anthea
NVALA	narla
NVAR	invar
NVAYL	naylor
NVAZ	nazi
NVBL	nobel
NVBL	nobel
NVDA	nevada
NVDYNG	nuding
NVF	enif
NVGNT	nugent
NVJANS	nevejans
NVJANZ	nevejans
NVJNANS	nevejans
NVJNS	nevejans
NVJNT	nevejans
NVKS	nevskys
NVKV	niki
NVLAN	nolan
NVLD	nolde
NVLF	nolf
NVL	nevel
NVL	nevel
NVNYS	ninoys
NVP	np
NVRA	nora
NVRBAY	norby
NVRDA	nevada
NVRDBAY	nordby
NVRDBVRG	nordborg
NVRDDRAP	noorddorp
NVRDNSTVRM	nordenstrom
NVRDRAP	narendra
NVRDRVPH	randolph
NVRDT	nordt
NVRDVRP	noorddorp
NVRDVRP	noorddorp
NVRHA	norha
NVRKAT	barakat
NVRN	noren
NVRSRAP	northrop
NVRSVRP	northorpe
NVRTKAT	northeast
NVRTVRPH	northorpe
NVRTVRP	northorpe
NVRVVD	nirad
NVRY	convery
NVSAK	nosack
NVSL	novosel
NVT	nat
NVTZN	knutzen
NVTZ	notz
NVVALA	narla
NVVRDDRP	noorddorp
NVVSL	novosel
NVVYK	novik
NVYA	noya
NVYFL	nyffeler
NVYJANZ	nevejans
NVYK	novik
NVYL	noyles
NVYL	noyles
NVYLS	noyles
NVYNGTVN	symington
NVYS	nevskys
NVZ	neva
NYBY	nibby
NYCVLAS	niclas
NYCVLS	niclas
NYDAL	nidal
NYDA	ayda
NYDH	nayfeh
NYDLZ	snyder
NYD	snyder
NYFJAN	neefjan
NYFYN	nyman
NYGLY	langley
NYG	enying
NYGRA	nigra
NYGT	enyart
NYHALANY	nihalani
NYKALAS	niklas
NYKLAS	niklas
NYKLAS	niklas
NYKLAS	niklas
NYKLAS	niklas
NYKL	nyikos
NYKL	nyikos
NYKL	nyikos
NYKL	nyikos
NYKLS	nyikos
NYKLS	nyikos
NYKLS	nyikos
NYKLS	nyikos
NYKLSN	nickelsen
NYKLSN	nickelsen
NYKLSVN	nickelsen
NYKLV	nyikos
NYKLZ	nyikos
NYKLZ	nyikos
NYK	nye
NYK	nye
NYK	nye
NYKRBAKR	knickerbacker
NYKRBKR	knickerbacker
NYKRBYKR	knickerbocker
NYKRSVN	nickerson
NYKS	nyikos
NYKSVN	enoksson
NYKVLA	nukala
NYKVLAS	niklas
NYKVLAS	niklas
NYKVLAS	niklas
NYKVLAS	niklas
NYKVL	nyikos
NYKVLSAN	nyman
NYKVLS	nyikos
NYKVLS	nyikos
NYKVLS	nyikos
NYKVLSVN	nevison
NYKVLYK	nikolay
NYKVLY	nikolay
NYKVLY	nikolay
NYKVLZ	nyikos
NYKVLZ	nyikos
NYKV	nyikos
NYKY	nevsky
NYKY	nevsky
NYKY	nevsky
NYKY	nevsky
NYLBRY	allbery
NYLJH	lylah
NYLMG	enying
NYLND	niland
NYL	naylor
NYL	naylor
NYLS	noyles
NYLS	noyles
NYLS	noyles
NYLS	noyles
NYLTH	nuth
NYLTJH	heyltje
NYLTJ	heyltje
NYLTJY	heyltje
NYLZ	naylor
NYMAH	nyman
NYMA	nyman
N'YMH	nayfeh
NYMH	nayfeh
NYMRAD	nyman
NYMTZ	nimtz
NYMY	nyman
NYNDK	ninedek
NYNJA	ninja
NYN	nyman
NYN	nyman
NYNS	noyens
NYNSTAR	ninstar
NYNV	nyman
NYNVYS	ninoys
NYPAN	nyman
NYPNBRG	knippenberg
NYPTVN	napton
NYR	nayar
NYR	nayar
NYS	nyasa
NYS	nyasa
NYSN	nyman
NYSPL	knispel
NYSYLDA	gnishilda
NYTYN	nyman
NYVAN	nyman
NYVARK	enyart
NYVAYNGTN	yangon
NYVAYNGTVN	symington
NYVBAY	nabatiye
NYVBRY	nyberg
NYVBRY	nyberg
NYVKVLAS	niklas
NYVKVYST	nevskys
NYVLND	niland
NYVMAN	nyman
NYVMAN	nyman
NYVMN	nyman
NYVMYR	november
NYVSAM	nyasa
NYVTN	nyman
NYVVYNGTVN	symington
NYVYSVN	nevison
NYVYYNGTVN	symington
NYYVKAMB	kamb
NYYVTN	nyman
'NYZH	nayfeh
NZAHAH	nazahah
NZAHA	nazahah
NZAHH	nazahah
NZYRAH	nazirah
NZYRA	nazirah
NZYRH	nazirah
PABLT	pablo
PABLV	pablo
PACVLKH	pacholke
PACYANV	pachiano
PADVA	padua
PADVLA	padilla
PADYAL	padial
PADYLA	padula
PAGLAYS	paglias
PAGLYA	paglia
PAGLYS	paglias
PAGLYYARV	pagliaro
PAGT	pagett
PAJT	patt
PAKALA	pakala
PAKARD	packard
PAKNAS	pakenas
PAKS	paks
PAKS	paks
PAKT	paks
PAKVAT	pakala
PALAGY	palagyi
PALAK	pallack
PALFVRD	pulford
PALMRT	palmert
PAL	pal
PAL	pal
PALRMV	palermo
PALSKY	polsky
PALSN	paulsen
PALSYFR	palmyra
PALTJH	paultje
PALTJ	paultje
PALTJY	paultje
PALVMBV	palumbo
PALYDV	paley
PALY	paley
PALY	paley
PALY	paley
PALYS	palmyras
PAMFRY	pumfrey
PAM	pam
PANAGS	panagos
PANAS	panas
PANC	panici
PANDA	panda
PANDR	pandora
PANDVLFYNV	pandolfino
PANDYAN	pandya
PANDYT	pandya
PANDZ	panda
PANFYL	panfil
PANGBVRN	pangborn
PANJABY	punjabi
PANKRAS	pandoras
PANKRS	pankhurst
PANN	panon
PAN	pan
PANT	pant
PANVALKR	panvalkar
PANVN	panon
PANYKV	pansys
PANYSY	pansy
PAPALARDV	pappalardo
PAPAY	papay
PAPLASKAS	paplaskas
PAPLTVN	appleton
PAPLY	papay
PAPN	pape
PAP	pape
PAP	pape
PAPVYK	papay
PAQ	pak
PARA	parra
PARAT	parratt
PARAYL	parayil
PARDN	pardon
PARDYNGTN	pardington
PARDYNGTVN	pardington
PARDY	pardi
PARDZ	pardi
PARHAM	parham
PARK	park
PARKYN	parkyn
PARKZ	parks
PARMAR	parmar
PARNS	parnass
PARSANZ	parisians
PARSL	parsi
PARSN	parson
PARSVNS	parsons
PARSVNZ	parsons
PARTVN	parton
PARTVS	partos
PARTY	parry
PARYNGTVN	partington
PARY	parry
PARYS	paris
PASKAL	pakala
PASKV	pasko
PASKV	pasko
PAS	pas
PASTRNAK	pasternak
PASTVR	pasteur
PASYFYK	patsys
PASYR	patsy
PATN	patna
PATR	patkar
PATRSVN	paterson
PATRSVN	paterson
PATRVKLVS	patricks
PATRYK	patrik
PATRYK	patrik
PATRYK	patrik
PATRYS	patsys
PATRYSYA	patsys
PATRYZYV	patrizio
PATS	pates
PATTA	patetta
PATVCY	patsy
PATVKSNT	patuxent
PATYL	pathyil
PAVL	pavol
PAVLSN	paulsen
PAVLS	pavlovs
PAVLTH	plath
PAVLT	pavlik
PAVLYK	pavlik
PAV	pal
PAVV	pavlov
PAYJ	payne
PAYK	paik
PAYNH	payne
PAYN	payne
PAYNTVN	paynton
PAYNY	payne
PAY	paley
PAYPR	paypal
PAYRAMYD	pyramid
PAYTH	plath
PAYTJ	payton
PAYTR	paynter
PAYTR	paynter
PAYTVN	payton
PAYVLSVN	pavlovian
PAYVLTJ	paultje
PAYVTH	plath
PD	pd
PDRAM	pedram
PDRSN	pedersen
PDRSVN	pedersen
PDY	preedy
PG	peg
PGRAM	pegram
PGT	puget
PK	pak
PKR	parker
PKYNGZ	pekings
PLAK	plack
PLAMN	plamen
PLAMR	plamen
PLANK	planck
PLAN	plaine
PLANT	plante
PLASTYNV	plastino
PLATFVRM	platform
PLAT	plat
PLAT	plat
PLATYV	palagyi
PLAYR	layer
PLC	plack
PLHAM	pelham
PLKCYA	percy
PLKY	polsky
PLNKNR	plinskin
PLNTH	plath
PLTAYR	pataky
PLTCR	pletcher
PLTFRM	platform
PLTKVS	platkus
PLTNN	peltonen
PLT	pelt
PLT	pelt
PLTYV	poltava
PLTYYR	plyler
PLVHN	ploehn
PLVMR	palmer
PLYGRYNY	pelligrini
PLYNSKYN	plinskin
PLYSKYN	pliskin
PLYT	playtex
PLYV	plyler
PNBAKR	pennebaker
PNDLTN	pendleton
PNDLTVN	pendleton
PNDYA	pandya
PNGADV	pengadu
PNG	pang
PNKRAS	ankaras
PNL	panfil
PN	pan
PNS	pans
PNTVN	panton
PNYMAN	nyman
PNYNSVLA	peninsula
PNYNZVLA	peninsula
PNY	pansy
PPH	sappho
PPLR	peppler
PPYN	pepys
PRABST	pabst
PRACT	paraclete
PRADV	prado
PRAGV	sprag
PRAHL	prahl
PRAKTYKVM	praktikum
PRAL	prael
PRALT	perrault
PRAM	pram
PRAMVD	pramod
PRANAV	pranav
PRANGS	prongs
PRANK	pranke
PRAPYS	pepys
PRASAD	prasad
PRASANA	prasana
PRASANT	prashant
PRASN	prasen
PRAS	praias
PRATP	pratap
PRAT	pratt
PRATS	prates
PRATVL	pratul
PRATYK	prateek
PRATYKS	pratiksh
PRATYKV	prateek
PRAVL	pravil
PRAVYN	praveen
PRAYB	parayil
PRAYL	parayil
PRAYM	pram
PRAYVN	praveen
PRAYVYT	rayya
PRBN	preben
PRC	price
PRDYKARV	puryear
PRDYKYS	perdikis
PRDYS	prados
PRKAS	pereckas
PRKS	parks
PRKYNS	parkyn
PRKYNZ	parkyn
PRLMAN	perlman
PRLMN	perlman
PRL	perl
PRLR	perler
PRLY	perley
PRMAL	premal
PRNT	parent
PRNTYS	trinitys
PRPK	perpk
PRSATTAM	purshottam
PRSKAT	prashant
PRSL	parsi
PRSLT	priest
PRSTN	preston
PRSTRVD	prestrud
PRSTRV	prestero
PRSTVN	preston
PRSVN	parson
PRSYNV	parkyn
PRSYVAL	parsifal
PRVAMR	priam
PRVAN	provan
PRVGTV	private
PRVJT	projet
PRVMVNTVRY	promontory
PRVN	parvin
PRVPS	propes
PRVS	purvis
PRVTRV	petrov
PRVTVS	protus
PRVV	pravil
PRVVST	prevost
PRVYN	parkyn
PRVY	pruy
PRVYS	priya
PRYA	priya
PRYAVLT	pravil
PRYBL	parayil
PRYCARD	pritchard
PRYDY	preedy
PRYKLY	prickly
PRYKN	parkyn
PRYKT	prakrit
PRYLV	parayil
PRYMRV	pryor
PRYMV	pym
PRYMYVS	pygmys
PRYNG	prong
PRYN	parkyn
PRYNS	paynes
PRYNSS	prensas
PRYNT	bryant
PRYNY	bryony
PRY	pery
PRYSKAT	prashant
PRYSLR	preisler
PRYSTLY	priestly
PRYSTLY	priestly
PRYST	priest
PRYSTVN	preston
PRYSYLA	priya
PRYSYNG	rysling
PRYTCARD	pritchard
PRYTY	pretty
PRYTY	pretty
PRYTZ	pritz
PRYVR	pryor
PRYVS	pryors
PRYVST	provost
PRYYVTY	pretty
PRZ	perez
PSKYN	parkyn
PSNKV	plunk
PS	ps
PSTMA	postma
PST	post
PTCR	petcher
PTKR	patkar
PTLA	patella
PTRN	petren
PTR	peter
PTRSN	petersen
PTRSN	petersen
PTRSVN	paterson
PTRSVN	paterson
PTRVF	petrov
PTRVNLA	petronella
PTRV	petrov
PTRVV	petrov
PTRVYC	patric
PTRYC	patric
PTRYK	petry
PTRY	petry
PTRZ	perez
PTSY	patsy
PTV	pt
PTYBN	paysan
PTYBVN	payton
PTYL	pathyil
PTYNS	paynes
PTY	patsy
PTY	patsy
PTY	patsy
PTYTJYN	petitjean
PTZVLD	petzold
PVALMA	palmyra
PVA	pa
PVGA	puga
PVGLYS	pigmys
PVG	peg
PVGVSYAN	pogosyan
PVHAN	puhan
PVHAR	pohar
PVHL	pohl
PVH	poh
PVKVRNY	pokorny
PVLAKVS	platkus
PVLGAR	pulgar
PVLK	pavlik
PVLMYTYS	almatys
PVLND	poland
PVLN	polen
PVLN	polen
PVLNT	pellant
PVL	pavol
PVL	pavol
PVLSN	polson
PVLS	pavlovs
PVLS	pavlovs
PVLTR	psalter
PVLV	pavlov
PVLVVYN	pavlovian
PVLYNG	poling
PVLYPALY	paypal
PVLY	polly
PVLYS	pollys
PVLYT	playtex
PVLYYAM	polyhymnia
PVLZ	pavlik
PVMA	puma
PVMFRY	pumfrey
PVNA	pina
PVNT	pant
PVNVZ	panza
PVPAT	popat
PV	pl
PVP	epp
PVP	epp
PVRAHV	prahl
PVRANYK	puranik
PVRJZ	piroz
PVRKV	park
PVR	pier
PVRTNVY	portnoy
PVRTRFYLD	porterfield
PVRVS	purvis
PVRYNTVN	paynton
PVRYR	pryor
PVSALA	poosala
PVSARY	peary
PVSN	posen
PVS	ps
PVSTYL	pathyil
PVSV	pavlov
PVSY	pusey
PVTKVNN	putkonen
PVT	pt
PVTRY	petry
PVTYT	pitt
PVTYT	pitt
PVTZ	putz
PVVLZ	volz
PVV	pavlov
PVYNT	paynter
PVYNTYNG	poynting
PVYRYR	pryor
PVYSL	pyle
PVYV	pavlov
PVZYVS	pavlovs
PYAK	pak
PYATJY	patsy
PYATK	piatek
PYBADY	peabody
PYDH	piyush
PYD	pd
PYD	pd
PYJH	piyush
PYJT	pyotr
PYKAP	pickap
PYKARD	pickard
PYKASV	pythias
PYKL	psyko
PYK	psyko
PYK	psyko
PYK	psyko
PYK	psyko
PYKRL	pyers
PYKS	pyers
PYKVLBNY	pokorny
PYKZ	psyko
PYLAR	mylar
PYLARZ	mylars
PYLATV	pilato
PYLAZV	pyle
PYL	pyle
PYL	pyle
PYLVSKY	polsky
PYLVYV	polly
PYLY	pygmy
PYLYSNRY	pillsbury
PYNAKL	spinak
PYNA	pina
PYNCAZ	pancras
PYNCRA	pancras
PYNDAR	pindar
PYNDV	payne
PYNGNVT	pingenot
PYNG	tyng
PYNKVVYTZ	pinkowitz
PYNKY	pinky
PYN	payne
PYN	payne
PYN	payne
PYNSN	paynton
PYNSVN	paynton
PYNTH	paynter
PYNTN	paynton
PYNTR	paynter
PYNTR	paynter
PYNTR	paynter
PYNTVN	paynton
PYNTVN	paynton
PYNV	payne
PYNV	payne
PYNXAM	putnam
PYNYAN	pinyan
PYNY	pliny
PYNZ	payne
PYPGRAS	pipgras
PYP	pype
PYP	pype
PYPR	pype
PYPVNY	epiphany
PYRAMYD	pyramid
PYRAN	piran
PYRANY	pirani
PYRARD	pirard
PYRAVAT	pravdas
PYRKV	pyrex
PYRLMAN	perlman
PYRL	pyle
PYRMN	pyramid
PYR	pyers
PYRSN	pyers
PYRSN	pyers
PYRSN	pyers
PYRS	pyers
PYRS	pyers
PYRSVN	parson
PYRT	pyers
PYRV	pyrex
PYRVZ	piroz
PYRY	pery
PYRYR	pryor
PYRYZ	piroz
PYRZ	pyers
PYSAH	peasah
PYSAN	paysan
PYSH	piyush
PYSLY	paisley
PYSNS	paynes
PYS	pyers
PYS	pyers
PYS	pyers
PYSTVN	paysan
PYTAN	paysan
PYTA	pythias
PYTH	python
PYTJ	pyotr
PYTKV	psyko
PYTMN	payton
PYT	pyotr
PYT	pyotr
PYT	pyotr
PYT	pyotr
PYTR	pyotr
PYTR	pyotr
PYTR	pyotr
PYTRSVN	pyotrs
PYTRV	pyotr
PYTRZ	pyotrs
PYTS	pyotrs
PYTYBVN	python
PYVMLY	pygmy
PYVN	payne
PYVNYK	pivnick
PYV	pyle
PYVRYNTN	paynton
PYVTR	pyotr
PYYK	psyko
PYYRY	parry
PYYV	pygmy
PYZA	pizza
PYZLY	pygmy
PYZS	pyles
PYZVLYTV	pavlov
PYZYALY	piziali
PYZYNY	pliny
PYZY	pygmy
PYZYR	pyziur
PZARAYS	paraguays
QADSYH	qadisiyah
QALYA	alya
QASAN	hasan
QASM	qasim
QAYD	ayda
QAYS	mays
QBYLH	qubilah
QDAMH	qudamah
QDYLA	dylan
QDYL	daryl
QDYM	edam
QDYRA	qadira
QDYR	dayr
QDYSH	qadisiyah
QDYSYHA	qadisiyah
QLYA	elya
QLYBA	elya
QLYB	klyber
QLYLA	layla
QML	aqil
QMR	qamar
QNTVN	quentin
QRBYA	surabaya
QRYBYH	rubys
QSAN	san
QSN	qun
QSYM	syme
QSYM	syme
QTRAN	quatrain
QVASYM	qasim
QVBYLH	qubilah
'QYLA	aqila
'QYLA	aqila
'QYL	aqil
'QYL	aqil
QYT	kyte
QYVN	sylvan
RABKYN	rabkin
RABLD	rabold
RABL	rabel
RABNAV	rabenau
RABN	raben
RABN	raben
RAB	arab
RABRT	rabat
RABRTSN	robertson
RABRTSVN	robertson
RAB	arab
RABTM	rabat
RABVYL	raby
RABYDYAKS	rayya
RABY'H	rabiah
RABYJN	abyan
RABYN	robyn
RABYN	robyn
RABYNSN	robyns
RABYNSVN	robyns
RABY	raby
RABY	raby
RABYV	raby
RACL	oracle
RAC	traci
RADAK	radek
RADBRG	rodberg
RADBVD	radboud
RADBVN	radbone
RADHA	radha
RADHYKA	radhika
RADKLYF	bradely
RADK	radek
RADMN	rodman
RADNBRC	radenburch
RADNBRGARBRVK	radenburgerabroek
RADNBRGRABRK	radenburgerabroek
RADNBRGRABRVK	radenburgerabroek
RADNBRGRBRVK	radenburgerabroek
RADNYK	rodney
RAD	rad
RADRAMVNY	rudramuni
RADRFRD	bradford
RADR	rader
RADR	rader
RADT	brandt
RADVA	radev
RADVF	radev
RADVLFS	adolfs
RADVLFVS	adolfs
RADV	radev
RADVYG	radig
RADYAH	radeyah
RADYH	radeyah
RADYNG	radig
RADY	grady
RAFALKV	rafalko
RAFAL	rafal
RAFALSKY	rafalski
RAFA	rafa
RAFAYL	rafal
RAFAYLY	rafaeli
RAFNR	rainer
RAF	rafa
RAFRTY	rafferty
RAFYKYV	rayya
RAFYL	rafal
RAFYN	raffin
RAFY	raby
RAGATZ	ragatz
RAGLND	ragland
RAGL	ragle
RAGNAR	ragnar
RAGNARSVN	ragnarsson
RAGNRD	fragonard
RAGNVALD	ragnvald
RAGRV	prager
RAGSDYL	ragsdale
RAHARJV	rahardjo
RAHBK	radhika
RAHRR	rohrer
RAHRYG	kathryn
RAHVL	rahul
RAHY	sarathy
RAJCR	rajcher
RAJNDR	rajender
RAJN	trajan
RAJ	raj
RAJR	raj
RAJRZ	ramirez
RAJS	rajas
RAJV	rajeev
RAJYV	rajeev
RAKAH	barakah
RAKL	akl
RAKL	akl
RAK	drake
RAKVN	raskin
RAKV	radev
RAKYKVT	prakrit
RALF	ralf
RALF	ralf
RALF	ralf
RAMA	rama
RAMBL	rambo
RAMBV	rambo
RAMPLZ	rampling
RAM	ram
RAM	ram
RAMR	ramer
RAMS	ramas
RAMSY	ramsay
RAMSYR	ramsay
RAMTAN	ramani
RAMVLVS	hamills
RAMVS	ramos
RAMY	reamy
RAMYRV	ramiro
RAMZ	ramez
RANA	rana
RANDL	randal
RANDR	rander
RANGL	wrangell
RANKYN	rankin
RANN	erann
RAN	eran
RAN	eran
RAN	eran
RANR	rainer
RANTGN	rontgen
RANY	randy
RANY	randy
RANY	randy
RANYV	randy
RAPBRYK	ropebrake
RAP	trapp
RAPR	draper
RARK	ark
RASA	rasha
RASCN	racine
RASDAL	ragsdale
RASD	prasad
RASFVRD	ashford
RASKH	rasha
RASK	raskin
RASKYN	raskin
RASL	rasul
RASL	rasul
RASMN	rastin
RASNDAL	randal
RASNDYL	randy
RASNMAN	rosenman
RASPYNY	rasputin
RAS	ras
RAS	ras
RAS	ras
RAS	ras
RASTN	rastin
RASTRAM	tristram
RAST	rastin
RASTYN	rastin
RASTY	raisty
RASVM	asim
RASV	ras
RASV	ras
RASV	ras
RASYD	rashed
RATCSVN	ratcheson
RATGRT	rutgert
RATJRT	rajat
RATKS	rutks
RATMN	dratman
RATRA	rattray
RAT	rat
RATRFVRD	rutherford
RAT	rat
RATSTRVM	ruthstrom
RAVBATM	rabat
RAVDAH	raidah
RAVDA	pravda
RAVDA	pravda
RAVLND	ragland
RAVLT	travolta
RAVNR	rainer
RAV	ravi
RAV	ravi
RAV	ravi
RAVRDY	raverdy
RAV	ravi
RAVRT	ararat
RAVS	reavis
RAVT	rat
RAVYAH	rawiyah
RAVYH	ravey
RAVYNDRAN	ravindran
RAVYRAJ	raviraj
RAVY	ravey
RAVY	ravey
RAYBLT	rybolt
RAYDAH	raidah
RAYDJ	ayda
RAYDL	rayle
RAYDN	ryden
RAYFL	rayle
RAYLH	rayleigh
RAYLY	bayly
RAYMVND	raymond
RAYNR	rayner
RAYP	ray
RAY	ray
RAYSL	rayle
RAYS	brays
RAYSTLYN	raistlin
RAYT	ray
RAYTZ	ragatz
RAYVARD	bayard
RAYVLYNGZ	ayling
RAYV	ray
RAYVTYALA	rautiala
RAYZL	rayle
RAZDAN	razdan
RAZN	razdan
RAZVRBK	razorback
RBHVLZ	rebholz
RBRTSVN	robertson
RBVK	rubik
RBVSV	rbs
RBYAH	riyadh
RBYH	blyth
'RBYL	araby
RBYS	rubys
RDAH	raidah
RDA	reda
RDBVN	radbone
RDFYLD	redfield
RDLFVS	rodolfos
RDLVS	redlus
RDMN	redman
RDMYL	redmill
RDRYK	fredrik
RDVA	reva
RDVLF	rudolf
RDVNDV	redondo
RDYDH	riyadh
RDYH	radeyah
RDY	rudy
RFA	rafa
RFSNS	refsnes
RFSVN	refson
RF'T	rafat
RGD	raghd
RGV	rov
RHLYNG	rehling
RHNY	rony
RHYMAH	rahimah
RHYMH	rahimah
RHYM	rahim
RJAS	rajas
RJAT	rajat
RJ	raj
RKAH	barkah
RKDAL	reckdahl
RKKAH	mekkah
RKSTN	reksten
RKVG	roving
RLF	ralf
RLYVS	orlys
RLYVZ	allyz
RMD	remde
RMFR	rempfer
RMLYNGR	remlinger
RMNCYK	romanchik
RMN	ramon
RMNS	ramons
RMPLYNG	rampling
RMVNY	romany
RMY	remy
RNALDZ	renalds
RNALT	renault
R'NA	rana
RNA	erna
RNAVD	ronald
RNBART	rennebarth
RNDHL	randhol
RNDR	rander
RNDY	randy
RNJ	rns
RNVYS	randys
RN	rn
RNY	rony
RNZLND	renzland
RNZ	renze
RPLAGL	replogle
RPRT	rupert
RPTVN	repton
RQAH	raqqah
RQA	ra
RQD	red
'RRYFA	arrifa
RSA	rosa
RSL	risel
RSL	risel
RSNYK	resnick
RST	rest
RSVL	ravel
RSVLVYRT	resolveert
RSVNAT	resonate
RSVNDL	randal
RSYDA	ayda
RSYDH	riyadh
RSYD	riyad
RSYNH	forsyth
RSYNJH	resyntje
RSYNTH	resyntje
RSYNTJ	resyntje
RSYVYN	rosalyn
RTKLYF	ratliff
RT	art
RVAN	provan
RVATR	grater
RVAY	ray
RVAYZ	vaya
RVAZNR	rainer
RVBRJ	raviraj
RVBR	ribar
RVBRTA	roberta
RVBRT	robert
RVBRTSVN	robertson
RVBRTV	robert
RVBVZ	roboz
RVBYN	robyn
RVBYNSVN	robyns
RVBYNZ	robyns
RVBY	roby
RVBY	roby
RVC	eric
RVC	eric
RVDA	pravda
RVDH	radha
RVDLV	radov
RVDNBRG	roodenburg
RVD	rd
RVD	rd
RVDRYGV	rodrigo
RVDRYGZ	rodriguez
RVDVLFAS	rodolfos
RVDVLF	rudolf
RVDVLFVS	rodolfos
RVGALSKY	rogalsky
RVGVZA	rogoza
RVHAN	rohan
RVHL	brohl
RVHM	rohm
RVHN	rohn
RVHRR	rohrer
RVHR	ruhr
RVJAS	rojas
RVKAN	rukan
RVKA	erika
RVKN	rukan
RVKRY	raverdy
RVKSAN	arkansan
RVKSAN	arkansan
RVKV	drevik
RVKYKY	ryukyu
RVKZ	ritz
RVLAND	roland
RVLDAN	roldan
RVLFH	rolfe
RVLF	ralf
RVLF	ralf
RVLND	roland
RVLS	orvals
RVLV	ravel
RVLY	riley
RVMFVRT	roumfort
RVMRV	marv
RVMYG	romig
RVMYV	remy
RVNALD	ronald
RVNDA	ronda
RVNDH	randhol
RVNDL	rundle
RVNDYN	randys
RVNGV	irving
RVNTRY	coventry
RVNY	rony
RVNY	rony
RVNYT	rony
RVPKH	ralph
RVPRT	rupert
RVP	rep
RVRKH	barkah
RV	rev
RV	rev
RVR	river
RV	rev
RVRY	raverdy
RVRYS	rorys
RVSALYN	rosalyn
RVSAM	rosham
RVSAM	rosham
RVSANA	rosana
RVSA	rosa
RVSKV	rusk
RVSL	risel
RVSLYN	roslyn
RVSLYN	roslyn
RVSNAL	rosendale
RVSNBLAT	rosenblatt
RVSNDAL	rosendale
RVSNDL	rosendale
RVSNFLD	rosenfeld
RVSN	arvesen
RVSNR	reisner
RVS	revas
RVS	revas
RVS	revas
RVSR	river
RVSTAD	rostad
RVSTND	rostand
RVSVLT	roosevelt
RVSVN	arvesen
RVSV	revas
RVSV	revas
RVSYALA	ayala
RVSYTR	rayer
RVTABAGA	rutabaga
RVTGR	rutgers
RVTGRT	rutgert
RVTJ	maritje
RVTJY	ravey
RVTRFRD	rutherford
RVT	rivest
RVT	rivest
RVT	rivest
RVT	rivest
RVT	rivest
RVT	rivest
RVT	rivest
RVTS	ritas
RVTZ	ritz
RVVLVRY	lavery
RVVTH	raith
RVVT	rivest
RVVT	rivest
RVYAH	riyadh
RVYAL	royal
RVYAPA	royappa
RVYBL	rybolt
RVYDN	ryden
RVYH	riyadh
RVYL	royal
RVYLY	lyly
RVYMATA	roimata
RVYN	kevyn
RVYN	kevyn
RVYPK	riopka
RVY	ravey
RVYS	roys
RVYS	roys
RVYS	roys
RVYTNBRG	roytenberg
RVYYZ	rayya
RVYZ	ravey
RVZMARY	rosemary
RVZMARY	rosemary
RVZNDAL	randal
RVZNFLDR	rosenfelder
RVZNJK	rosenjack
RVZN	irvin
RVZ	ariz
RVZ	ariz
RVZ	ariz
RVZVLT	rizvi
RVZY	ravey
RVZYR	rayer
RVZYR	rayer
RVZYTA	travolta
RYAD	riyad
RYBAK	rybicki
RYBAR	ribar
RYBK	rybicki
RYB	rya
RYBRN	rayburn
RYCARD	rickard
RYCARDSN	richardson
RYCARDSVN	richardson
RYCAR	richar
RYCAV	rysavy
RYCMN	ryzman
RYCMYR	richmeyer
RYC	bryce
RYCR	lycra
RYCY	ricky
RYCY	ricky
RYDA	ayda
RYDA	ayda
RYDA	ayda
RYDH	riyadh
RYDH	riyadh
RYDJ	ryder
RYDKVYST	rydquist
RYDL	rydland
RYDNBRC	radenburch
RYDNBRGYRBRAK	radenburgerabroek
RYDN	ryden
RYD	riyad
RYDR	ryder
RYDYG	rydberg
RYDY	rudy
RYFKAYND	rifkind
RYGAN	ryan
RYGARD	regard
RYGLR	rigler
RYG	drying
RYGV	rysavy
RYGYNZ	bryguy
RYHANA	rihana
RYHANH	thanh
RYHL	brohl
RYJKARD	rijkaard
RYJ	rya
RYJSVYJK	rysavy
RYJSVYK	rysavy
RYJYNZ	marylynn
RYKARD	rickard
RYKARD	rickard
RYKR	rayer
RYKRT	prakrit
RYKSVN	rysling
RYKTZ	ritz
RYKVLSVN	reynoldson
RYKY	ryukyu
RYLND	rydland
RYL	rayle
RYLSBK	railsback
RYLY	lyly
RYMANT	reymont
RYMND	raymond
RYMNZ	rymon
RYM	rymon
RYMRS	ymirs
RYMVND	raymond
RYMVND	raymond
RYMVND	raymond
RYMVN	rymon
RYMYL	rymill
RYMY	remy
RYNAH	zaynah
RYNALDA	reynaldo
RYNALD	reynaldo
RYNALDS	reynaldos
RYNALDZ	reynaldo
RYNDNR	rynders
RYNDRT	rynders
RYNDRZ	rynders
RYNG	drying
RYNGST	ringuest
RYNGVVD	reynolds
RYNH	trinh
RYNKR	rayner
RYNLDA	reynaldo
RYN	ryan
RYN	ryan
RYNR	rayner
RYNR	rayner
RYNRT	rayner
RYNTVL	krystal
RYNVD	reynaldo
RYNVLDA	reynolds
RYNVLD	reynolds
RYNVLD	reynolds
RYNVLDS	reynolds
RYNVLDSVN	reynoldson
RYNVLDZ	reynolds
RYNVVD	reynolds
RYPL	dalrymple
RY	ray
RYRDAN	rydland
RYRDAN	rydland
RYRDN	ryden
RY	ray
RYRSVN	rysling
RYRZ	rayer
RYSAH	riyadh
RYSALVYRT	rysavy
RYSAR	yasar
RYSAVY	rysavy
RYSJY	rysavy
RYSKAR	baskar
RYSLVRT	resolveert
RYSLYNG	rysling
RYSLY	rysavy
RYSNR	rayner
RYSNR	rayner
RYSNYK	bryony
RYSRC	oyarce
RYS	roys
RYS	roys
RYS	roys
RYS	roys
RYS	roys
RYSR	rayer
RYSR	rayer
RYSTV	krystal
RYSTYNTJY	resyntje
RYSTY	rusty
RYSVLVRT	resolveert
RYSVLVVRT	resolveert
RYSVR	rysavy
RYSVYK	rysavy
RYSY	rysavy
RYTAKV	rysavy
RYTA	rya
RYTCY	rysavy
RYT	rya
RYTSGRT	ritsgert
RYTVGR	rutgers
RYTYSGRT	ritsgert
RYTZGRT	ritsgert
RYTZ	ritz
RYTZR	retzer
RYVARD	rivard
RYVBR	rydberg
RYVDT	ruudt
RYVMLR	rymill
RYVNSVN	grinsven
RYVNVLD	reynolds
RYVPKA	riopka
RYVR	pryor
RYV	ryu
RYVRZ	pryors
RYVV	rysavy
RYVYRH	rysavy
RYVYS	rysavy
RYYAD	riyad
RYYD	rayya
RYYNKS	yanks
RYYR	rayya
RYZ	rya
RYZR	rayer
RYZVLVRT	resolveert
RYZV	rizvi
RYZVY	rysavy
RZBRY	irizarry
RZNBAVM	rosenbaum
RZNFLD	rosenfeld
RZNKRANS	arizonans
RZNLF	ralf
RZNMN	ryzman
RZNTJY	trinity
RZVLVRT	resolveert
RZYNT	bryant
SAARTJ	saartje
SABGLASYAL	subglacial
SABHANY	abhay
SABLT	sabot
SABRAMANYAM	subramaniam
SABRAMANYAN	subramanian
SAB	saab
SABTNS	sabinas
SABT	sabot
SABVRYN	sabrina
SABVS	saabs
SABYN	abyan
SABYNY	saxony
SACAT	shachat
SACK	sacks
SACR	sacks
SADGRV	sadgrove
SADHA	shadha
SADLR	sadler
SADRBLAM	soderblom
SADYAH	shadiyah
SADYH	shadiyah
SADYK	sandys
SADYKV	sandys
SADYKVYH	shadiyah
SADYKYV	ladasky
SADYVP	sandy
SAFR	shaffer
SAF	salfi
SAFT	taft
SAFTVR	satur
SAFTYN	safoutin
SAGARS	sugars
SAGA	sagan
SAGAYY	sagady
SAGN	sagan
SAGRV	sadgrove
SAGRV	sadgrove
SAHASY	sahasi
SAH	sahr
SAHVLM	sahel
SAJN	stajano
SAJRV	saar
SAKAMVTV	sakamoto
SAKARY	sakari
SAKAYV	sakharov
SAKLAD	saklad
SAKLA	saklad
SAKSNA	sakinah
SAKSNM	isakson
SAKS	saks
SAKS	saks
SAKSVN	isakson
SAKSYM	saks
SAKTN	sackton
SAKT	saks
SAKYA	shakya
SAKY	shakya
SALGA	algae
SALGVRV	salgueiro
SALKRAS	sankaras
SALK	salk
SALMVND	salmond
SALMY	sally
SALTZMN	saltzman
SALTZ	saltzman
SALVMN	salsman
SALVM	salem
SALVMVN	salsman
SALYAN	kalyan
SALYGRAM	shaligram
SALYN	rosalyn
SALY	saley
SALYT	salyut
SALYVAN	kalyan
SALZBRG	salzberg
SALZNBRG	salzenberg
SAMADAR	samaddar
SAMAH	samah
SAMAKR	samar
SAMAN	seaman
SAMANTA	samantha
SAMANTA	samantha
SAMAR	samar
SAMAS	asamas
SAMBAT	shambat
SAMBVLYK	lamboley
SAMGYN	saigon
SAMH	samah
SAMK	salk
SAML	samel
SAMN	seaman
SAMRAL	amaral
SAMR	samar
SAMR	samar
SAMRZ	samara
SAM	sam
SAMS	sams
SAMTYNG	samsung
SAMVLS	samuels
SAMVN	samoan
SAMVSKY	samosky
SAMVYL	sammy
SAMYR	samir
SAMYT	sammys
SAMYT	sammys
SAMZ	sams
SANAHAN	shanahan
SANANDV	anand
SANA	sana
SANBRN	sansburn
SANCTY	nancy
SANDAR	sundar
SANDHV	sandhu
SANDLYN	sandlin
SANDMAN	sandman
SANDRAM	sandra
SANDRM	sandra
SANDRNZ	sandra
SANDRS	sanders
SANDRSVN	sanderson
SANDRZ	sandra
SANDRZ	sandra
SAND	sand
SANDYP	sandy
SANDY	sandy
SANGLD	slangsvold
SANG	sang
SANG	sang
SANGV	sang
SANJAY	sanjay
SANJH	sandhu
SANJSTR	sangster
SANKAR	sankara
SANKN	sanka
SANKR	sankara
SANKR	sankara
SANK	sanka
SANK	sanka
SANLA	scanlan
SANLY	stanley
SANNAR	sanner
SANRANG	semarang
SANRAYZ	sanjay
SANRJH	sarah
SANRTH	granroth
SANRTJY	sannertje
SANRT	sanskrit
SANSAYN	santayana
SANSBRN	sansburn
SAN	san
SAN	san
SANSS	sanas
SANST	satanist
SANSVN	sansing
SANTANA	santana
SANTA	santa
SANTH	sumanth
SANTJ	santje
SANTJY	sanjay
SANTRTJ	sannertje
SANT	saint
SANTSBRN	sansburn
SANTV	sanov
SANTVS	santos
SANTVSY	santos
SANTYK	sandys
SANTY	sandy
SANVNDV	sandvik
SANVN	sandlin
SANV	sanov
SANYL	sandy
SANY	sandy
SANY	sandy
SANYT	sandys
SANZBVRN	sansburn
SANZ	sanz
SAPRV	shapir
SAP	saiph
SARANN	saranen
SARA	sara
SARATY	sarathy
SARDGNA	sardegna
SARDLV	tardell
SARDV	sardo
SARJH	sarah
SARKNAS	sharknas
SARLVT	arlet
SARLY	early
SARMA	sarma
SARNA	sarna
SAR	saar
SAR	saar
SARTAKSV	spartas
SARTH	sarathy
SARTJ	saartje
SARTJY	sarathy
SART	start
SART	start
SARTZR	shartzer
SARVATH	sarathy
SARVK	stark
SARY	starkey
SARYVL	daryl
SASAKY	samosky
SASAN	sawsan
SASKA	sanka
SASLAV	saslav
SASMN	salsman
SASNHYM	sassenheim
SASN	samson
SASTK	astik
SASTYK	astik
SASZH	sasze
SASZ	sasze
SASZY	sasze
SATFN	satan
SATFYN	santayana
SATJ	santje
SATKAS	sankas
SATN	satan
SATR	satur
SATR	satur
SAT	sat
SAT	sat
SATVN	satan
SATVN	satan
SATVR	satur
SATV	sat
SAVAN	kesavan
SAVARAM	savaram
SAVARS	savarese
SAVCVK	sacks
SAVDY	savoy
SAVFRD	sanford
SAVL	savel
SAVL	savel
SAVL	savel
SAVLZ	savela
SAVNDRZ	sandra
SAVSAN	salsman
SAV	slav
SAVTR	salter
SAVTR	salter
SAVTZ	savetz
SAVVY	savoy
SAVYN	savin
SAVYR	savoyard
SAYBRMYJ	sprayberry
SAYBRT	sayers
SAYDA	ayda
SAYKS	sayers
SAYKV	masaryk
SAYLR	sayer
SAYMKV	syme
SAYM	syme
SAYMVN	ayman
SAYMVNS	caymans
SAYP	skype
SAYRY	sayre
SAYTJ	sytje
SAYT	salyut
SAYTV	salyut
SAYTZ	savetz
SAYVRYNGLNT	siuuirdingelant
SAYVYRDYNGLANT	siuuirdingelant
SAYVYR	sayer
SAZH	sarah
SBASTYN	sebastian
SBASTYN	sebastian
SBAYN	bayern
SBHAN	sobhan
SBRA	sabra
SBRT	osbert
SBRYANY	bryony
SBRY	abery
SBS	sbs
SBYRAH	sabirah
SBYRA	byra
SBYRH	sabirah
SBYSTN	blystone
SBYT	sibyl
SDAH	sadah
SDAH	sadah
SDA	seda
SDAY	sunday
SDGRV	sadgrove
SDHA	shadha
SDH	sadah
SDLR	sadler
SDRHLM	cederholm
SDRVV	sadgrove
SD	sed
SDS	seds
SDVAL	sedvall
SDVR	sadr
SDV	sed
SDYA	diya
SDYH	shadiyah
SDYK	dykes
SDYRA	syria
SFARD	farid
SFRD	sanford
SF	asif
SFYLD	ashfield
SGAL	segal
SGVRA	segura
SHA	shar
SHRAB	sohrab
SHR	sahr
SH	seh
SHYB	shub
SKANL	kanal
SKARP	karp
SKAR	sekar
SKLANY	slaney
SKMAN	akman
SKRNTN	krenn
SKSNM	isakson
SKSPYR	skippy
SKSTN	isakson
SKSTVN	skaven
SKT	eskite
SKVYRA	skaya
SKYVRYTY	karty
SLAMKY	slumkey
SLAMN	slan
SLAR	solar
SLARYR	slattery
SLAT	slate
SLAY	slaney
SLAYZ	allyz
SLBRG	selberg
SLBRG	selberg
SLDN	saladin
SLDVN	saladin
SLF	salfi
SLFY	sly
SLJ	seljuk
SLJ	seljuk
SLK	salk
SLMA	salma
SLMA	salma
SLMYDY	smyley
SLMY	sly
SLNY	slaney
SLR	esler
SL	sal
SL	sal
SLT	slut
SLTH	stith
SLTJH	slash
SLTVN	salton
SLVA	silva
SLVD	blvd
SLVDVF	salvador
SLVN	slavin
SLVN	slavin
SLVVD	blvd
SLYJ	sly
SLYMANYH	sulaymaniyah
SLYMA	sloma
SLYMH	blyth
SLYM	sly
SLYM	sly
SLYNA	lynda
SLYPRY	slippery
SLY	sly
SLYTR	slater
SLYV	sly
SMAH	samah
SMAL	small
SMALYAH	shamaliyah
SMALYH	shamaliyah
'SMAN	tasman
SMAR	samar
SMAR	samar
SMA	asma
SMA	asma
SMAT	smart
SMBHV	shambhu
SMBLNKS	samblanx
SMH	samah
SMKVVN	smakovane
SMLY	smyley
SMMA	samma
SMMR	sammer
SMPL	sample
SMPT	sampath
SMRN	smirnov
SMR	samar
SMR	samar
SM	sm
SMSC	samec
SMSL	samsel
SMVTYVK	smitley
SMYAH	samiyah
SMYH	smythe
SMYLH	smythe
SMYM	syme
SMYRAH	samirah
SMYRA	myra
SMYRA	myra
SMYRH	smythe
SMYR	emyr
SMYR	emyr
SMYR	emyr
SMYS	sammys
SMYTLY	smyley
SMYZ	semiz
SNAN	sinan
SNA	sana
SNA	sana
SNA	sana
SNDBRG	sandberg
SNDFVRD	sandford
SNDHYL	sendhil
SNDLYN	sandlin
SNDMN	sandman
SNDRS	sanders
SNDRZ	sandra
SND	sand
SNDS	sands
SNDVYK	sandvik
SNDY	sandy
SNDZ	sands
SNFNG	shenfeng
SNFTLYBN	senftleben
SNGAL	sangal
SNGLVGLV	cengeloglu
SNG	sang
SNG	sang
SNG	sang
SNGVPTA	sengupta
SNGVTA	sengupta
SNHAL	snehal
SNJH	singh
SNKYAT	shenkiat
SNNRTJ	sannertje
SNNY	sonny
SNQAN	sinan
SNR	eisner
SNSBRN	sansburn
SN	sn
SNTJ	santje
SNT	saint
SNTYAGV	santiago
SNVRY	snively
SNVTV	sanov
SNYRJH	snyders
SPARD	shepard
SPARNDAM	spaarndam
SPASTYN	spartan
SPHR	sphar
SPRD	shepard
SPRYNGR	springer
SP	sup
SPYNVAL	panvalkar
SPY	seppy
SRAB	sarab
SRAFYN	serafin
SRASVL	transvaal
SRATVZA	serratosa
SRAYNH	zaynah
SRCAK	sercan
SRDAR	sardar
SRHYR	serhir
SRJH	sarah
SRKAMB	kamb
SRKAN	skean
SRK	stark
SRKS	sparks
SRKYAH	sharqiyah
SRKYH	starkeys
SRLD	sold
SRL	serel
SRLYNG	serling
SRLY	orly
SRMAN	sherman
SRMN	sherman
SRPNT	serpent
SRQYH	sharqiyah
SRR	serra
SRR	serra
SR	sr
SR	sr
SR	sr
SRSTA	sarasota
'SRT	israt
SRTRYD	strydom
SRVADY	servadei
SRVARY	sharvari
SRVMBC	sambolec
SRVVD	servideo
SRVYC	bryce
SRVYDYV	sydney
SRVYS	servis
SRVY	survey
SRYA	surya
SRYF	surya
SRYF	surya
SRYNGTVN	symington
SRY	stray
SRY	stray
SRY	stray
SRYT	surya
SRYVR	strayer
SSADRY	badry
SSANY	sandy
SSDRY	badry
SSYL	sibyl
STARLVZN	stalin
STFANVS	stefans
STHVRAJAN	sethurajan
STLAYN	stian
STLND	eastland
STLR	stoler
STL	stael
STMF	stampf
STNT	styntie
STRATVN	straton
STRYTR	strayer
ST	st
STVFL	stoffel
STVRAMAN	sethuraman
STV	steve
STYVNSVN	stevenson
SVAFVRD	sanford
SVAGATV	swagato
SVAMY	sammy
SVAMY	sammy
SVANK	sevanick
SVAN	sivan
SVAN	sivan
SVANYK	vandyke
SVANY	slaney
SVARMN	savaram
SVART	start
SVARYNGYN	swearingin
SVAS	sivas
SVA	siva
SVAYDA	suwayda
SVBHANDV	subhani
SVBVTKA	sobotka
SVCAN	suchan
SVDAN	sudan
SVDAN	sudan
SVDARMV	sudarmo
SVDARSAN	sudarshan
SVDR	sadr
SVDYP	sudip
SVDYPTV	sudipto
SVDYR	sidor
SVDZ	savetz
SVFN	savin
SVFR	sevier
SVFYH	smythe
SVFYLD	savoyard
SVFY	savoy
SVGN	sogen
SVGRLF	sugarloaf
SVG	savage
SVHA	soha
SVHAS	suhas
SVHA	soha
SVHM	sohm
SVKK	sikkim
SVKLA	smikla
SVKVL	sokol
SVKVMAR	sukumar
SVLAR	solar
SVLAYMNYAH	sulaymaniyah
SVLDR	sluder
SVLD	sold
SVLFVR	silver
SVLK	silk
SVL	savel
SVL	savel
SVLTAN	sultan
SVLT	slut
SVLTZ	shultz
SVLVMVN	silverman
SVLV	silva
SVLVVY	silvey
SVLVYR	silvey
SVLVY	silvey
SVLY	sly
SVLYS	sallys
SVLYTAS	salyuts
SVMA	salma
SVMASYKAR	somashekar
SVMJY	sammy
SVMN	simen
SVMR	simer
SVMRVYL	somerville
SVMVY	somvay
SVMYKR	myer
SVNAR	sundar
SVNA	sina
SVNDARAM	sundaram
SVNDRZ	sindre
SVNGKRN	songkran
SVNGR	singer
SVNGRVALA	songerwala
SVNG	sing
SVNJA	sonja
SVN	sven
SVN	sven
SVN	sven
SVNSN	stevenson
SVN	sven
SVNY	sony
SVNY	sony
SVPN	sopan
SVPRATYK	sporay
SVPRYV	supriyo
SVP	sup
SVRAB	sorab
SVRAB	sorab
SVRAJ	suraj
SVRANA	surana
SVRK	stark
SVRL	savel
SVRNSN	sorensen
SVRN	severn
SVR	sir
SVR	sir
SVRS	srs
SVRSVN	severson
SVRTL	virtual
SVRTN	severn
SVRVALY	sorvali
SVRYNDR	rynders
SVRYN	shryne
SVSAL	vestal
SVSA	sosa
SV	siva
SVSH	slash
SV	siva
SVSN	sven
SV	siva
SV	siva
SV	siva
SVSYA	vaya
SVSYL	sibyl
SVTAN	stan
SVTFN	stefan
SVTN	sven
SVTR	star
SVTR	star
SVTS	sats
SVTV	steve
SVYAK	soyack
SVYDA	ayda
SVYDH	riyadh
SVYFT	seyfert
SVYLR	shuyler
SVYLR	shuyler
SVYNGLR	spangler
SVYNRTVN	symington
SVYN	kevyn
SVYN	kevyn
SVYR	sayer
SVYTNKY	slinky
SVYTV	sytje
SVYYNK	soyinka
SVZALYS	sallys
SVZANA	azana
SVZANH	savannah
SVZA	siva
SVZ	savetz
SVZV	slav
SVZY	suzy
SYANDRA	sandra
SYANG	yang
SYANG	yang
SYANV	yaniv
SYBACR	syriac
SYBL	sybil
SYBL	sybil
SYBLT	sybils
SYBLY	sibley
SYBRT	seyfert
SYDA	ayda
S'YDH	sadah
SYDLR	sidler
SYDLR	sidler
SYDMN	sydney
SYDNY	sydney
SYDR	snyder
S'YD	samoyed
SYD	snyder
SYD	snyder
SYDVR	snyder
S'YDY	sydney
SYFARD	savoyard
SYGL	sybil
SYGL	sybil
SYGLTVN	sylvan
SYGMN	sigman
SYGMN	sigman
SYGMN	sigman
SYGMVND	sigmund
SYG	synge
SYGS	synge
SYHAN	scythian
SYHN	scythian
SYHSVBHVN	sihsobhon
SYHY	sheehy
SYJH	sytje
SYJKV	sytje
SYJMN	sijmen
SYKAGV	ashikaga
SYKAR	shiyekar
SYKARV	shiyekar
SYKR	sakr
SYK	slyke
SYKVLV	sylvia
SYKVRA	sikora
SYKY	sky
SYLA	sylvia
SYLBRMAN	silberman
SYLBRMN	silberman
SYLDN	sylvan
SYLDZ	styles
SYLK	silk
SYL	sibyl
SYLVAN	sylvan
SYLVA	sylvia
SYLVD	sylvie
SYLVNN	sylvan
SYLVRBRG	silverberg
SYLVRMN	silverman
SYLVR	sylvester
SYLVRTVRN	silverthorne
SYLVRVD	sylvie
SYLV	sylvia
SYLVVD	sylvie
SYLVYA	sylvia
SYLVYA	sylvia
SYLVY	silvey
SYLVYV	sylvia
SYLYG	smyley
SYLYMAN	lyman
SYLYMN	lymn
SYLY	smyley
SYLY	smyley
SYLYT	smyley
SYLZMN	saltzman
SYLZ	soyuz
SYLZ	soyuz
SYMAL	somali
SYMARD	simard
SYMAYH	shimayah
SYMBAB	siembab
SYMLR	simler
SYMNDS	raymonds
SYMN	lymn
SYMN	lymn
SYMN	lymn
SYMN	lymn
SYMN	lymn
SYMNZ	lymn
SYMPLYSYTY	simplicity
SYMR	syme
SYMR	syme
SYMS	systems
SYMS	systems
SYMSYK	masaryk
SYMVDYNZ	simodynes
SYMVNA	sylvan
SYMVNDS	raymonds
SYMVNH	yaminah
SYMVNH	yaminah
SYMVN	sylvan
SYMVN	sylvan
SYMVNSN	symington
SYMVNS	sylvan
SYMVNZ	sylvan
SYMVNZ	sylvan
SYMYNG	symington
SYMYNGTVN	symington
SYMYN	ayman
SYMYN	ayman
SYMZ	syme
SYMZ	syme
SYNA	dyna
SYNAN	sinan
SYNA	dyna
SYNAYN	santayana
SYNDLMN	sindelman
SYNDRH	sindhi
SYNGLTVN	singleton
SYNG	synge
SYNK	soyinka
SYNKLARY	sankara
SYNKLAYR	sankara
SYNKLR	sunker
SYNK	soyinka
SYNR	tynor
SYN	sync
SYN	sync
SYN	sync
SYN	sync
SYN	sync
SYN	sync
SYN	sync
SYNTYA	sonya
SYNV	sync
SYNVY	sydney
SYNYBALDY	sinibaldi
SYNYG	synge
SYNY	sydney
SYPL	paypal
SYPLVAYDN	sylvan
SYPLVYDN	sylvan
SYPLZ	skype
SYPMN	shipman
SYPN	stolypin
SYPRYANV	yaryan
SYP	skype
SYRAFYN	serafin
SYRAN	syrian
SYRANT	syrians
SYRA	syria
SYRAY	stray
SYRCNT	searchnet
SYR	sayer
SYRKVYS	starkeys
SYRL	syria
SYRLY	smyley
SYRR	sayer
SYR	sayer
SYR	sayer
SYR	sayer
SYRS	sayers
SYRS	sayers
SYRVKA	syria
SYRVN	syrian
SYRVS	syrias
SYRVYZ	survey
SYRYF	surya
SYRYL	sheryl
SYRYLV	sheryl
SYRYNG	strong
SYSABA	skylabs
SY	sly
SY	sly
SY	sly
SY	sly
SYSK	sisk
SYSLVNZ	sylvan
SYSLV	sylvia
SYS	sykes
SYSTMZ	systems
SYSZ	soyuz
SYTARAM	sitaram
SYTA	scythia
SYTAY	stray
SYTH	smythe
SYTH	smythe
SYTJ	sytje
SYTJY	sytje
SYTLAYV	smyley
SYTLR	sittler
SYTRAH	sitrah
SYTRA	syria
SYTRH	sitrah
SYT	sytje
SYT	sytje
SYTS	systems
SYTV	sytje
SYTYA	rayya
SYTYH	smythe
SYTY	sytje
SYTYZN	styron
SYTZ	sytje
SYTZ	sytje
SYVALD	osvaldo
SYVALV	stovall
SYVA	sylvia
SYVAYRDYNGLNT	siuuirdingelant
SYVLA	sylvia
SYVL	sybil
SYVMN	sylvan
SYVNG	synge
SYVNKA	soyinka
SYVN	sylvan
SYVNYS	sydneys
SYVRDYNGLNT	siuuirdingelant
SYVR	sayer
SYV	sylvia
SYV	sylvia
SYVSMNZ	tysmans
SYVVD	sylvie
SYVYRDYNGLANT	siuuirdingelant
SYVY	smyley
SYVY	smyley
SYYVAYRDYNGLNT	siuuirdingelant
SYYVNYL	sydney
SYZNHYM	sydney
SZARV	sharov
TABVK	tabuk
TABYT	tatby
TAC	taco
TADR	sadr
TAD	tad
TAFT	taft
TAFTZ	tafts
TAFVN	trafton
TAGLV	tagle
TAHARA	tahara
TAHRYHA	tahirah
TAHVN	tahsin
TAJH	tasha
TAKA	taka
TAKMN	akman
TAKR	tasker
TAKSBRY	salisbury
TAKV	taki
TAKY	pataky
TALAN	tallan
TALBRG	thalberg
TALBVYZ	talboys
TALKVT	talbot
TALMAYR	thallmayer
TALMN	talman
TALMY	talmy
TALN	stalin
TALNV	stalin
TALS	staels
TALVANN	tolvanen
TALYBAH	talibah
TALYS	italys
TAMANA	tammana
TAMARA	tamara
TAMAS	tamas
TAMATYVS	almatys
TAMAY	tammany
TAMBRVS	tombros
TAMB	kamb
TAMPAS	tampas
TAMPKYNZ	tompkins
TAMSN	talman
TAMSVN	samson
TAM	tam
TAM	tam
TAM	tam
TAMYNZ	tammuz
TAMY	talmy
TAMZ	tammuz
TANAK	tanak
TANA	tania
TANG	tang
TANG	tang
TANJS	tanis
TANKN	tanneken
TANN	tanner
TANTVN	tanton
TANYS	tanyas
TAPA	tampa
TAPLYN	taplin
TAPR	apr
TAPSYN	topsys
TAPTANY	toptani
TAPYK	tapio
TAPYN	taplin
TAPYV	tay
TARA	tara
TARDL	tardell
TARKL	stark
TARK	stark
TARML	tarim
TARN	stearn
TARQ	tariq
TARS	stars
TARSVN	larson
TAR	star
TARVB	tarub
TARYK	masaryk
TASDYLR	tasdeler
TASKR	tasker
TATAM	tattam
TATARY	tartary
TATBAY	tatby
TATH	strath
TATJ	taatje
TATL	tat
TATL	tat
TATRVY	tartary
TATSVRV	tatsuro
TAT	tat
TAT	tat
TAT	tat
TATYH	takiyah
TATYH	takiyah
TATYL	tatby
TATZ	startz
TAVARS	tavares
TAVRNYNY	tavernini
TAVR	stavers
TAV	tai
TAYBVT	talbot
TAYJMN	ayman
TAYLBRY	taylor
TAYLMANS	tysmans
TAYLMNZ	talman
TAYLR	taylor
TAYLV	taylor
TAYMN	ayman
TAYNVR	traynor
TAYRAY	tartary
TAYR	taylor
TAYRVN	bayern
TAYRY	tartary
TAYSN	ayson
TAYSVN	ayson
TAY	tay
TAYT	tay
TAY	tay
TAYTY	tatby
TAYV	tay
TBT	tibet
TBVK	tabuk
TBYB	toby
TBYT	toby
TDL	trudel
TFYLAH	tafilah
TFYLA	tafilah
T'FYLH	tafilah
TGLBRG	tegelberg
TGL	tagle
THSYN	tahsin
TH	th
THYRAH	tahirah
THYRA	hydra
THYRH	tahirah
TJAJH	tjaatje
TJATJ	tjaatje
TKS	rutks
TK	tak
TK	tak
TK	tak
TKYAH	takiyah
TKYH	takiyah
TLANDR	thelander
TLBRT	talbert
TLBVYS	talboys
TLBVYZ	talboys
TLFR	telfer
TLKVM	tokman
TLLV	tell
TLNT	atlanta
TLR	tyler
TL	tl
TLYBAH	talibah
TLYBA	taliban
TLYBH	talibah
TLYB	talib
TMBRY	tilbury
TMPLMN	tempelman
TMPLR	templar
TMPLTVN	templeton
TMPST	tempest
TM	tm
TMYR	emyr
TNANT	tennant
TNAYA	tenaya
TNBRVK	tenbrook
TNBV	nb
TNDYRY	tandiary
TNKN	tanneken
TNPV	tenpo
TNTS	tants
TNT	tent
TNVR	invar
TNVRYV	nureyev
TNYKN	tennyson
TNYSAN	tennyson
TNY	tiny
TPV	tupi
TQYH	takiyah
TRADA	estrada
TRAFTVN	trafton
TRAFVRD	trafford
TRAH	trash
TRAJKTNSYS	stravinskys
TRAKV	amtrak
TRAN	tran
TRANYTSA	turnitsa
TRAP	trapp
TRAPYN	terrapin
TRASH	trash
TRASTR	traster
TRA	tra
TRAVAJLYA	travaglia
TRAVN	tran
TRAVZY	ravey
TRAYKTNSYS	stravinskys
TRAYNTH	traynor
TRAYNTZ	traynor
TRAYNVR	traynor
TRAYSTNSYS	stravinskys
TRAYSTNYS	tristans
TRAYSY	tracys
TRAZ	taraz
TRBRY	terry
TRD	torda
TRFVRD	trafford
TRLD	startled
TRLDY	trudy
TRL	tri
TRLV	trull
TRMVYL	turmoil
TRMYNAL	terminal
TRNR	turner
TRNSH	trash
TRNS	trans
TRN	tern
TRNTN	trenton
TRNT	trent
TRNYK	ternyck
TRSA	teresa
TRS	stars
TRSTVN	tristan
TRTJY	tartary
TRTJY	tartary
TRTNH	trinh
TRTVAN	tristan
TRTVN	triton
TRVB	tarub
TRVBY	trubey
TRVDL	trudel
TRVDSVN	troedson
TRVF	travis
TRVGTVN	tarkington
TRVHYKV	teruhiko
TRVKS	turks
TRVL	trull
TRVL	trull
TRVLYNGR	trollinger
TRVMBV	trumbo
TRVMYTR	trometer
TRVN	tron
TRVP	trump
TRVRAYS	murrays
TRVR	trevor
TRVRYK	terry
TRVRYS	tertiarys
TRV	tri
TRVTR	trevor
TRV	tri
TRVT	tevet
TRVYLYGR	trevelyan
TRVYRYK	terry
TRVYSDYL	trudy
TRVYTH	truth
TRVYTJ	tryntje
TRVYT	troys
TRVYYJH	tryntje
TRYBL	rybolt
TRYBL	rybolt
TRYDVY	trudy
TRYGS	treys
TRYJV	tryntje
TRYK	ternyck
TRYKTNSYS	brittneys
TRYKT	tryntje
TRYMSTAR	triemstra
TRYM	strydom
TRYNDAD	trindade
TRYND	strand
TRYNHAM	trainham
TRYNJH	tryntje
TRYNKL	trinkle
TRYNTH	tryntje
TRYNTJ	tryntje
TRYNT	tryntje
TRYNVR	traynor
TRYPS	treys
TRYQ	treys
TRYS	treys
TRYSTNSYS	tristans
TRYSTRM	tristram
TRYSY	rysavy
TRYSY	rysavy
TRY	trey
TRY	trey
TRY	trey
TRY	trey
TRYTL	tritle
TRYTL	tritle
TRYTVRY	tartary
TRYVLV	rymill
TRYVRAYS	murrays
TRYVR	traynor
TRYVYTZ	rysavy
TRZH	trash
TSKR	tasker
TSLA	tesla
TSLR	tesler
TSNR	tessner
TSTA	testa
TS	ts
TSTR	tester
TSYMA	teshima
TSYNK	tesink
TTJY	tatby
TTRAD	tetrad
TTR	tatar
TTRV	tetervin
TTRVYN	tetervin
TVAMA	tuama
TVARY	varty
TVAYCL	vancil
TVB	tb
TVBVTYS	talboys
TVBYAS	libyas
TVBYN	robyn
TVDAR	adar
TVD	tod
TVFRY	fry
TVFTH	tooth
TVHLA	thalia
TVKR	stoker
TVK	tak
TVKYV	tokyo
TVLANY	tomany
TVLA	tula
TVLAY	stavely
TVLDV	torvalds
TVLMN	tillman
TVL	tl
TVLYN	trevelyan
TVLY	stavely
TVLY	stavely
TVLY	stavely
TVLYVR	tolliver
TVLYV	stavely
TVMANY	tomany
TVMAS	tomas
TVMAS	tomas
TVMATYVS	almatys
TVMBLY	twombly
TVMS	tims
TVM	tim
TVMY	talmy
TVMY	talmy
TVMY	talmy
TVMYTYVS	almatys
TVMZ	tims
TVNAR	tonar
TVNGA	tonga
TVNG	ting
TVNG	ting
TVNG	ting
TVNJS	tonjes
TVNR	tonar
TVNS	stevens
TVN	tin
TVNYS	tonyas
TVNYS	tonyas
TVNYS	tonyas
TVNY	tiny
TVRAD	tetrad
TVRAMBR	turambar
TVRAYA	thurayya
TVRBR	thurber
TVRDA	torda
TVRKAT	barakat
TVRKV	turk
TVRLDH	trinh
TVRMALA	tormala
TVRMN	truman
TVRNBRG	tornberg
TVRNLY	thornley
TVRNR	turner
TVRN	tern
TVRN	tern
TVRNTVN	trenton
TVRP	tharp
TVRTL	turtle
TVRTN	turton
TVRTVN	turton
TVRVF	viraf
TVRVP	trump
TVRYA	rya
TVRYN	bryn
TVRYSN	torys
TVRY	tory
TVRZ	tirza
TVSAR	tushar
TVSKANV	alaskan
TVS	tls
TVSV	tls
TVSYNG	tyng
TVSYNK	tesink
TV	tl
TV	tl
TVTY	totty
TVVYS	tys
TVYDA	toyoda
TVYDY	sydney
TVYH	takiyah
TVYN	kevyn
TVYT	tuyet
TVYT	tuyet
TVYYDYL	tyndall
TVYYG	tyng
TVYYN	trevelyan
TYBAT	tabatha
TYBL	sybil
TYBVT	rybolt
TYCAVR	carver
TYD	tye
TYF	ty
TYFVRD	tifford
TYGV	tyng
TYHAN	beyhan
'TYH	ayah
TYJATH	strath
TYJMN	tymen
TYLBRY	tilbury
TYLDN	tilden
TYLGNR	tilgner
TYLMANS	tysmans
TYLMNS	tysmans
TYLMNZ	tymen
TYLN	tylenol
TYLR	tyler
TYLR	tyler
TYLV	sylvia
TYLVTSAN	sylvan
TYLYNG	ayling
TYMBVL	timbol
TYMKV	tymes
TYMN	tymen
TYMN	tymen
TYM	tymes
TYMVNYN	tymen
TYMVR	ymir
TYMYAN	tysmans
TYMYNZ	tymen
TYMZ	tymes
TYNANT	tennant
TYNA	dyna
TYNDAL	tyndale
TYNDAL	tyndale
TYNGLY	tingley
TYNG	tyng
TYNG	tyng
TYNSL	tinsel
TYNSLY	tinsley
TYN	tyng
TYN	tyng
TYN	tyng
TYNY	tiny
TYPAL	paypal
TYPV	tupi
TYRNY	tierney
TYRVKS	turks
TYRYH	torah
TYRY	tory
TYRZA	tirza
TYSMNZ	tysmans
TYS	tys
TYSYNJR	tysinger
TYSZA	tisza
TY	ty
TYTAY	tartary
TYTH	myth
TYTMAS	tysmans
TYTS	tys
TYT	tytie
TYT	tytie
TYTY	totty
TYVGA	stygian
TYVMYNN	tymen
TYVNA	dyna
TYVNYS	sydneys
TYVNYS	sydneys
TYV	ty
TYYVLN	sylvan
TYZ	tys
VADAPARTY	vadaparty
VADH	sadah
VADRY	vandry
VADZN	vanduzen
VAFA	afa
VAFYAH	ayah
VAFYA	vaya
VAGL	vogl
VAGNR	vagner
VAGNR	vagner
VAGN	vagner
VAH	lash
VAJDYK	vandyke
VAKFYLD	barksfield
VAKRDAYN	vardan
VAKVRN	vankeuren
VALANS	alans
VALAS	valaries
VALDMANYVNA	waldmanneuenna
VALDMNNA	ladonna
VALDMNNYVYNA	waldmanneuenna
VALDMNYVNA	ladonna
VALDRAM	waldram
VALDV	valdez
VALDZ	valdez
VALH	valhalla
VALKA	valkila
VALKNAR	valkenaar
VALMN	avalon
VALNTYJN	valentijn
VALNTYN	valentin
VALN	avalon
VALRYN	valerian
VALTMN	altman
VALTN	valentin
VALTR	valur
VALTRZ	alcatraz
VALTVN	valentin
VALT	vals
VAL	val
VAL	val
VALVM	valium
VALVRT	calvert
VALVR	valur
VALV	vall
VALVYN	allyn
VAL	val
VALYHVR	valihora
VALYNGTN	alington
VALYNGTVN	alington
VALYN	allyn
VALYS	italys
VALYS	italys
VALY	valley
VALY	valley
VALY	valley
VALY	valley
VALYY	valley
VALZ	valdez
VAMBVL	gamble
VANANTVRP	vanantwerp
VANANVRP	vanantwerp
VANATVRP	vanantwerp
VANBRN	vanburen
VANBVRN	vanburen
VANDNBRQ	vandenburgh
VANDN	vanden
VANDRVYR	vandry
VANDRVYYR	vanderveer
VANDVSN	vandousen
VANDVZN	vanduzen
VANDYK	vandyke
VANDZN	vanduzen
VANDZVN	vanduzen
VANG	vang
VANK	vanick
VANKVRN	vankeuren
VANKVRN	vankeuren
VANSCVNHVN	vanschoonhoven
VANSK	evans
VANSKVNHVN	vanschoonhoven
VANSY	pansy
VAN	van
VANVLK	vanvleck
VANVRANKN	vanvranken
VANVRNKN	vanvranken
VAN	van
VANZANT	vanzandt
VANZNDT	vanzandt
VARBRG	lagerberg
VARBRTVN	warburton
VARBRVG	lagerberg
VARBRVQ	barbra
VARBVRVG	lagerberg
VARBVRV	arbur
VARDY	varty
VARGAS	vargas
VARGV	vargo
VARMA	varma
VARNR	garner
VARNR	garner
VARNS	varnes
VARN	varnes
VARN	varnes
VARNY	varney
VARTVN	gartin
VARTY	varty
VARVL	varvel
VARYANS	aryans
VARYANTS	variants
VARYANTZ	variants
VARYVR	varty
VASALV	vasallo
VASKY	veasey
VASLV	saslav
VASM	asim
VASNGTN	langston
VASNGTVN	langston
VAST	last
VAST	last
VASVN	cavasin
VAS	avas
VAS	avas
VASYK	vandyke
VASYM	veasey
VASYNGTVN	symington
VASYT	veasey
VATANAB	watanabe
VATANYB	latonya
VATKYNZ	atkins
VATRHAVS	latashas
VATRMN	lanterman
VATRSVN	larson
VATRZ	beatriz
VATS	ats
VATV	vato
VAT	vato
VAVDRAY	vandry
VAVDRY	vandry
VAYA	vaya
VAYB	vaya
VAYBY	playboy
VAYDMN	vandeman
VAYD	ayda
VAYGL	vaya
VAYLDR	aylor
VAYL	layla
VAYMN	ayman
VAYNGRV	vijayanagar
VAYNTH	zaynah
VAYN	ayn
VAYPKJ	vandyke
VAYSMN	ayson
VAYS	vaya
VAYTHAVS	altheas
VAYTHRN	leythen
VAYTHVRN	leythen
VAYTHVS	athos
VAYTVRS	ayers
VAYTYKR	varty
VAYTYKR	varty
VAYZAK	yzaak
VAYZ	vaya
VBR	br
VBSTR	buster
VB	vibe
VCNR	lechner
VDAD	dada
VDBRG	edberg
VDLMVDY	vadlamudi
VDLYN	evelyn
VDMYR	emyr
VD	ved
VFA	ufa
VFYAH	ayah
VFYH	forsyth
VFYYH	wafiyyah
VGL	vogl
VGL	vogl
VGNR	vagner
VGNR	vagner
VHRA	vohra
VJDAN	vardan
VJYHA	vaya
VJYHH	najiyah
VJYH	najiyah
VKKYA	kaya
VKRFAS	veras
VKRV	kirov
VK	vik
VLADAK	vladack
VLADAN	vladan
VLADV	vlad
VLAM	lam
VLAN	vladan
VLA	vela
VLA	vela
VLDMN	veldman
VLDMNVNA	ladonna
VLDMN	veldman
VLDN	velden
VLD	veld
VLFSVN	olafson
VLKMAN	volkman
VLK	volk
VLK	volk
VLMJH	elijah
VLMN	veldman
VLMTH	lilith
VLMTJ	wellemtje
VLMT	velma
VLNTA	vinata
VLNTYJN	valentijn
VLNTYN	valentin
VLR	valur
VLSKY	polsky
VLS	vals
VLSY	valley
VLTMR	voltmer
VLTR	voltmer
VLTRYNG	tyng
VLTRY	lory
VLTY	varty
VLVDYN	vladan
VLVSV	volvos
VLYDH	blyth
VLYNGTVN	ellington
VLYNK	evelyn
VLYS	lilys
VLYS	lilys
VLZL	volz
VLZ	volz
VLZ	volz
VNABLS	venables
VNANTVRP	vanantwerp
VNASCVNVN	vanschoonhoven
VNBRN	vanburen
VNBVRN	vanburen
VNCVNHVVN	vanschoonhoven
VNC	vance
VNDAZN	vanduzen
VNDLND	wendland
VNDL	vandal
VNDL	vandal
VNDMN	vandeman
VNDRFVRD	vanderford
VNDRVR	vanderveer
VNDRVYR	vandry
VNDRY	vandry
VNDVSN	vandousen
VNDVVSN	vandousen
VNDVZN	vanduzen
VNDVZN	vanduzen
VND	vinod
VNDYK	vandyke
VNDZL	vandal
VNG	vang
VNHF	vanhoff
VNKATA	venkata
VNKAT	venkat
VNKRN	vankeuren
VNKRN	vankeuren
VNKVRN	vankeuren
VNKVRN	vankeuren
VNKV	vinko
VNKYVRN	vankeuren
VNKYVRN	vankeuren
VNLK	volk
VNNTVRP	vanantwerp
VNRNKN	vanvranken
VNR	vagner
VNRYPR	vanriper
VNSKVNHVVN	vanschoonhoven
VNSL	tinsel
VNS	avins
VNSVNHAVN	vanschoonhoven
VNSVNHVVN	vanschoonhoven
VNTRLY	coventry
VNTZ	lantz
VN	van
VNVLK	vanvleck
VN	van
VNVRANKN	vanvranken
VN	van
VN	van
VN	van
VNYK	vandyke
VNYLK	vandyke
VNYNGR	enying
VNYRNKN	vanvranken
VNZANDT	vanzandt
VNZANT	vanzandt
VNZND	vanzandt
VNZNT	vanzandt
VRBK	verbeck
VRBVRVF	viraf
VRCYK	tracys
VRDAN	vardan
VRHVST	verhulst
VRKMN	volkman
VRLV	volvo
VRLYND	verlinde
VRLYNG	arling
VRMASRN	vermaseren
VRMAS	vermaas
VRMA	varma
VRMVLN	vermeulen
VRMVNT	vermont
VRMYLYYVN	marylynn
VRMYVLN	vermeulen
VRMZ	varma
VRNGRYN	nguyen
VRNN	vernon
VRNR	lerner
VRSVVN	iverson
VRVBL	varvel
VRVJH	irish
VRVTH	horvath
VRVVD	rivard
VRVVTJ	vrouwtje
VRVYJ	averys
VRYLAV	rysavy
VRYLV	beryl
VRYTY	verity
VRY	avery
VSAL	vestal
VSLYAN	visayans
VSLY	sly
VSLZ	volz
VSM	sm
VSTAL	vestal
VSTFAL	vestal
VSTLY	astley
VSTLY	astley
VSTMVRLND	westmoreland
VSTN	stan
VSTRHLM	westerholm
VSTRN	stern
VSTRVLDT	westerveldt
VSTRVLT	strait
VSTR	vorster
VST	vest
VSTVN	steven
VSTVR	stavers
VST	vest
VST	vest
VS	vs
VSYM	syme
VSYT	vest
VSY	veasey
VSY	veasey
VTMVR	voltmer
VTR	vitor
VTR	vitor
VTS	vitos
VT	vest
VVDARD	darde
VVDBRN	aldebaran
VVDD	ved
VVDGYT	egypt
VVDHAVS	vidals
VVDN	velden
VVDRV	vader
VVDVARD	edvard
VVD	veld
VVGLR	vogler
VVGL	vogl
VVG	vigo
VVJAK	vojak
VVK	vivek
VVLARD	villard
VVLARD	villard
VVLMN	voldman
VVLTRNYNG	morning
VVLY	lively
VVLZ	volz
VVN	vin
VVN	vin
VVRDN	vardan
VVRYLAV	rysavy
VVRYLV	ivery
VVS	vs
VVTR	vitor
VYANN	vianen
VYBH	lylah
VYBKH	lylah
VYBRND	bernd
VYBVVV	sybil
VYB	yb
VYBY	lyly
VYCARD	lockard
VYCVRA	lycra
VYDAD	rydland
VYDAL	vidal
VYDAL	vidal
VYDA	lydea
VYDD	lydea
VYDFANG	yang
VYDMAN	veldman
VYDMN	lymn
VYDMR	vladimir
VYDRY	vandry
VYDVN	lyndon
VYD	loyd
VYDYR	dayr
VYDY	sydney
VYDYV	sydney
VYFAL	vaya
VYGAND	uganda
VYGAND	uganda
VYGJYN	pygmys
VYGLY	lyly
VYGMVR	voyager
VYGN	vigen
VYGRT	voyagers
VYGSTVN	livingston
VYGTVN	leyton
VYG	vaya
VYGYNZ	pyongyang
VYJBRAND	wijbrand
VYJBRND	wijbrand
VYJDAN	vladan
VYJNAND	wijnand
VYJND	lynda
VYJNND	lynne
VYJN	lymn
VYKAMP	kampe
VYKAS	vikas
VYKAVN	skaven
VYKFYLD	byfield
VYKHAM	yokohama
VYKLVND	yelland
VYKNZ	kenz
VYKRAM	vikram
VYKRS	iyars
VYKRZ	vikram
VYKS	sykes
VYKS	sykes
VYKTVR	viktor
VYKTVR	viktor
VYKTYM	varty
VYK	vik
VYK	vik
VYK	vik
VYK	vik
VYLADVT	viladot
VYLARD	villard
VYLARD	villard
VYLASKV	laylas
VYLAS	laylas
VYLATZ	blatz
VYLA	layla
VYLA	layla
VYLBR	byler
VYLDKAT	venkat
VYLDRMN	voldman
VYLDYNG	ayling
VYLFRD	alfred
VYLFRD	alfred
VYLHAYT	avichay
VYLHLMAS	valhallas
VYLHLMVS	valhallas
VYLHLM	valhalla
VYLJV	viljo
VYLKAKS	laylas
VYLKANS	balkans
VYLKAS	laylas
VYLKNS	voikins
VYLKN	volkman
VYLKRSVN	fulkerson
VYLKYNSN	marylynn
VYLKYNSVN	marylynn
VYLKYN	evelyn
VYLKYNZ	valkyrie
VYLLMVS	vilmas
VYLMNTJY	valentijn
VYLMR	voltmer
VYLMTJY	almaty
VYLMT	vilma
VYLMVR	ymir
VYLMVT	vilma
VYLMYNTH	yaminah
VYLMYNTJH	yaminah
VYLMYNTJ	martyntje
VYLMYNT	zygmunt
VYLMYNYTH	aliyyah
VYLND	hyland
VYLND	hyland
VYLNR	byler
VYLR	byler
VYLR	byler
VYLSVN	sylvan
VYLS	lyles
VYL	lyle
VYL	lyle
VYL	lyle
VYLYAM	lyly
VYLYAMYNA	layamon
VYLYANY	albany
VYLYNGHAM	willingham
VYLYNGZ	ayling
VYLYR	lyly
VYLY	lyly
VYLY	lyly
VYLY	lyly
VYLZ	volz
VYLZ	volz
VYMAL	vimal
VYMAN	lyman
VYMAN	lyman
VYMBRLY	kimberly
VYMN	lymn
VYMPH	rumph
VYMPJH	olympia
VYMPJ	olympia
VYMPJY	gypsy
VYMP	olympia
VYMPYJ	olympia
VYMR	ymir
VYNATA	vinata
VYNBRG	roytenberg
VYNCSTR	lancaster
VYNDN	lyndon
VYNDRZ	rynders
VYNDVM	lynda
VYND	lynda
VYNKLMAN	monkman
VYNKL	lyndel
VYNKLZ	yanks
VYNKV	vonk
VYNLT	lyndel
VYNND	lynne
VYNN	lynn
VYNRT	lynette
VYNR	tynor
VYNSNT	lynn
VYNSN	lynn
VYNSR	lynds
VYNSTD	finstad
VYNSTRVM	lundstrom
VYNSTVK	ulyanovsk
VYNSTVN	vinson
VYNSVN	vinson
VYNTH	cynthia
VYNTJH	eyntje
VYNTJ	eyntje
VYNTJY	eyntje
VYNTRFYLD	winterfeld
VYNTRMYVT	coventrys
VYNTRR	paynter
VYNTR	paynter
VYNTRZ	luntz
VYNTVN	teynton
VYNT	bryant
VYNTZ	luntz
VYN	kevyn
VYNVKR	yonkers
VYN	kevyn
VYNYBL	venable
VYNYKY	vandyke
VYNYNGR	pyongyang
VYNYNGSTD	winningstad
VYNYZ	sydneys
VYNZ	kevyn
VYPKJH	lylah
VYPKJ	wiepkje
VYPKJY	gypsy
VYPK	yok
VYPYN	gypsys
VYRAF	viraf
VYRCVAL	lyrical
VYRJYL	varty
VYRJYNYA	rayya
VYRNDRA	virendra
VYRN	byrne
VYRSMA	varma
VYRTANN	virtanen
VYRT	evert
VYR	lyra
VYR	lyra
VYR	lyra
VYRYANA	yaryan
VYRZ	lyra
VYSAL	lysol
VYSKA	yeka
VYSL	lysol
VYSPY	gypsy
VYSR	yasar
VYSR	yasar
VYSTFAL	vestal
VYSTVN	blystone
VYST	myst
VYS	levys
VYSVN	alyson
VYSVN	alyson
VYSY	gypsy
VYSYVS	gypsys
VYTAKA	taka
VYTAKR	voyager
VYTAL	vitale
VYTFYLD	byfield
VYTKAMB	kamb
VYTKVS	vaitkus
VYTMR	voltmer
VYTMVR	ymir
VYTNBRG	roytenberg
VYTN	leyton
VYTN	leyton
VYTSH	ayush
VYTSVN	yeltsin
VYT	ivy
VYTVL	lytle
VYTVR	vitor
VYTVRYA	yaryan
VYTV	lytle
VYT	ivy
VYT	ivy
VYT	ivy
VYTYKR	tyler
VYTYK	vitek
VYTYNGTVN	symington
VYTZ	lutz
VYVA	vaya
VY	ivy
VYVKS	yves
VYVK	vivek
VYVLA	layla
VYVR	iyar
VYVVR	aylor
VYVYANH	aliyyah
VYVYAN	yaryan
VYVYK	lyly
VY	ivy
VY	ivy
VY	ivy
VYYRS	iyars
VYZBRAND	librande
VYZNAND	vanzandt
VYZNRY	vandry
VYZN	vizen
VYZRNR	byrne
VYZVN	sylvan
VZDA	hvezda
VZYNA	vezina
XALDAH	khalidah
XALYDH	aaliyah
XAN	xian
XAY	tay
XLYDA	lydea
XLYDH	blyth
XLYLH	lylah
XRDL	kardal
YAGLA	yagla
YAGR	yager
YAKVB	yake
YAKVLTY	oakley
YAKVTAH	yakootah
YAKVTA	yalta
YAMAHA	yamaha
YAMAHA	yamaha
YAMHA	yamha
YAMN	yarman
YAMYNAH	yaminah
YAMYNA	yaminah
YANGR	yang
YANG	yang
YANGY	yangi
YANSVN	yanson
YANVVYTZ	yangtze
YAN	yan
YANYV	yaniv
YANZK	yanzek
YAP	yap
YARGR	yager
YARLA	iarla
YARMAN	yarman
YARVN	yaron
YARVS	yaros
YARYAN	yaryan
YASAR	yasar
YASR	yasar
YASYN	yasin
YASYRAH	yasirah
YASYRH	yasirah
YASY	yossy
YATS	yates
YAV	yaniv
YAYN	yaryan
YKVTAH	yakootah
YLND	hyland
YLYC	alyce
YLYF	lyly
YMHA	yamha
YMN	lymn
YMYNH	yaminah
'YN	ayn
YRBRY	yerbury
YRMYS	pygmys
YSRA	yasirah
YSRYH	yasirah
YSYRAH	yasirah
YSYRA	syria
YSYRH	yasirah
YTR	pyotr
YVBYRA	byra
YVFYNGTVN	uffington
YVHANS	hans
YVKYLV	jekyll
YVK	yok
YVLYN	evelyn
YVMANS	lymans
YVMN	yumn
YVMVRA	aymara
YVNAL	tyndale
YVNAS	yonas
YVNGSAP	yongsup
YVN	sylvan
YVNSVN	yanson
YVN	sylvan
YVNYZA	sonya
YVRANYM	franny
YVRBANYK	urbanik
YVRK	york
YVRMV	yermo
YVRYNA	yaryan
YVSF	yosef
YVSTN	yousten
YVS	yves
YVSYV	yossy
YVSY	yossy
YVSY	yossy
YVZF	yosef
YVZR	aylor
YYKA	yeka
YYK	yok
YYTZ	yahtzee
YYTZ	yahtzee
YZAK	yzaak
YZK	yzaak
YZYD	yazid
ZABL	zabel
ZABZ	zambezi
ZACARY	zachary
ZAFYNA	zafina
ZAGAR	zagar
ZAHD	zahid
ZAHYD	zahid
ZAKVB	zaki
ZAKVB	zaki
ZAKVMYNTAY	zaynah
ZAKYVS	jackys
ZAK	zaki
ZAKY	laky
ZALAN	zalan
ZAMVR	zamora
ZAMYT	amyot
ZANGRL	zangerl
ZAN	zane
ZANKH	zaynah
ZANKY	jansky
ZANK	zanuck
ZANS	zanes
ZANT	iant
ZAPARA	zapara
ZARA	zara
ZARRYTN	zjarritjen
ZARVS	zaras
ZARYA	arya
ZARYH	zaynah
ZARYTN	karyn
ZARYTZN	aryan
ZATRVVD	astrid
ZAYNAH	zaynah
ZAYNA	zaynah
ZAYRA	mayra
ZAYR	mayr
ZAZA	zaza
ZFRY	fry
ZFYNA	zafina
ZFYNH	zaynah
ZHRA	zahra
ZHRA	zahra
ZHRA	zahra
ZHYD	hyde
ZHYRAH	zahirah
ZHYRA	hydra
ZHYRH	zahirah
ZJARYTJN	zjarritjen
ZJARYTN	zjarritjen
ZKH	kazakh
ZKYAH	zakiyyah
ZKYH	zakiyyah
ZKY	sky
ZK	zaki
ZK	zaki
ZLA	zola
ZLR	zeller
ZLTJ	aaltje
ZLYKAH	zaynah
ZLYXA	alyx
ZMANK	zemanek
ZMAN	zeman
ZMYRAN	zimraan
ZMYT	amyot
ZNG	zang
ZNK	zns
ZNTNR	zentner
ZNYKH	zaynah
ZN	zn
ZPKA	zepka
ZRA	ezra
ZRYA	arya
ZRYFA	zarifa
ZRYF	zarifa
ZRYH	zaynah
ZRYNK	zurink
ZRY	czerny
ZVHANS	khans
ZVHANSN	hansen
ZVKA	zepka
ZVLD	zold
ZVL	zyl
ZVLMR	zolmer
ZVLY	lively
ZVLYKA	zuleika
ZVNTK	zontek
ZVRYNK	zurink
ZVRYSYKA	rayya
ZVTRVD	astrid
ZVTRVVD	astrid
ZVVAYTA	vaya
ZVVYTA	zuvieta
ZVYTA	zuvieta
ZVYTRVVD	ayurveda
ZVZF	aziz
ZYGMVNT	zygmunt
ZYLT	zyl
ZYL	zyl
ZYMRAN	zimraan
ZYNAH	zaynah
ZYNA	zaynah
ZYNB	zaynah
ZYNH	zaynah
ZYNSR	zinser
ZYRA	lyra
ZYRYLY	marylynn
ZYR	zeyer
ZYTV	zyl
ZYVRYNK	zurink
ZYVTRVD	ayurveda
ZYZY	lizzy
ZZA	zaza
ZZ	aziz
