AACTAY	antarctica
AALTJ	aaltje
AAMYNA	aamina
AARVN	aaron
ABA	aba
ABAD	abad
ABADA	barbadian
ABADHBY	abudhabi
ABAJA	azerbaijan
ABAR	akbar
ABCR	abcher
ABDJA	abidjan
ABDLRHMAN	abdalrahman
ABDVN	aberdeen
ABH	abhay
ABHAY	abhay
ABHY	abhay
ABLA	abella
ABL	abel
ABL	abel
ABLH	abdullah
ABLHYD	adelheid
ABLJ	abeltje
ABLT	ablett
ABLTJ	abeltje
ABLY	abley
ABLYSN	abelson
ABND	abend
ABNR	abner
'ABR	aabar
ABR	aberg
ABRAHAM	abraham
ABRAHYM	abraham
ABRAHYM	abraham
ABRAM	abram
ABRAMSVN	abramson
ABRAPT	abrupt
ABRAYT	abstract
ABRBAC	eberbach
ABRG	aberg
ABRG	aberg
ABRKRVMBY	abercrombie
ABRL	amberle
ABRLY	amberle
ABRMSKY	obremski
ABRT	abrupt
ABRT	abrupt
ABRVTR	abrupt
ABRY	abery
ABRY	abery
ABRYN	asbrink
ABRYNY	abernathy
ABSTGARTN	obstgarten
ABST	abstract
ABSTRKT	abstract
ABT	abbot
ABTYN	abtine
ABV	abe
ABVBA	aboba
ABVDBY	abudhabi
ABVDHABY	abudhabi
ABVHBYB	abudhabi
ABVLYN	abolin
ABVRYMH	warborough
ABVT	abbot
ABVT	abbot
ABVTSMYT	abbotsmith
ABYA	abyan
ABYAB	abiab
ABY	abby
ABY	abby
ABYAD	abiad
ABYAN	abyan
ABYD	abend
ABY	abby
ABYL	abel
ABYLAK	abdalmalik
ABYNA	abyssinia
ABYNGM	albinger
ABYNGN	abyssinian
ACDL	archdale
AC	ac
ACR	accra
ACRNAR	achernar
ACTY	acton
ACTYH	arctic
ACY	ascoly
ACYLS	aeschylus
ACYSVN	acheson
ACYT	acosta
ADAB	adab
ADAM	adam
ADAMV	adamo
ADANA	adana
ADAN	adan
ADANL	dardanelles
ADARA	adhara
ADB	adab
ADBRG	anderberg
ADGRYNGLND	adgeringelant
ADGRYNGLNT	adgeringelant
ADGYNGTVN	edgington
ADH	adhara
ADKAK	adisak
ADKK	adik
ADKRYK	adirondack
ADKVK	adik
ADKYNZ	adkins
ADKYRK	oudekirk
ADLA	adela
'ADL	wardell
ADL	adel
ADLARDV	adelardo
ADLAYD	adelaide
ADLAYD	adelaide
ADLHYD	adelheid
ADLMA	adalma
ADL	adel
ADLR	adler
ADLSVN	adelson
ADLY	ardley
ADMVND	edmond
ADMVNDS	edmonds
ADMVNDZ	edmond
ADMVNZ	adametz
ADMYRALN	admiralen
ADMYRALZ	admiral
ADMYSTVN	edmiston
ADNAMS	adnams
ADNAMZ	adnams
ADNBRAG	vandenburgh
ADNBRG	vandenburgh
ADNBRV	radenburch
ADNBRVG	vandenburgh
ADNBVRG	vandenburgh
ADRY	audrey
ADRY	audrey
ADRYANA	adriana
ADRYAN	adrian
ADRYANS	adrianas
ADRYN	adrian
ADRYNKLNT	adgeringelant
ADRYNS	aldrins
ADRYNY	adriane
ADRYNY	adriane
ADRYS	audreys
ADSAL	adusumalli
ADST	adsett
ADSVN	addison
ADT	adit
ADVARD	adelardo
ADVARD	adelardo
ADVARDSN	edwardsson
ADVART	vadaparty
ADVLF	adolf
ADVLFSVN	adolfsson
ADVLF	adolf
ADVNCR	adventure
ADVNL	adgeringelant
ADVNYS	adventist
ADVSVMALY	adusumalli
ADVVART	vadaparty
ADY	addy
ADY	addy
ADY	addy
ADY	addy
ADY	addy
ADYH	adolph
ADYK	adik
ADYKS	addicks
'ADYL	wardell
ADYL	adel
ADYLRD	adelardo
ADYNA	adina
ADYNGTVN	addington
ADYNGTVN	addington
ADYS	andys
ADYSAK	adisak
ADYSVN	addison
ADYT	adit
AFA	afa
AFAF	afaf
AFRA	afra
AFRDYT	alfredo
AFRVDYT	alfredo
AFTAB	aftab
AFV	afif
AFVRYL	macfarlane
AFYCART	aphichart
AFYF	afif
AFYGTN	afghanistan
AFYNGTN	uffington
AFYS	afros
AFYSR	ayrshire
AFYVN	afioun
AFZAL	afzal
AFZL	afzal
AGALY	agali
AGAS	agass
AGATY	agate
AGBRN	pangborn
AGBVRN	pangborn
AG	ag
AGLSTVN	eaglestone
AGMN	agamemnon
AGMVZ	adametz
AGNDY	agndie
AGNV	aganovic
AGNVYK	tanganyika
AGPYAN	agopian
AGR	agra
AGRAVALA	agrawala
AGRN	agren
AGRTN	baumgartner
AGRTVN	baumgartner
AGRYNGLANT	adgeringelant
AGRYNGLND	adgeringelant
AGVLV	agullo
AGVR	alger
AGVSTV	agustin
AGVSTYN	augustyn
AGVSTYNLY	agostinelli
AGVSTYNY	augustyn
AGVYRV	aguero
AGVYV	agoyo
AGYLA	angela
AGYL	argyle
AGYLSVN	eaglestone
AGYNST	against
AHAY	abhay
AHLAND	auckland
AHMAN	ahriman
AHMN	ahriman
AHRN	ahern
AHY	abhay
AHYH	wahibah
AJ	ajax
AJAST	ojaste
AJAY	ajay
AJDA	alejandra
AJLVS	beaujolais
AJNT	martijntje
AJRAYNGLND	adgeringelant
AJYNGTVN	alington
AJYNTVN	anton
AKA	aka
AK	ack
AKADMY	akademik
AKADMYK	akademik
AKAKS	taklamakans
AKAPADY	accapadi
AKBRG	ekberg
AKBVRN	ayckbourn
AKDAG	akdag
AK	ack
AKGAN	akgun
AKL	akl
AKLAND	oakland
AKLND	oakland
AKLVF	aurkleven
AKLY	ackley
AKLY	ackley
AKM	akeem
AKMAN	akman
AKMANDNSYS	ekmundensis
AKMANDSYS	ekmundensis
AKMAN	akman
AKMNA	amna
AKMN	akman
AKMR	nakamura
AKMVNDNSYS	ekmundensis
AKMY	akemi
AKN	akin
AK	ack
AKR	akar
AKRM	ackerman
AKRMAN	ackerman
AKRMN	ackerman
AKRSAND	eckersand
AKRSLATV	ekerslato
AKRSLYTV	ekerslato
AKRSTV	backhurst
AKRT	ackeret
AKRVYD	ackroyd
AKRYL	akrill
AKS	aksu
AKSAYL	barksdale
AKSDLM	barksdale
AKSFRD	ashford
AKSFVRD	ashford
AKSFVRD	ashford
AKSKRYTYA	nakasora
AKSLSVN	jakobsson
AKSLY	barksdale
AKSS	adkinss
AKSTRND	ekstrand
AKSTYN	pakistan
AKSV	aksu
AKSYL	barksfield
AKTS	awketts
AKTVN	alkerton
AKTVN	alkerton
AKTY	akihito
AKTYV	akhmatova
AKVAL	alukal
AKVAYLA	pakala
AKVAYL	alukal
AKVDV	alkaid
AKVKS	bangkoks
AKVNA	askanas
AKVNR	afrikaner
AKVSTA	pakistan
AKY	ackley
AKY	ackley
AKYF	wakefield
AKYHYKV	akihiko
AKYLA	akella
AKYLA	akella
AKYLAH	akilah
AKYL	akil
AKYL	akil
AKYLH	akilah
AKYLS	akilesh
AKYM	akeem
AKYN	akin
AKYTVMV	akitomo
AL'ADYN	alaaldin
ALAHAYDYKYA	alexandria
ALAHDVD	salahaddin
ALALDYN	alaaldin
AL	al
ALAM	alamo
ALAMZ	kalamazoo
ALANA	alana
ALANGKV	arkhangelsk
ALAPATY	alapati
ALAQBH	alaqabah
ALARD	allard
ALASR	alaisdair
ALASVRS	alars
ALAVAY	allaway
ALAVY	allaway
ALAYN	alain
ALAYSDYR	alaisdair
ALAYS	albanys
ALBAHAH	albahah
ALBHA	albahah
ALBHAH	albahah
ALBLJH	abeltje
ALBR	alber
ALBRAYT	galbraith
ALBRT	albert
ALBRTYNY	albertini
ALBRY	allbery
ALBRYJ	allbery
ALBVN	albion
ALBVZ	alvarez
ALBYNGR	albinger
ALDHAYD	almohad
ALDLHLD	adelheid
ALDN	aldan
ALDN	aldan
ALD	aldo
ALDR	alder
ALDRD	aldridge
ALDRYC	aldrich
ALDRYDJ	aldridge
ALDRYG	aldridge
ALDRYG	aldridge
ALDRYJ	aldridge
ALDRYJ	aldridge
ALDRYJ	aldridge
ALDRYJH	aldrich
ALDYN	alden
ALDZ	valdez
ALFA	alfaro
ALF	alf
ALFANSV	californians
ALFARV	alfaro
ALF	alf
ALFRD	alford
ALFRDV	alfredo
ALFRS	alfors
ALFRYNG	elfering
ALFVRD	alford
ALFVRD	alford
ALGADV	alegado
ALGARD	allard
ALGAYN	alagesan
ALGRV	alger
ALGSAN	alagesan
ALGY	almighty
ALGYNGTVN	alington
ALHDAD	alhudud
ALHDVD	alhudud
ALJ	aeltje
ALJH	alex
ALKAN	alaskan
ALKBAH	albahah
ALKBR	alkabeer
ALKBYR	alkabeer
ALKK	alok
ALKMR	walker
ALKMRH	almeroth
ALKMRY	alkerton
ALKR	walker
ALKRTN	alkerton
ALKRTVN	alkerton
ALKS	alaskas
ALKSANDR	alesandro
ALKSANDRVZ	alesandro
ALKSNDR	alesandro
ALKSY	alaskas
ALKSYV	alaskas
ALKVAB	alkabeer
ALKVK	alok
ALKVR	walker
ALKYNGTN	elkington
ALKYNGTVN	elkington
ALKYNTN	elkinton
ALLADHKYAH	alladhiqiyah
ALLADHYKYAH	alladhiqiyah
ALLAHYGYAH	alladhiqiyah
ALLDHYKYAH	alladhiqiyah
ALLDYKYAH	alladhiqiyah
ALLHYQYH	alladhiqiyah
ALM	alm
ALMAR	walmart
ALMAS	almas
ALMATVN	dalmatian
ALMGRN	almgren
ALMKVAST	taklamakans
ALMKVYST	almqvist
ALMN	allman
ALMNTAJ	almintaqah
ALMR	almira
ALMRS	walmarts
ALMRVT	almeroth
ALMVD	almoravid
ALMVDYVAR	almudevar
ALMV	almqvist
ALMVMAN	elmoman
ALMVR	almudevar
ALMYNAKAH	almintaqah
ALMYNTAGAH	almintaqah
ALMYNTAKAH	almintaqah
ALMYNTAKVA	almintaqah
ALMYNTKH	almintaqah
ALMYRAL	almirall
ALN	alan
ALN	alan
ALND	walend
ALNDR	alcindor
ALN	alan
ALNVR	alnoor
ALNY	albany
ALPN	alpen
ALPRT	alpert
ALPVRT	alpert
AL'QBH	alaqabah
ALRBK	ellerbeck
ALRD	alford
ALRTN	alkerton
ALRTVN	alkerton
ALRVY	allbery
ALRY	allbery
ALRYGH	albright
ALRYJ	allbery
ALSANDRY	alesandro
ALSAN	alaskan
ALSAN	alaskan
ALSAP	alsop
ALSAP	alsop
ALSAP	alsop
ALSNDRV	alesandro
ALSN	alison
ALSN	alison
ALSNR	alesandro
ALSP	alsop
ALSP	alsop
ALSPD	alsop
ALSR	aleser
ALSTRVM	ahlstrom
ALSVN	alison
ALSVN	alison
ALSVN	alison
ALSVP	alsop
ALSVP	alsop
ALSVRS	alistairs
ALSVRT	alsworth
ALSVZ	alvarez
ALSY	als
ALT	alta
ALTANYN	eltanin
ALT	alta
ALTAYR	altair
ALTMAN	altman
ALTMN	altman
ALTMN	altman
ALTRVAYD	alternately
ALTRVD	aaltruide
ALTRVYD	aaltruide
ALTRVYYD	aaltruide
ALTSVN	malthusian
ALTV	alto
ALTYR	altair
ALTZ	alcatraz
ALVA	alva
ALVAN	alwan
ALVARV	alvaro
ALVARVS	alvaros
ALVARZ	alvarez
ALVAY	allaway
ALVF	alf
ALVKAL	alukal
ALVK	alok
ALVLD	alfeld
ALVRS	alvaros
ALVSA	alisa
ALVVD	almoravid
ALVVD	almoravid
ALVY	abley
ALVY	abley
ALVYN	alwyn
ALVYN	alwyn
ALVYN	alwyn
ALVYN	alwyn
ALVYN	alwyn
ALVYS	alves
ALVZ	alvarez
ALXZNA	alzena
'ALYA	aaliyah
ALYA	alya
'ALY	early
A'LY	ainley
ALY	alya
ALYA	alya
ALYA	alya
A'LYAH	aaliyah
ALYAH	aliyyah
ALY	alya
ALY	alya
ALY	alya
ALYAN	alwan
ALYAS	alyssas
ALYASVN	alaskan
ALYBY	alibey
ALY	alya
ALY	alya
ALYFAS	alfredas
'ALYH	aaliyah
ALYJ	aeltje
ALYKS	alnitaks
ALYLYVNAS	alelyunas
ALYMA	alima
AL'YN	alwyn
ALYN	allyn
ALYN	allyn
ALYN	allyn
ALYN	allyn
ALYNGR	albinger
ALYNGTVN	alington
ALYNGTVN	alington
ALYN	allyn
ALYNYK	alnitak
ALY	alya
ALYSA	alyssa
ALYS	alyces
ALYS	alyces
ALYS	alyces
ALYSN	alyson
ALYSTVN	alston
ALYSTYR	alistair
ALYSVN	alyson
ALYSVN	alyson
ALYSVN	alyson
ALYSVN	alyson
ALYSYA	alyssa
ALYVA	alya
ALYVRYA	alvarado
ALYVT	aleut
ALYVT	aleut
ALYVY	aliyyah
ALYYA	aliyyah
ALYZA	alzena
ALYZABT	elizabeth
ALYZ	allyz
ALYZR	alzheimer
ALZ	allyz
ALZNA	alzena
ALZN	alzena
ALZVRS	alzheimers
AMA	ama
AMADVR	amador
AMAGYV	armageddon
A'MAL	admiral
AMAL	amal
AMAND	amand
AMANVAL	amanda
AMANV	amani
AMANVL	campanella
AMANVYL	campanella
AMANY	amani
AMANYVL	campanella
AMARA	amara
AMARAL	amaral
AMARDYV	amardeo
AMARNT	amarnath
AMARYT	amarit
AMBAR	lambadaris
AMBASY	gambias
AMBLR	ambler
AMBRLY	amberle
AMBRLY	amberle
AMBRLYNG	emberling
AMBRVSS	ambrosius
AMBRVSVS	ambrosius
AMBRVSYV	ambrosio
AMBRVSYVS	ambrosius
AMBVS	ambers
AMBYJ	abuja
AMDYV	almudevar
AMFN	amin
AMLAK	amlak
AML	amal
AMLK	amlak
AMLN	ameslan
AMLYA	amalia
AMNA	amna
AMN	amin
AMNVN	amnon
AMPN	ampon
AMPRVR	emperor
AMPSVN	sampson
AMPT	ampte
AMPTH	sampath
AMPY	ampon
AMRALD	emerald
AMR	amir
AMRJYNG	armstrong
AMRMAN	amerman
AMRVSYV	ambrosio
AMRY	amery
AMRY	amery
AMRY	amery
AMRYKA	amerikan
AMRYKN	amerikan
AMRYKN	amerikan
AMRYTA	amritha
AMS	ams
AMSTAT	amstadt
AMSTD	amstadt
AMSTR	amster
AMSY	amshey
AMT	amit
AMTYSTA	amethysta
AMVNA	amina
AMVNDSYZ	amundsen
AMVRVSV	almoravids
AMVRY	amery
AMVS	almqvist
AMY	amy
AMY	amy
AMYH	amish
AMYHAY	amihai
AMYKVS	armonks
AMYLY	amelia
AMYLY	amelia
AMYLYYV	amelia
AMYNA	amina
AMYNA	amina
AMYNH	amenhotep
AMYRA	amira
AMYR	amir
AMYR	amir
AMYT	amyot
AMYTAVA	amitava
AMYT	amyot
AMYT	amyot
AMYVT	amyot
AMYVT	amyot
AMYZVTA	amezquita
ANAGRAM	anagram
ANAKYN	anakin
ANALVG	analog
ANANDA	ananda
ANAND	anand
AN	ain
ANANSA	ananias
ANANT	anant
ANAS	anas
ANASTASYA	anastasia
ANATVLY	anatoly
ANATY	anatoly
ANAY	anay
ANAYLYN	anatolian
ANAYZA	unaiza
ANAZ	anasazi
ANAZA	unaiza
ANBAR	anbar
ANBR	anbar
ANBV	anbu
ANCY	anchi
ANDAMZ	adametz
AND	and
AND	and
ANDNS	andenes
ANDRA	andra
ANDR	andr
ANDR	andr
ANDRBRG	anderberg
ANDRBVRG	anderberg
ANDRBY	anderberg
ANDR	andr
ANDR	andr
ANDRR	anderer
ANDRS	andras
ANDRS	andras
ANDRSN	andersen
ANDRSN	andersen
ANDRSVN	andersen
ANDRVS	andres
ANDRVZ	andropov
ANDRYA	andrea
ANDRY	andre
ANDRY	andre
ANDRYAS	andreas
ANDRYS	andres
ANDRYS	andres
ANDRYS	andres
ANDRYSN	andreasen
ANDRYSN	andreasen
ANDRYVZ	andropov
ANDRYYA	andrea
ANDRYZ	andree
ANDSVRS	landsteiners
ANDSVRT	endesworth
ANDSVVRT	endesworth
ANDVLSN	andolsen
ANDYSL	vanderspeigle
ANDYYVRANS	andrianampoinimerinas
ANFANT	enfant
ANFYLD	arnfield
ANGBRTSN	engebretsen
ANGH	anghe
ANGLAND	langland
ANGLANDR	englander
ANGLASMA	anglicanism
ANGLHARD	engelhardt
ANGLHLM	engelholm
ANGLHVRN	engelhorn
ANGLND	langland
ANGLS	angels
ANGLS	angels
ANGLSMA	anglesea
ANGLSVN	andolsen
ANGLTH	angelita
ANGLTJ	engeltje
ANGLTJH	engeltje
ANGLYNA	angelina
ANGLYS	angles
ANGLZ	anglicize
ANGRSVL	ingresole
ANGVLV	angelo
ANH	anchi
ANHLD	anhold
ANJBRTSVN	engebretsen
ANJL	banjul
ANJLJY	banjul
ANJLS	angels
ANJLT	anujit
ANJLTJA	angelita
ANJLV	banjul
ANJLYNA	angelina
ANJLYS	angeles
ANJLYSYA	anglesea
ANJY	anujit
ANJYLYNY	angeline
ANKNY	ankeney
ANKR	anker
ANKRLY	enkerli
ANKSTAD	annexstad
ANKVRN	anckorn
ANPYNGKV	unpingco
ANQ	algonquin
ANQH	almintaqah
ANRAH	andromache
ANR	andr
ANRYK	vanvranken
ANRYKV	vanvranken
ANRYKYV	vanvranken
ANRYKYYVZ	markowitz
ANSAR	ainsaar
ANSKAMB	anscomb
ANSL	ansell
ANSLM	anselm
ANSLMV	anselmo
ANSLY	ansley
ANSLYN	ansselin
ANSPAC	anspach
ANSR	ainsaar
ANSTYTV	aisenstat
ANSY	ansley
ANSY	ansley
ANSYH	anshu
ANSYKR	sanskrit
ANTAL	antal
ANTANAYTYS	antanaitis
ANTARAMYAN	antaramian
ANT	aint
ANTH	anthea
ANTNA	antenna
ANTRAPY	antwerp
ANTRV	antero
ANTRVSYV	antrosio
ANTRYKYN	entrikin
ANTSTL	anthistle
ANTSYTL	anthistle
ANTVN	anton
ANTVN	anton
ANTVN	anton
ANTVNVGLV	antonoglou
ANTVNVVYC	antonowich
ANTVNY	antony
ANTVNY	antony
ANTVNY	antony
ANTVNYS	antonys
ANTVNYS	antonys
ANTVNYV	antony
ANTVNYVS	antonys
ANTVS	antevs
ANTY	antley
ANTYLA	antila
ANTYPDS	antipodes
ANTYSTL	anthistle
ANTYSTLH	anthistle
ANV	antevs
ANV	antevs
ANVAR	anzlovar
ANVCYN	anuchin
ANV	antevs
ANV	antevs
ANVJYT	anujit
ANVKVL	anukul
ANVN	angevin
ANVPAM	anupam
ANVP	anoop
ANVR	anvers
ANVR	anvers
ANVR	anvers
ANVRS	anvers
ANVS	antevs
ANVS	antevs
ANVTYYADYS	oranjestads
ANVVY	anniversary
ANYART	earnhardt
ANYJMA	banjarmasin
ANYL	anil
ANYL	anil
ANYL	anil
ANYMA	andaman
ANYNG	antonoglou
ANYSA	anisa
ANYS	andys
ANYSH	anoosh
ANYSTYN	earnestine
ANYVRSRY	anniversary
ANYVS	andys
ANYYV	ainley
ANZALVNY	anzalone
ANZLVAR	anzlovar
ANZYNGR	enzinger
APCRC	aphichart
AP	apr
APL	apel
APL	apel
APLBAY	albany
APLBRG	appelberg
APLBY	appleby
APLBY	appleby
APLMN	appleman
APLNDS	laplands
APLYBY	appleby
APLYBY	appleby
APLYN	aplin
APNDYS	laplands
APRAYT	alpheratz
APRLY	april
APRSVN	aperson
APRYL	april
APSTN	capistran
APSTVN	capistran
APSTYN	capistran
APSYLVN	epsilon
APVNTH	aponte
APVRVA	apoorva
APYDAL	camelopardalis
APYSTYN	capistran
AQBAL	iqbal
ARAM	abram
ARAND	armand
ARAN	amran
ARARKH	astrakhan
ARAS	aras
ARAS	aras
ARASMVS	arianisms
ARAY	airay
ARAYZ	americanize
ARBANAS	arbanas
ARBR	arber
ARBVR	arber
ARBYD	archibald
ARBY	araby
ARBYL	arbil
ARBY	araby
ARCAL	archdale
ARCALH	ardalich
ARC	arce
ARCARD	earnhardt
ARCDALY	archdale
ARCDL	archdale
ARCDYL	archdale
ARCR	archer
ARCYBALD	archibald
ARDALYC	ardalich
ARDMN	hardiman
ARDN	arden
ARDRZ	cardozo
ARDYS	ardis
AR	ar
ARFANAKYS	orfanakis
ARFVRD	waterford
ARFYVS	arnulfos
ARGAN	argentinian
ARGAN	argentinian
ARGAR	margaret
ARHARD	earnhardt
ARKARD	afrikaner
ARKDYL	barksdale
ARKTYKY	arktiki
ARLAYJ	iarla
ARL	aral
ARL	aral
ARL	aral
ARLT	arlet
ARLY	early
ARLYJ	early
ARLYNDH	adirondack
ARLYNG	arling
ARMAND	armand
ARM	arm
ARMASTRANG	armstrong
ARMATV	armato
ARMNY	armani
ARMRY	armour
ARMSRVNG	armstrong
ARMSTRANG	armstrong
ARMVNTRVT	armontrout
ARMVR	armour
ARMYN	aureomycin
ARMYTAJ	armitage
ARMYT	armitt
ARMYTAZ	armitage
ARN	arne
ARNAT	argonaut
ARND	arend
ARNDT	arendt
ARNFYLD	arnfield
ARNH	arnhem
ARNLD	arnold
ARNST	earnest
ARNT	arnot
ARNT	arnot
ARNT	arnot
ARNTS	arantes
ARNVLD	arnold
ARNVT	arnot
ARNVT	arnot
ARP	earp
ARPYN	arpin
ARS	ars
ARSKAT	arsenault
ARSKAYN	carskadon
ARSNALT	arsenault
ARSY	anniversary
ARSYD	aristides
ARSYKR	arsikere
ARTL	aristotle
ARTR	arter
ARTRS	arthers
ARTRZ	arturo
ARTVT	armitt
ARTYS	abernathys
ARTYZ	alpheratz
ARVAL	aral
ARVMA	aromaa
ARVN	arvesen
ARVNACALAM	arunachalam
ARVNAH	arunah
ARVND	arend
ARVNN	argonne
ARVRKH	farrakhan
ARVSN	arvesen
ARVYNG	arling
ARVYVLA	arviola
ARYA	arya
ARYA	arya
ARY	arya
ARYC	aureomycin
ARYFA	arrifa
ARYJ	arjuna
ARYKA	amerikan
ARYKA	amerikan
ARYK	ark
ARYK	ark
ARYKSN	arkansan
ARYKSVN	arkansan
ARYKSVN	arkansan
ARYKSVN	arkansan
ARYN	aryan
ARYNGTN	arlington
ARYS	aryans
ARYS	aryans
ARYS	aryans
ARYSTVTL	aristotle
ARYZ	ariz
ARYZ	ariz
ARZAT	arzate
ARZ	ariz
ASAKVL	assakul
ASBL	asbell
ASBRN	asbrink
ASBRYNK	asbrink
ASBVRN	eastburn
ASCAFYLD	ashfield
ASCAGN	mascagni
ASCRVVYC	ashcroft
ASCVFYLD	ashfield
ASCVYLAR	auslander
ASCYPLVDN	schipluiden
ASCYPLVYDN	schipluiden
ASCYPN	aspen
ASDS	assads
ASFAR	rastafarian
ASFYLD	ashfield
ASGVRYAN	asguarian
ASKADZ	ashkhabad
ASKAGN	askanas
ASKAHAN	saskatchewan
ASKAJN	askanas
ASKALANT	escalante
ASKAL	alukal
ASKALYK	arkhangelsk
ASKALY	alukal
ASKANL	askanas
ASKANYL	askanas
ASKARP	baskar
ASKARS	ankaras
ASKARTSYS	skartsis
ASKARY	baskar
ASK	ask
ASKATV	saskatoon
ASKATYA	saskatchewan
ASKATY	saskatoon
ASKAVN	askanas
ASKAYA	askanas
ASKAYLR	baskar
ASKAY	asoka
ASKAYT	saskatoon
ASKLDSVN	eskeldson
ASKLTN	skelton
ASKLTVN	skelton
ASKLVYR	arsikere
ASKNL	assakul
ASKNS	askanas
ASKP	aesop
ASKRAB	ashkhabad
ASKRANTVN	austranten
ASKRAYZ	ashkenazim
ASKRNTN	austranten
ASKRNTVN	austranten
ASKRVYC	arsikere
ASKRYBLYNG	scribbling
ASKRYBNR	easterner
ASKRYC	arsikere
ASKRY	arsikere
ASKRYS	sanskrits
ASKRYV	arsikere
ASKVAYRL	baskar
ASKVAYR	baskar
ASKVFYLD	ashfield
ASKVGAN	askanas
ASKVLY	assakul
ASKVLYNG	rasalingam
ASKVLYN	austvollen
ASKVLY	assakul
ASKVLYZ	assakul
ASKV	ask
ASKVRR	austvorren
ASKV	ask
ASKVTVNY	saskatoon
ASKVYLR	arsikere
ASKVYVYL	assakul
ASKYBA	ashkhabad
ASKYLS	catskills
ASKYNR	arsikere
ASKYN	askanas
ASKYN	askanas
ASKYPLADN	carskadon
ASKYPLVYDN	eskeldson
ASKYPN	aspen
ASKYP	waskey
ASKYPY	waskey
ASKYRS	sanskrits
ASKY	waskey
ASKYTR	aster
ASLANKARD	slankard
ASLAN	ameslan
ASLAN	ameslan
ASLAN	ameslan
ASLATKYN	slatkin
ASLATKYN	slatkin
ASLATR	auslander
ASLATRY	auslander
ASLATVBR	auslander
ASLAVK	eastlake
ASLAVMYZ	kalamazoo
ASLAVNBRG	slavenburg
ASLAVYN	ameslan
ASLAYK	eastlake
ASLBVTNN	slabotnen
ASLD	ashfield
ASLMN	asselman
ASLNGZVALD	slangsvold
ASLP	aswalap
ASLR	auslander
ASLS	ashlees
ASLSYNG	slashing
ASLTN	auslin
ASLTR	aster
ASLVAN	ameslan
ASLVKAM	ashkenazim
ASLVKA	kasmalkar
ASLVMN	asselman
ASLVN	auslin
ASLVN	auslin
ASLVP	aswalap
ASLY	ansley
ASLYGRZ	allegro
ASLYMAN	asselman
ASLYNY	auslin
ASLYPR	allport
ASLYP	aswalap
ASLYTY	assimilate
ASLYVPAS	aliphas
ASLYV	ansley
ASMA	asma
ASMADJ	ahmadinejad
ASMAL	adusumalli
ASMALY	adusumalli
ASMART	asmara
ASMAYT	assimilate
ASMDLY	ashmolean
ASMLN	ashmolean
ASMVKY	kasmalkar
ASMVLYK	kasmalkar
ASMVLYN	ashmolean
ASMVR	ashmore
ASMVT	assimilate
ASMYD	quasimodo
ASMYKLA	ashmolean
ASMYL	ashmolean
ASMYLY	ashmolean
ASMYRNV	austhamaren
ASMYT	assimilate
ASMYTSVN	austronesian
ASMYTVYK	astik
ASMYTZ	auschwitz
ASMYTZ	auschwitz
ASNAG	ashikaga
ASNAYDR	alesandro
ASNDN	ashenden
ASNL	arsenault
ASNL	arsenault
ASNLYNG	snelling
ASNR	easterner
ASNVDN	ashenden
ASNVFYLD	arnfield
ASNVGRS	angoras
ASNV	anson
ASNYD	ashenden
ASNYL	arsenault
ASNYSL	aspens
ASPANGLR	spangler
ASPARDAM	spaarndam
ASPARKS	sparks
ASPARNDAM	spaarndam
ASPAR	caspar
ASPARV	kasparov
ASPARZA	esparza
ASPATAFVRA	spatafora
ASPAT	elastoplast
ASPATSVVD	elastoplasts
ASPATZ	alpheratz
ASPAVLDYNG	spaulding
ASPAYDR	auslander
ASPAYDRZ	esparza
ASPAYK	kasprzak
ASPAYKS	aspidiskes
ASPAYNYNG	souphanouvong
ASPAYRZ	esparza
ASPAYZ	esparza
ASPLMN	asselman
ASPLYD	ashfield
ASPLYNTR	splinter
ASPNSR	aspens
ASPNS	aspens
ASPRAG	sprag
ASPR	atmosphere
ASPRVT	alpert
ASPRYBRY	sprayberry
ASPRY	atmosphere
ASPVLARYC	spolarich
ASPVLARYX	apollinaire
ASPVR	atmosphere
ASPVRY	atmosphere
ASPVSTA	aisenstat
ASPVSYTV	elastoplast
ASPVTYS	australopithecus
ASPYDN	aspen
ASPYLMN	asselman
ASPYNAK	spinak
ASPYNDRYFT	spindrift
ASPYN	aspen
ASPYRAS	diasporas
ASPYR	atmosphere
ASPYR	atmosphere
ASPYRV	atmosphere
ASPYRV	atmosphere
ASPYRYNG	armstrong
ASPYRZ	kasprzak
ASPYRZ	kasprzak
ASPYSAK	aspidiske
ASPYSYK	aspidiske
ASPYT	rasputin
ASPYTZR	spitzer
ASPYVAK	kasprzak
ASPZYTV	australopithecus
ASRAT	abstract
ASRAYYL	australia
ASRMN	asherman
ASTABRT	astarte
ASTABZ	rastaban
ASTAD	amstadt
ASTAD	amstadt
ASTAFL	australia
ASTAFVRD	stafford
ASTAG	castlereagh
ASTAJANV	australian
ASTAKMN	astrakhan
ASTAKR	astaire
ASTAKSLAJR	stockslager
ASTAKS	alnitaks
ASTAKY	eastlake
ASTAKY	eastlake
ASTALKH	astrakhan
ASTAMPR	austhamaren
ASTAM	amsterdam
ASTANGYR	stangier
ASTANVL	estanol
ASTAPLYC	australopithecus
ASTARBAK	easterbrook
ASTARGS	astartes
ASTARGYL	astaire
ASTARK	astaire
ASTARKYP	astaire
ASTARKY	astaire
ASTAR	astaire
ASTAR	astaire
ASTARTLD	startled
ASTART	astarte
ASTARTZ	astarte
ASTARYNGR	staringer
ASTARZ	astaire
ASTAS	acostas
ASTATM	astarte
ASTATRZ	astaire
ASTATZMN	austranten
ASTAYLZ	australia
ASTAYNLS	astanas
ASTAYNMN	austbanen
ASTAYN	astana
ASTAYR	astaire
ASTBAY	austbanen
ASTCNYK	pasternak
ASTDLR	stadler
ASTDMN	eastman
ASTDYNA	astana
ASTFANS	rastafarians
ASTFAN	rastafarian
ASTFAN	rastafarian
ASTFANVS	rastafarians
ASTFANV	rastafarian
ASTFANZ	rastafarian
ASTFN	rastafarian
ASTFNSVN	austronesian
ASTGN	castergine
ASTK	astik
ASTLR	castlereagh
ASTLY	astley
ASTLYK	eastlake
ASTLY	astley
ASTNFRD	stanford
ASTNFVRD	stanford
ASTNFVRT	stenfort
ASTNKAMB	astana
ASTNSL	alstons
ASTNSRAD	australoid
ASTN	aston
ASTNTJY	austranten
ASTPKN	astrakhan
ASTPK	astik
ASTRABRYJ	easterbrook
ASTRADR	ostrander
ASTRAKMN	astrakhan
ASTRAK	astrakhan
ASTRANDR	ostrander
ASTRAP	australopithecus
ASTR	aster
ASTRASYM	asturias
ASTRAVB	australoid
ASTRLYNG	armstrong
ASTRMLR	stremler
ASTRN	austern
ASTRND	astrid
ASTRN	austern
ASTRVK	astrakhan
ASTRVM	ahlstrom
ASTRVS	astartes
ASTRVSTRAP	stroustrup
ASTRYAN	austrian
ASTRYBL	australia
ASTRYD	astrid
ASTRYDM	amsterdam
ASTRYDR	astrid
ASTRYM	ahlstrom
ASTRYN	austrian
ASTRYNGR	armstrong
ASTRYNJR	easterner
ASTRYN	austrian
ASTRYNY	austrian
ASTRYR	easterner
ASTRY	astore
ASTRYTY	astarte
ASTS	easts
ASTVARD	bastard
ASTVART	astarte
ASTVBRYJ	easterbrook
ASTVDVLA	amsterdam
ASTVFL	basterfield
ASTVKLAS	aristotelians
ASTVK	astik
ASTVK	astik
ASTVKVL	austvollen
ASTVKY	astik
ASTVLK	eastlake
ASTVLR	castlereagh
ASTVL	austvollen
ASTVN	aston
ASTVNBRAYJ	glastonbury
ASTVNSN	austronesian
ASTVN	aston
ASTVN	aston
ASTVR	aster
ASTVRGA	astoria
ASTVRLYR	austvorren
ASTVRMZ	austerlitz
ASTVRR	austvorren
ASTVRYM	ahlstrom
ASTVRY	austvorren
ASTVRY	austvorren
ASTV	aster
ASTVVAL	australia
ASTVY	astley
ASTYANSN	astanas
ASTYBL	astley
ASTYBR	eastburn
ASTYD	astrid
ASTYGBRG	stigberg
ASTYGMN	eastman
ASTYGRS	easters
ASTYG	armstrong
ASTYJH	asquith
ASTYK	astik
ASTYKLMN	stickelman
ASTYLR	castlereagh
ASTYL	astley
ASTYL	astley
ASTYL	astley
ASTYLY	astley
ASTYLZ	austerlitz
ASTYN	augustyn
ASTYNBRG	stenberg
ASTYNSN	austronesian
ASTYN	augustyn
ASTYN	augustyn
ASTYNSVN	austronesian
ASTYNTH	austranten
ASTYNTJH	austranten
ASTYNTJ	austranten
ASTYNZ	augustyn
ASTYPLZ	austerlitz
ASTYP	aristophanes
ASTYRN	austern
ASTYRNZ	austern
ASTYSY	alstons
ASTYSY	alstons
ASTYT	adsett
ASTYVDNT	amstadt
ASTYVN	augustyn
ASTYVNSVN	austronesian
ASTYVS	asturias
ASTYVZ	austerlitz
ASVALAP	aswalap
ASVALD	australoid
ASVANAY	astana
ASVK	ashok
ASVLT	arsenault
ASVRS	easters
ASVSKY	aspidiske
ASVYSR	assyria
ASYA	assyria
ASY	amshey
'ASYF	asif
ASYF	asif
ASYMYLYT	assimilate
ATANSYV	altmans
ATA	alta
ATA	alta
ATARAS	ataras
ATH	athey
ATJH	aetje
ATKA	atka
ATKYNSN	atkinson
ATKYNSVN	atkinson
ATKYNZ	aitken
ATKYNZ	aitken
ATL	atle
ATLS	atlas
ATMSFR	atmosphere
ATMZ	akitomo
AT	at
ATRAM	atram
ATR	atri
ATRTN	atherton
ATRY	awtrey
ATRYSPS	atriceps
ATRZ	austerlitz
ATTLY	alternately
ATV	active
ATVATR	atwater
ATVD	astrid
ATV	active
ATVL	atul
ATVL	atul
ATV	active
ATV	active
ATVSAN	athabascan
ATVS	antevs
ATVSY	antevs
ATVVD	atwood
ATVVL	austvollen
ATVYL	austvollen
ATYA	atiya
ATY	athey
ATYG	attig
ATYLRD	aylward
ATYLRDH	castlereagh
ATYLYV	antley
ATYNGR	easterner
ATYNY	antony
ATYNZVN	etinzon
ATYS	antonys
ATYVL	atul
ATYYA	atiya
AVACA	oaxaca
AVAD	alvarado
AVADYA	awadia
AVALD	aguinaldo
AVAN	avian
AVANZ	aurangzeb
AVASTY	awasthi
AVBAJA	azerbaijan
AVBRAYAN	abdalrahman
AVBRDVRFR	oberdorfer
AVBRHVLZ	oberholz
AVBRHYM	abraham
AVBR	aubrey
AVBRTAS	albertas
AVBRY	aubrey
AVBRY	aubrey
AVBYD	abend
AVBYNGM	albinger
AVCARD	alvarado
AVCAR	achernar
AVCLND	walend
AVCZ	anglicize
AVDDY	addy
AVDKRYK	oudekirk
AVDKYRK	oudekirk
AVDL	adel
AVDLY	audley
AVDRA	audra
AVDRGV	auldridge
AVDVAK	adisak
AVDVN	advent
AVDV	acevedo
AVDYVM	adam
AVFNR	afrikaner
AVFYNGTVN	uffington
AVGAR	avogadro
AVGBVRN	pangborn
AVGLT	aoglat
AVGNH	walpurgisnacht
AVGNYV	allegheny
AVGVR	auger
AVGVRY	avogadro
AVGVST	august
AVGVSTV	auguste
AVGVSTYN	augustyn
AVGYNH	walpurgisnacht
AVHALVRAN	ohalloran
AVHRMN	ahriman
AVJN	abidjan
AVKLND	auckland
AVKLY	ackley
AVKR	auker
AVKRAYN	ackerman
AVKR	auker
AVKSLY	barksdale
AVKSTVN	pakistan
AVKSVL	jacksonville
AVKT	akita
AVKTS	awketts
AVKTZ	markowitz
AVKYNZ	ashkenazim
AVKYTS	awketts
AVLAFSVN	olafson
AVLA	avila
AVL	advil
AVLAYVVLA	apalachicola
AVLD	auld
AVLDKVRN	aldrin
AVLDRAYT	aludra
AVLDRYJ	auldridge
AVLDZ	valdez
AVLMN	allman
AVL	advil
AVLSN	abelson
AVLSN	abelson
AVLSVN	abelson
AVLSVN	abelson
AVLVSTAD	ulvestad
AVLYMA	alima
AVLYNG	aveling
AVLY	ainley
AVLY	ainley
AVLYVYH	aliyyah
AVLYVYR	alvaro
AVMAKY	amlak
AVMBRGR	baumberger
AVMGA	amiga
AVMLAS	amalias
AVMR	amir
AVNAT	anant
AVN	avon
AVNAYZA	unaiza
AVNAYZ	anasazi
AVNGLYSTA	evangelista
AVNG	aveling
AVNSTY	adventist
AVNSVN	anson
AVNVSKV	arkhangelsk
AVNYL	avniel
AVNYL	avniel
AVNZ	alonzo
AVQVAQ	aqila
AVRAHAM	avraham
AVRAM	avram
AVRAYL	aral
AVRAYS	alvarados
AVRAYZ	americanize
AVRAYZ	americanize
AVRBN	arabian
AVRCARD	earnhardt
AVRDALN	aurdalen
AVRFYVS	aeroflots
AVRGAN	adgeringelant
AVRHAN	archean
AVRHAN	archean
AVRHART	earhart
AVRHRT	earhart
AVRHV	avraham
AVRKLYVN	aurkleven
AVRKNY	amerikan
AVRLANDV	garland
AVRL	averell
AVRLYNZ	weaverling
AVRMA	amerman
AVRM	avram
AVRMSPVRDN	ormesporden
AVRN	avernus
AVRNVPN	aurnupen
AVR	avery
AVRSBRG	arensburger
AVRSLR	oursler
AVRTS	arts
AVRTYZ	alpheratz
AVRVM	avrum
AVRV	avrum
AVRVYL	argyle
AVRY	avery
AVRYGA	auriga
AVRYK	ark
AVRYL	argyle
AVRYL	argyle
AVRYNTS	arantes
AVRYS	averys
AVRYS	averys
AVRYS	averys
AVRY	avery
AVRYVLY	argyle
AVRYVN	aryan
AVRYVRDAN	karridian
AVRYZ	alvarez
AVSAL	absalom
AVSBVRN	eastburn
AVSBVRN	eastburn
AVSLANDR	auslander
AVSLYNA	rasalingam
AVSN	arvesen
AVSN	arvesen
AVSNZ	ashkenazim
AVSTBANN	austbanen
AVSTHAMARN	austhamaren
AVSTLYC	astley
AVSTNDVRP	oostendorp
AVSTRANDR	ostrander
AVSTRNDR	easterner
AVSTVLYN	austvollen
AVSTVRYN	austvorren
AVSTYN	augustyn
AVSYVN	assyrian
AVSYZ	agassiz
AVTAGVRV	pantagruel
AVTA	avesta
AVTH	alioth
AVTJH	aetje
AVTJ	aetje
AVTLV	atle
AVTLV	atle
AVT	advent
AVT	advent
AVTRY	awtrey
AVTVLYNY	austvollen
AVTV	amitava
AVTYS	almatys
AVVLYV	alyx
AVVRDAL	airedale
AVVRPK	overpeck
AVYAN	abyan
AVYARS	alvaros
AVYCAY	avichay
AVYK	aveek
AVYNAS	alelyunas
AVYNG	auyeung
AVYNZ	alonzo
AVYRSA	aversa
AVYS	averys
AVYSNA	abyssinia
AVYVA	aviva
AVYVN	aoyoun
AVZBRN	aldebaran
AVZGVR	anzlovar
AVZMN	saltzman
AVZVNYS	arizonas
AYALA	ayala
AYBAC	abstract
AYBAR	aabar
AYBL	aibel
AYBYRVNK	asbrink
AYCAS	africas
AYCBVRN	ayckbourn
AYCYRV	ayckbourn
AYDA	ayda
AYDA	ayda
AYDAN	adan
AYDMN	andaman
AYDNBVRG	vandenburgh
AYD	ayda
AYDS	ayyubids
AYDVAYSVZ	aidas
AYDVRY	audrey
AYDYD	aidid
AYDY	addy
AY	amy
AYF	afif
AYFJH	ajax
AYFJ	baefje
AYFVFL	baffle
AYFV	adolfo
AYGAN	aegean
AYGLASTVN	eaglestone
AYGLSTVN	eaglestone
AYGLV	agali
AYGLY	agali
AYGRT	adgeringelant
AYGRTVN	baumgartner
AYGV	ayling
AYGVR	auger
AYJH	ajax
AYJLSTVN	alston
AYJVYN	ajlun
AYK	aycock
AYKAM	akademik
AYKARVS	ankaras
AYKBRN	ayckbourn
AYKBVRN	ayckbourn
AYKH	akilah
AYKLVZAN	auckland
AYKN	ayckbourn
AYKVK	waikiki
AYLANA	alana
AYLAN	alan
AYLKA	walka
AYLMYN	alcmena
AYLPV	alpo
AYLR	aylor
AYLSA	ailsa
AYLTH	walth
AYLVARD	aylward
AYLVR	aylor
AYLVT	aylott
AYLVT	aylott
AYLVYZA	alzena
AYLYA	alya
AYLYDYV	aylward
AYLYN	ayling
AYLYN	ayling
AYLYN	ayling
AYLYNG	ayling
AYLYN	ayling
AYLYS	alyces
AYLYS	alyces
AYLZ	allyz
AYM	ayman
AYMAN	ayman
AYMAN	ayman
AYMANTZ	umanetz
AYMAR	aymara
'AYMN	eamon
AYMN	ayman
AYMN	ayman
AYMRY	amery
AYMVN	ayman
AYMY	amy
AYNAC	anzac
AYN	ayn
AYNA	abyssinia
AYNANA	ananda
AYNAN	abyssinian
AYNARYNV	eannarino
AYNAT	anant
AYN	ayn
AYNAYN	abyssinian
AYNC	anchi
AYNDALYS	andalusia
AYNDAYRSN	andersen
AYNDRA	andra
AYNDRAJYT	indrajit
AYNDRANYL	indranil
AYNDRLY	mandrell
AYNDSVRS	landsteiners
AYNDVY	andy
AYNGALZ	anglicize
AYNG	ayling
AYNG	ayling
AYNG	ayling
AYNGLD	langland
AYNGLF	angle
AYNGL	angel
AYNGLS	angels
AYNGLYS	angles
AYNGLYS	angles
AYNGMAR	ingmar
AYNGMAR	ingmar
AYNGRAHAM	ingraham
AYNGRAM	anagram
AYNGRM	anagram
AYNGRSVL	ingresole
AYNGRYA	angara
AYNGRYD	dangerfield
AYNGRYSL	ingresole
AYNGRYSVL	ingresole
AYNGVAR	angara
AYNGYJD	ahmadinejad
AYNHV	anchi
AYNJH	anoosh
AYNJJNRY	anniversary
AYNKH	aniakchak
AYNKVGNYTA	incognita
AYNLY	ainley
AYNMN	andaman
AYNR	acuner
AYNS	aryans
AYNS	aryans
AYNSR	ainsaar
AYNT	aint
AYNTAYR	anntar
AYNT	aint
AYNTH	anthea
AYNTJ	ariaantje
AYNTJH	antioch
AYNTLSAT	intelsat
AYNTRNT	armontrout
AYNTRNT	armontrout
AYNVKSN	anakin
AYNVN	abyssinian
AYNVSNT	jansenist
AYNYSA	ainissa
AYNZ	alonzo
AYNZHNRY	inzhenery
AYNZ	alonzo
AYNZ	alonzo
AYPRSVN	aperson
AYPRT	alpert
AYR	ayers
AYRARDY	earnhardt
AYRAY	airay
AYRBYD	archibald
AYRD	aylward
AYRDV	aylward
AYR	ayers
AYR	ayers
AYRLAYNZ	americanize
AYRL	aral
AYRLND	garland
AYRNST	earnest
AYRNVT	arnot
AYRP	earp
AYRS	ayers
AYRVN	assyrian
AYRVN	assyrian
AYRVNSVN	aronson
AYRVVD	ayurveda
AYRVYNG	arling
AYRVYN	aryan
AYRVYN	aryan
AYRVYYN	aureomycin
AYRY	abery
AYRYK	ark
AYRYS	ayres
AYRYZARY	irizarry
AYRZ	ariz
'AYSA	walesa
AYSA	alyssa
'AYSA	walesa
AYSA	alyssa
AYS	amys
AYSA	alyssa
AYSAK	adisak
AYSAK	adisak
AYSAKS	nagasakis
AYSAMA	aissama
AYSAN	abyssinian
AYSASK	alyssas
AYSBL	asbell
AYSFALZ	parsifal
'AYSH	wash
AYSH	ayush
'AYSH	wash
AYSH	ayush
AYS	amys
AYSKANDR	iskander
AYSK	ask
AYSLT	austerlitz
AYSLYK	eastlake
AYSMAN	eastman
AYSMN	eastman
AYSNSTAT	aisenstat
AYSPVRT	alpert
AYSRAT	abstract
AYSRT	abstract
AYSRT	abstract
AYSTBRN	eastburn
AYSTLND	eastland
AYSTMAS	austrias
AYSTMN	eastman
AYSTMVS	amsterdams
AYSTRAGV	castlereagh
AYSTRBRVK	easterbrook
AYSTR	aster
AYSTR	aster
AYSTVVD	astrid
AYSTVY	astley
AYSTYK	astik
AYSTYN	augustyn
AYSVN	ayson
AYSVN	ayson
AYSY	ayse
AYSYZAKY	kasprzak
AYT	amyot
AYT	amyot
AYTAMAR	austhamaren
AYTCV	aitcho
AYTCVN	atchison
AYTH	alioth
AYTH	alioth
AYTJ	aetje
AYTJ	aetje
AYTJY	aetje
AYTKN	aitken
AYTR	atri
AYTSN	aitsen
AYVA	ayurveda
AYVALD	aguinaldo
AYVANZ	americanize
AYVAR	aylward
AYVAYNG	americanizing
AYVGNH	walpurgisnacht
AYV	ayurveda
AYVJNH	avinash
AYVLYN	ayling
AYVND	abend
AYVNS	alysons
AYVRS	ayers
AYVRSVN	amerson
AYVRY	avery
AYVS	ayers
AYVS	ayers
AYVSTYS	avestas
AYVSV	ayuso
AYVSYN	ayson
AYVTYK	astik
AYVYN	aoyoun
AYZAK	ganzak
AYZAKSVN	kazakhstan
AYZCYL	azazel
AYZDY	azad
AYZ	allyz
AYZL	afzal
AYZMN	saltzman
AYZRVDA	ayurveda
AYZV	allyz
AZAD	azad
AZALYA	azalea
AZALY	azalea
AZANA	azana
AZAR	azhar
AZBVRN	aberdeen
AZCYL	azazel
AZHR	azhar
AZLA	azlan
AZLN	azlan
AZR	azhar
AZVR	anzlovar
AZYCL	azazel
BAABAR	baabar
BAAFJ	baefje
BABA	baba
BABA	baba
BABAH	babah
BABAR	babar
BABAR	babar
BAB	baba
BAB	baba
BAB	baba
BABK	babak
BABK	babak
BABL	babel
BABR	babar
BABT	babitz
BABV	babu
BABVRAV	baburao
BABVSKYN	babushkin
BABY	babylon
BABY	babylon
BABY	babylon
BABYKV	babikow
BABYRL	barbarella
BABYTZ	babitz
BACALTR	buchalter
BACARAC	bacharach
BACAS	bacalls
BAC	bach
BACLDR	batchelder
BAD	badr
BAD	badr
BADKK	badcock
BADKVK	badcock
BADLVC	badeloch
BADMN	baderman
BADNYK	budnick
BADR	badr
BADRMN	baderman
BADRYK	badrick
BADVYN	bauduyn
BADVYYN	bauduyn
BADY	badry
BADYG	bandung
BADYN	bauduyn
BADYN	bauduyn
BADYNGTN	baldington
BADYNGTVN	baldington
BADYVN	bauduyn
BADZ	nebuchadnezzar
BADZYAK	budziak
BAFL	baffle
BAFY	beaufays
BAFY	beaufays
BAGA	bagga
BAGAM	baugham
BAGARLY	baggarly
BAGAY	baggarly
BAGDAN	bragdon
BAGHAM	baugham
BAGLY	bagley
BAGLY	bagley
BAGM	baugham
BAGSAV	bagshawe
BAGVLY	baguley
BAGYD	bagnold
BAGZ	baez
BAGZ	baez
BAHYH	bahaullah
BAJVA	bajwa
BAJYK	bialystok
BAKAR	baskar
BAKAS	backas
BAKAYA	bakaya
BAKLY	barkley
BAKNR	baker
BAKR	baker
BAKR	baker
BAKSKA	baskar
BAKSR	blacksher
BAKSY	bakos
BAKVM	bakkum
BAKVS	bakos
BAKY	bakaya
BAKYR	baker
BALAK	abdalmalik
BALANDR	balendra
BALANS	balkans
BALARD	ballard
BALARY	balarie
BALAS	balash
BALAST	ballast
BAL	baal
BAL	baal
BALBYR	balbir
BALCVNAS	balchunas
BALD	bald
BALDRD	baldred
BALDVR	balder
BALDYNGTN	baldington
BALDYNGTVN	baldington
BALFNZ	balfanz
BALGA	baliga
BALHAM	balham
BALKA	balkan
BALKVSKY	bulkowski
BALMA	balma
BALMASDA	balmaseda
BALMR	balmer
BALNDRA	balendra
BALNY	balleny
BALSAM	balsam
BALSARA	bulsara
BALSK	basilisk
BALSLY	balsley
BALSVN	balson
BALTAKS	baltais
BALTAYS	baltais
BALTAZAR	balthazar
BALTZL	baltzell
BALV	bale
BALY	bally
BALYGA	baliga
BALYK	bialystok
BALYN	balin
BALYN	balin
BALYSTYK	bialystok
BALYT	bialystok
BAMBRGR	baumberger
BAMN	barman
BAMSV	bamse
BANA	banan
BANABYV	barnaby
BAN	bain
BAN	bain
BAND	bandi
BANDD	banded
BANDYRDY	bandireddi
BANDZ	bandi
BANGARTZ	bongarts
BANG	bang
BANGRZ	bangor
BANKLR	bankler
BANKRAFT	bancroft
BANKRVFT	bancroft
BANKS	banks
BANKVALA	bankwalla
BANL	banjul
BANR	bangor
BANTVN	banton
BANTY	blantyre
BANTYNG	banting
BANY	bandy
BANY	bandy
BANY	bandy
BANYTA	blanstan
BANYTV	bantu
BANYVRA	balendra
BAP	baptist
BAPTYSTA	baptista
BAPTYST	baptist
BARAKVTA	barracouta
BARAS	barash
BARASV	barash
BARAT	barath
BARBAGALV	barbagallo
BAR	bar
BARBAS	barbas
BARBR	barber
BARBVRAK	barborak
BARBVR	barber
BARBY	barbary
BARD	bard
BARDVLVMZ	bardell
BARDYK	beardsley
BARF	barff
BARFRD	barford
BARFVRD	barford
BARFYT	bancroft
BARG	bargh
BARGS	bargus
BARGVS	bargus
BARH	bargh
BARJYL	bargiel
BARKALV	barksdale
BARKASFYLD	barksfield
BARKAY	barkai
BARK	bark
BARKLY	barkley
BARKRAFT	barcroft
BARKR	barker
BARKSDYLY	barksdale
BARKSFYLD	barksfield
BARKVLV	barkell
BARKVS	barkus
BARLAS	barlas
BARL	baral
BARL	baral
BARLV	barlow
BARNABY	barnaby
BARNAM	barnum
BARNARD	barnard
BARNAS	barnas
BARN	barn
BARND	barend
BARNSA	barnshaw
BARNSAV	barnshaw
BARNSV	barnas
BARNT	barnett
BARNY	barney
BARNYK	baronick
BARQARD	barnard
BARS	barrs
BARSY	beardsley
BARTA	barta
BART	bart
BART	bart
BARTHVLVMYVS	bartholomeus
BARTK	bartok
BARTKVR	barthakur
BARTL	bartle
BARTL	bartle
BARTLMAS	bartelmus
BARTLMVS	bartelmus
BARTLT	bartelt
BARTLT	bartelt
BARTLY	bartley
BARTMVS	bartelmus
BARTN	barton
BARTN	barton
BARTVK	bartok
BARTVLVMVS	bartelmus
BARTVLVMYVS	bartholomeus
BARTVLYNY	bartolini
BARTVN	barton
BARTVNYKV	baryshnikov
BARTY	bartley
BARTY	bartley
BARTYH	barth
BARTYS	barents
BARTZ	bartz
BARVA	barua
BARVC	barich
BARVN	baron
BARVN	baron
BARVNS	barents
BARVNYA	baronia
BARVZ	bartz
BARYAKS	baracks
BARY	badry
BARY	badry
BARY	badry
BARY	badry
BARYNGR	barringer
BARYNGTN	barrington
BARYNGTVN	barrington
BARYS	barneys
BASA	basha
BAS	bas
BAS	bas
BASKAR	baskar
BASKRVYL	baskerville
BASKY	blavatsky
BASL	basel
BASMA	basma
BASN	basin
BASR	basir
BASSA	bassam
BASSN	basson
BASTARD	bastard
BAST	basit
BASTYK	bialystok
BASTYLVS	bastilles
BASTYN	bastien
BASTYN	bastien
BASTYN	bastien
BASTYVN	bastien
BASVAL	barksdale
BASV	basu
BASV	basu
BASVM	basem
BASYL	basel
BASYLYKA	basilica
BASYLYSK	basilisk
BASYLYVS	beasleys
BASYN	basin
BATALS	baals
BATAN	bataan
BAT	bat
BATL	batel
BATLR	batchelder
BATNAT	bratina
BATN	banton
BATRA	batra
BATRBY	batterbee
BATRS	baxters
BATRSS	waterss
BATRST	bathurst
BATRVRS	basseterres
BATRYS	beatrixs
BATRZ	beatriz
BATY	bartley
BATYL	batel
BATYNG	banting
BAVA	bavaria
BAV	bravo
BAVCMP	basecamp
BAVDN	baudin
BAVDN	baudin
BAVDVYYN	bauduyn
BAVDYN	bauduyn
BAVDYN	bauduyn
BAVDYSYN	baudissin
BAVGMN	baughman
BAVKAM	baikal
BAVKVS	baukus
BAVM	baum
BAVMGARTNR	baumgartner
BAVPRS	baupres
BAVRY	badry
BAVS	beavis
BAVYZ	baez
BAXVM	baucom
BAYARD	bayard
BAY	bray
BAYDA	bayda
BAYDN	baudin
BAYFYLD	bakersfield
BAYKRASTAF	bickerstaffe
BAYKRZTAF	bickerstaffe
BAYLA	bayla
BAYLS	baylors
BAYLY	bayly
BAYLYNGSLY	billingsley
BAYLYNGTVN	baldington
BAYLYV	bayly
BAYLZ	balzac
BAYNVN	bayonne
BAYPRT	bonaparte
BAYR	bayer
BAYRD	bayard
BAYRN	bayern
BAYRN	bayern
BAYRTAY	barta
BAYRTYH	bayreuth
BAYRVN	bayern
BAYSVT	bialystok
BAYZ	baez
BAZBY	buzby
BAZBY	buzby
BAZT	bazett
BBKAK	babak
BBYT	babitz
BCLDR	batchelder
BCLR	bachelor
BDAL	bdale
'BDALH	abdalrahman
'BDALLH	abdullah
'BDALRHMAN	abdalrahman
'BDALRHMAN	abdalrahman
'BDALRHMN	abdalrahman
'BDALRHMN	abdalrahman
'BDAL'ZYR	abdalrahman
'BDAL'ZYZ	abdulaziz
'BDHBY	abudhabi
BDKK	bekki
BDKVK	bekki
'BDL	abdul
BDLAK	abdalmalik
BDL	bdale
BDLVC	badeloch
'BDL'ZYZ	abdulaziz
BDMY	badami
BDNAR	bednar
BDRK	badrak
BDRYK	badrick
'BDVAL'ZYZ	abdulaziz
'BDVL	abdul
'BDVLRHMN	abdulrahman
BDYN	bauduyn
BDYRA	bdira
BDYR	badir
BFJ	baefje
BGDAD	baghdad
BGLY	bagley
BGNVLD	bagnold
BGVYL	bagwill
BGYR	badger
BHAMND	bahamonde
BHARA	behara
BHNAM	behnam
BHRV	bahro
BHST	baathist
BHYJA	bahija
BJLY	banjul
BKA	benka
BKAR	baskar
BK	bk
BK	bk
BK	bk
BKDVR	backdoor
BKHVRST	backhurst
BKMN	backman
BKMN	backman
BKMYR	beckmeyer
BKR	baker
BKR	baker
BKR	baker
BKR	baker
BKS	bks
BKT	becket
BKVA	benka
BKVF	backof
BKVK	bangkok
BKVY	bekesy
BKVYT	bakelite
BKVYYR	beckmeyer
BKY	becky
BKY	becky
BKYNGSAL	beckingsale
BKYNGSL	beckingsale
BKYNGSYL	beckingsale
BKYR	beckmeyer
BKYS	beckys
BLA	bela
BLAC	balzac
BLAF	blackfoot
BLAFS	blackfoots
BLAHA	blaha
BLAK	black
BLAKSVM	blacks
BLALAK	blalock
BLAL	blal
BLAL	blal
BLAM	balham
BLAMKH	blacksher
BLAMY	bellamy
BLANCARD	blanchard
BLANCH	blanche
BLANSDAN	blanstan
BLANSDN	blunsdon
BLANSTAN	blanstan
BLANZDVN	blunsdon
BLAS	blas
BLASDN	blunsdon
BLASK	blask
BLASR	blacksher
BLASY	blavatsky
BLASYVS	blasius
BLAVADNYK	blavatnik
BLAVYZ	blaz
BLAYT	blatt
BLAZ	blaz
BLAZK	blazek
BLAZKYYVZ	blazquez
BL	blu
BLDN	bolden
BLDRD	baldred
BLDVYJN	boldwijn
BLDVYN	baldwin
BLDVYYN	baldwin
BLDYNG	belding
BLDYNGTVN	baldington
BLGA	baliga
BLKA	balkan
BLK	black
BLKLND	blokland
BLKLY	blackley
BLKMN	blackman
BLKMN	blackman
BLKSVM	bolshevism
BLKSYR	blacksher
BLKVL	blackwell
BLNK	blank
BLNKHVRN	blenkhorn
BLNKV	bliznakov
BLNKY	belenky
BLS	blas
BLTBRG	blattberg
BLTRAV	beltrao
BLV	blvd
BLVC	bloch
BLVHM	blohm
BLVKSVM	bolshevism
BLVM	blom
BLVMBRG	bloomberg
BLVMN	blumen
BLVMNFLD	blumenfeld
BLVNSDVM	blunsdon
BLVNSDVN	blunsdon
BLVNZDM	blenheim
BLVRNJ	blorenge
BLVSKVM	bolshevism
BLVYN	boleyn
BLVZ	blitz
BLVZVM	boltzmann
BLYK	bialystok
BLYK	bialystok
BLYN	boleyn
BLYN	boleyn
BLYNDA	belinda
BLYNGASLY	billingsley
BLYNGTN	baldington
BLYNKV	bliznakov
BLYNKV	bliznakov
BLYNKVV	bliznakov
BLYR	blantyre
BLYSTVN	blystone
BLYTA	blatta
BLYVYS	blyweiss
BLYZ	blitz
BNAKSY	bernankes
BNAMAR	benamar
BNAN	banan
BNARY	benari
BN	ben
BNDANG	bandung
BNDASTVN	bandstone
BNDK	bendek
BNDLY	bandali
BNDR	bender
BNDRVB	banderob
BNDY	bandy
BNG	bang
BNG	bang
BNG	bang
BNGT	bengt
BNH	bench
BNJYMAN	benjiman
BNKR	banker
BNKR	banker
BNKS	banks
BNR	bonar
BNS	bens
BNSN	bensen
BNSN	bensen
BNSVN	bensen
BNT	bantu
BNT	bantu
BNT	bantu
BNTLY	bentley
BNTN	banton
BNTN	banton
BNTV	bantu
BNTVN	banton
BNTZ	bentz
BNTZ	bentz
BNYA	baniya
BNYAMYN	beniamin
BNYFASYVS	bonifacius
BNYN	bunyan
BNZ	benz
BNZN	benzene
BQYR	baqir
BRABANT	brabant
BRABY	barnaby
BRACMN	brachman
BRAD	brad
BRAD	brad
BRADLY	bradly
BRADR	bradbury
BRADRTN	bradstreet
BRADRTVN	bradstreet
BRADSAV	bradshaw
BRADY	brady
BRADYS	bradlys
BRAFVRD	bradford
BRAGHAM	brigham
BRAHAM	braham
BRAHYM	brahim
BRAK	brake
BRAKLY	beakley
BRAKNY	brackney
BRAMBAV	brumbaugh
BRAM	bram
BRAMR	brahmaputra
BRAN	bran
BRAN	bran
BRAN	bran
BRANDL	brandel
BRANDY	brandy
BRANN	bormann
BRANSAV	branshaw
BRANSDVN	brunsdon
BRANSKVMB	branscombe
BRANSVYK	baranowski
BRANT	brant
BRANT	brant
BRARDY	berardi
BRASARD	brassard
BRASAYR	brassard
BRASRZ	bradstreet
BRASYRZ	brashers
BRAT	brat
BRATLT	bratlie
BRATR	brater
BRATYNA	bratina
BRAVN	braverman
BRAVN	braverman
BRAVNFYLD	brownfield
BRAVNR	brandenburg
BRAVNYNG	brandenburg
BRAVTVN	bratina
BRAVV	bravo
BRAVYC	branch
BRAYAN	barbadian
BRAY	bray
BRAYD	brad
BRAYN	brain
BRAYNKLR	brinkler
BRAYR	brar
BRAYS	brays
BRAYS	brays
BRAYSLAV	bratislava
BRAYSVN	banjarmasin
BRAYT	brat
BRAYTN	bratina
BRAYTVN	bratina
BRAYTVYT	braithwaite
BRAZVN	brazelton
BR	br
BRBVR	barber
BRCA	brejcha
BRCR	brecher
BRD	bard
BRD	bard
BRDLY	bradly
BRDLY	bradly
BRDLY	bradly
BRDN	borden
BRDN	borden
BRDN	borden
BRDSANG	birdsong
BRDSAV	bradshaw
BRDY	brady
BRDYK	burdick
BRDYT	bridget
BRFVRD	barford
BRGANTY	briganti
BRGARD	burgaard
BRGAYLV	borgailo
BRG	berg
BRG	berg
BRGDAN	burgundian
BRGLAND	berglund
BRGL	bergel
BRGMN	bergman
BRGR	berger
BRGS	borgs
BRGS	borgs
BRGSVN	bergson
BRGYVT	bergeot
BRHAN	burhan
BRJ	brij
BRKAH	barkah
BRKASPYR	breakspear
BRKAT	barakat
BRKAT	barakat
BRK	bark
BRK	bark
BRK	bark
BRKLY	barkley
BRKSFYLD	barksfield
BRKT	barakat
BRKVL	barkell
BRKVVYC	berkeley
BRKY	berkey
BRLACR	gibraltar
BRL	burl
BRLND	borland
BRLSVN	burleson
BRLV	berislav
BRLYN	brooklyn
BRLYNG	burling
BRLYNG	burling
BRML	bermel
BRMN	barman
BRMN	barman
BRNADVS	bernadus
BRNAL	bernal
BRNAN	brendan
BRNARD	barnard
BRNARD	barnard
BRNARDV	bernardi
BRNARDY	bernardi
BRNARDYN	bernardin
BRNARDZ	bernardi
BRNCAVD	branchaud
BRNC	branch
BRNCLY	brenchley
BRNDAN	brendan
BRND	bernd
BRND	bernd
BRND	bernd
BRNDL	brandel
BRNDL	brandel
BRNDS	berends
BRNDVN	branden
BRNDY	brandy
BRNDY	brandy
BRNDYS	brandys
BRNHARD	bernhard
BRNHART	barnhart
BRNHR	bernher
BRNR	bruner
BRNSAV	barnshaw
BRNSV	brownsville
BRNT	bernt
BRNT	bernt
BRNT	bernt
BRNV	brezhnev
BRNVL	brownsville
BRNY	barney
BRNY	barney
BRNYR	bruner
BRNZ	benz
BRQ	braque
BRSAV	berislav
BRS	brs
BRSFVRD	beresford
BRSLAV	berislav
BRSLR	bresler
BRSMN	bressman
BRSVN	bryson
BRSY	birdseye
BRT	bart
BRTLSVN	bertelson
BRTN	barton
BRTRAND	bertrand
BRTR	brater
BRTS	berts
BRTVN	barton
BRTVN	barton
BRTVN	barton
BRTY	bruty
BRTY	bruty
BRTYH	barth
BRVANHAT	branshaw
BRVARK	browarek
BRVDA	broda
BRVD	brod
BRVDFYLD	broadfield
BRVDHAST	broadhurst
BRVDLY	bradly
BRVDR	broder
BRVDRTVN	bridgetown
BRVHL	brohl
BRVKAV	brokaw
BRVK	brevik
BRVK	brevik
BRVK	brevik
BRVK	brevik
BRVKN	broken
BRVKNR	bruckner
BRVKR	brinker
BRVKS	brocks
BRVKSL	barksdale
BRVKVL	barkell
BRVKZ	brevik
BRVMBRG	bromberg
BRVMBRGR	bromberger
BRVMFYLD	brumfield
BRVMLY	bromley
BRVMYJ	bromery
BRVNL	brindle
BRVNR	bruner
BRVNVYYN	brunwin
BRVNYYV	britney
BRVR	braverman
BRVSRD	beresford
BRVSTR	brewster
BRVSYAV	berislav
BRVTY	bruty
BRVTZMN	brutzman
BRVVR	braverman
BRVYK	brevik
BRVYLV	beryl
BRVYN	bruyn
BRVYNS	bryons
BRVYNYNG	browning
BRVYR	breyer
BRVYR	breyer
BRVZ	broz
BRXARD	barnard
BRYAN	bryan
BRYAN	bryan
BRYANT	bryant
BRY	bray
BRY	bray
BRY	bray
BRY	bray
BRYBR	briber
BRY	bray
BRY	bray
BRYDLAV	breedlove
BRYDVL	bridalveil
BRYDY	bryde
BRYDYNG	breeding
BRYGVY	bryguy
BRYJ	brij
BRYJ	brij
BRYJMN	bremen
BRYKASPYR	breakespear
BRYKSPYR	breakspear
BRYL	beryl
BRYM	barrymore
BRYMR	barrymore
BRYMSTVN	brimstone
BRYN	bryn
BRYN	bryn
BRYNDAN	brendan
BRYND	brind
BRYNDL	brindle
BRYNGARDNR	bringardner
BRYNGTN	barrington
BRYNGTVN	barrington
BRYNK	baryshnikov
BRYNKMN	brinkman
BRYNR	bryner
BRYNSN	brinson
BRYR	breyer
BRYR	breyer
BRYS	brays
BRYS	brays
BRYSBYN	brisbin
BRYSBYN	brisbin
BRYSNV	baryshnikov
BRYSTVL	bristol
BRYSYNDA	brisinda
BRYTA	brita
BRYT	bryant
BRYTLYNG	breitling
BRYTV	bryant
BRYTVN	breton
BRYTYS	britneys
BRYVN	bryon
BRYVNY	bryony
BRYVR	breyer
BRYVRY	brewery
BRYYKPR	breakspear
BRYYTVN	breton
BRYZA	bereza
BRZA	bereza
BSAK	bosak
BSAM	besam
BS	bs
BSBRYS	besbris
BSKT	baskett
BSKV	besko
BSL	basel
BSMA	basma
BSMY	basem
BST	best
BSVAL	boswall
BSVL	basel
BSVN	basin
BSYL	basel
BSYM	basem
BSYRA	basira
BSYT	basit
BTAN	bataan
BTCLDR	batchelder
BTHVN	beethoven
BTL	batel
BTMN	batman
BTRYS	butrus
BTSY	betsy
BTVL	batel
BTY	betty
BTY	betty
BTYG	bettig
BTYYV	battey
BTZA	betza
BVALY	bally
BVAS	bavarias
BVAY	bovary
BVAY	bovary
BVAYVYN	bauduyn
BV	bev
BVBY	bobby
BVBYS	bobbys
BVCA	bianca
BVCA	bianca
BVC	bic
BVCGA	boschga
BVDA	beda
BVDA	beda
BVDAPATY	bodapati
BVDAR	bednar
BVD	blvd
BVD	blvd
BVD	blvd
'BVDHABY	abudhabi
BVDLA	bodla
BVDN	biden
BVDN	biden
BVDNMYLR	bodenmiller
BVDRA	bdira
BVDRV	budur
BVDV	blvd
BVDVR	budur
BVDVYN	bauduyn
BVDY	buddy
BVDYVN	bauduyn
BVDYVYN	bauduyn
BVFALV	buffalo
BVGARD	bogaard
BVGHAM	baugham
BVGS	bugs
BVHL	buhl
BVHR	bohr
BVJY	boije
BVKL	bokel
BVKL	bokel
BVKLY	beakley
BVKR	boker
BVKSY	bekesy
BVKVN	bockoven
BVLA	bela
BVLARD	bullard
BVL	beverly
BVLDN	bolden
BVLDT	boldt
BVLDVYJN	boldwijn
BVLDZR	bulldozer
BVLF	bolef
BVLN	bolen
BVLR	beeler
BVLR	beeler
BVLTAN	beltane
BVLTN	bolton
BVLTVN	bolton
BVLV	belvin
BVLVC	bloch
BVLVS	bolivars
BVLVYJN	boldwijn
BVLYNG	belding
BVMBR	bomber
BVMBRGR	bomberger
BVM	bum
BVMGARDNR	bumgardner
BVMHARD	bomhard
BVMN	braverman
BVNANDR	bonander
BVNAR	bonar
BVNAVGLYA	bonavoglia
BVN	bevan
BVN	bevan
BVNGARD	bongard
BVNSTRA	boonstra
BVNTN	benten
BVNVMV	bonomo
BVNVNV	bonaventure
BVNY	benny
BVNYFASS	bonifacius
BVNYFASYVS	bonifacius
BVNYFKYVS	brinkleys
BVNYFYSS	bernayss
BVNYN	bunyan
BVNYTZ	bonitz
BVQAM	beqaa
BVRA	bavaria
BVRAD	brad
BVRAP	brampton
BVRASCY	buraschi
BVR	beaver
BVRCRT	borchert
BVRDR	border
BVRDYK	burdick
BVRGA	borgia
BVRG	berg
BVRGV	beveridge
BVRGYVYS	burgoynes
BVRJYA	brejcha
BVRKVAL	barksdale
BVRKVL	berkeley
BVRKVYL	boerkoel
BVRKY	berkey
BVRL	beverly
BVRL	beverly
BVRLN	berlin
BVRM	borm
BVRML	bermel
BVRMN	braverman
BVRSL	bursell
BVRST	borst
BVRSYR	berster
BVRVS	bavarias
BVRYJ	brij
BVRYL	beryl
BVRYLLV	brillo
BVRYS	bovarys
BVRYVN	bryon
BVRYZ	bereza
BVRZ	bereza
BVSA	busa
BVSAL	boswall
BVSART	bossart
BVSARV	bulsari
BVSAYSN	boshuysen
BVS	beavis
BVS	beavis
BVS	beavis
BVS	beavis
BVS	beavis
BVS	beavis
BVSCA	biscay
BVSCGA	boschga
BVSGA	boschga
BVSKA	bocska
BVSK	blavatsky
BVSLY	bosley
BVSNL	bushnell
BVSNY	bosnia
BVSTAK	bostak
BVSTAMNT	bustamante
BVST	best
BVSTRAM	bostrom
BVSTRVM	bostrom
BVSTVN	boston
BVSTYK	bostak
BVSVAL	boswall
BVSVL	bessel
BVSVM	bolshevism
BVSVN	bensen
BVSVR	boisvert
BVSVYSN	boshuysen
BVSY	blavatsky
BVSY	blavatsky
BVSYK	blavatsky
BVSYSN	boshuysen
BVSYVYSN	boshuysen
BVTARY	botari
BVTAYS	butaysh
BVT	boisvert
BVT	boisvert
BVTCR	butcher
BVTLR	butler
BVTRL	bottrell
BVTRS	butrus
BVTSYH	british
BVTVN	beethoven
BVTZ	bitz
BVVDVYN	bauduyn
BVVN	bevan
BVVY	bovary
BVXNY	bodony
BVY	bovary
BVYKV	boyko
BVYLN	boylan
BVYR	beyer
BVYRKVYL	boerkoel
BVYS	bovarys
BVYS	bovarys
BVYSVYKS	bolsheviks
BVYSYV	bovarys
BVYVN	bruyn
BVYZY	buzby
BVZANCYV	bozeman
BVZ	baez
BVZKART	bozkurt
BVZMAN	bozeman
BVZVA	bozuwa
BVZVAL	brazzaville
BVZVVA	bozuwa
BVZVVYL	beuzeville
BVZYDAR	bozhidar
BVZYD	bouzid
BYAKV	bliznakov
BYAN	bryan
BYANG	bang
BYANGTAY	byungtae
BYATLYNG	beutling
BYAVYS	beasleys
BY	beyl
BYBL	byblos
BYBR	buber
BYCAM	beacham
BYC	bryce
BYCLY	beachley
BYCMP	basecamp
BYCYNGSYL	beckingsale
BYCZ	byzantine
BYDA	bayda
BYDL	bodla
'BYD	abend
BYDV	bryde
BYDVL	bridalveil
BYDY	bryde
BYF	byfield
BYFJH	baefje
BYFRAST	bifrost
BYG	byung
BYGLHL	beaglehole
BYGND	bigend
BYGNVALD	bigenwald
BYGV	bryguy
BYGVRDAN	bigourdan
BYGZ	benghazi
BYHAN	beyhan
BYHYV	baryshnikov
BYJ	brij
BYJH	brejcha
BYKA	benka
BYKARD	burkhard
BYK	boyko
BYK	boyko
BYK	boyko
BYK	boyko
BYKLY	beakley
BYKN	broken
BYKNST	bakeneset
BYKRASTAF	bickerstaffe
BYKRASTAFY	bickerstaffe
BYKRASTF	bickerstaffe
BYKRASTYF	bickerstaffe
BYKR	boker
BYKRSTF	bickerstaffe
BYKRTN	bickerton
BYKSLR	buckser
BYKVL	bokel
BYKVN	bockoven
BYLAL	bilal
BYLANY	billany
BYL	beyl
BYL	beyl
BYL	beyl
BYLHAR	bilhar
BYLKY	belenky
BYLNGTVN	billington
BYLR	byler
BYLR	byler
BYLR	byler
BYLS	byles
BYLV	boyle
BYLYKVK	bulkowski
BYLYNGASLAY	billingsley
BYLYNG	belding
BYLYNGSLY	billingsley
BYLYNGTVN	billington
BYLYNGZ	belding
BYLYNSKY	bilinsky
BYLYR	byler
BYLZ	belize
BYLZYBAB	beelzebub
BYMN	beaman
BYMYNG	beeming
BYN	bryn
BYN	bryn
BYN	bryn
BYN	bryn
BYNDMN	bindemann
BYNFNG	bienfang
BYNG	byung
BYNH	bench
BYNJN	benjamin
BYNMDART	bainmedart
BYNQAM	behnam
BYNR	bryner
BYNS	bryons
BYNS	bryons
BYNVD	benavides
BYNVY	bryony
BYNY	bryony
BYNY	bryony
BYNY	bryony
BYNYYVN	bynon
BYNZ	benz
BYNZ	benz
BYNZ	benz
BYPYN	bipin
BYRA	byra
BYR	byer
BYR	byer
BYR	byer
BYR	byer
BYR	byer
BYRBK	burbank
BYRC	byronic
BYRD	byrd
BYRD	byrd
BYRDMR	beardmore
BYRDN	borden
BYRFYS	bancrofts
BYRG	berg
BYRGL	bergel
BYRK	berk
BYRLA	berilla
BYRMN	berman
BYRNBVYM	birenboim
BYRN	byrne
BYRNH	bernher
BYRNS	byrnes
BYRTAY	brittany
BYRT	bayreuth
BYRTRYK	bartok
BYRTYH	bayreuth
BYRTYH	bayreuth
BYRVT	bayreuth
BYRYC	bryce
BYRYGANTY	briganti
BYRYNG	bering
BYRZ	bereza
BYSAYV	biscay
BYS	bayes
BYSH	butaysh
BYSKMP	basecamp
BYSL	bessel
BYSLY	bosley
BYSMARK	bismark
BYSM	besam
BYSR	bystander
BYSTANDR	bystander
BYST	bysouth
BYST	bysouth
BYSYN	bryson
BYTANKRT	bethancourt
BYTARD	bittard
BYT	blyth
BYT	blyth
BYTMN	brotman
BYTN	blystone
BYTRAYS	bertrams
BYTRYK	bialystok
BYTZ	bitz
BYVAN	bevan
BYV	byer
BYVCAMP	beauchamp
BYVCMP	beauchamp
BYVDVYN	bauduyn
BYVFYZ	balfanz
BYVGAM	brougham
BYVKMP	weikamp
BYVKRAFT	bickerstaffe
BYVLY	bayly
BYVLYV	bayly
BYVMNT	beaumont
BYVMVNT	beaumont
BYVNGS	byungse
BYVR	byer
BYVRLY	beverly
BYVRZ	bereza
BYVSH	butaysh
BYVTL	beetle
BYVYS	bovarys
BYVZVYL	beuzeville
BYYVCMP	beauchamp
BYYVNYK	baryshnikov
BYZ	byzantine
BYZR	bizer
BYZVANAT	byzantine
BYZVAS	byzantines
BYZVYL	beuzeville
BYZYR	bizer
BZVA	bozuwa
CAGN	cagney
CAKV	chacko
CALK	chalk
CAMBRLAYN	chamberlain
CAMPLYN	champlin
CAND	candy
CANDRAN	chandran
CANDR	chander
CANDVNYA	chandonia
CANSY	cains
CANY	candy
CAPLA	capella
CAPL	capella
CAPMN	chapman
CAPRA	capra
CAPYN	clapeyron
CARD	caird
CARLTN	carlton
CARLTVN	carlton
CARLVT	carlton
CARLY	carly
CARLYH	carly
CARLYN	carolyn
CARLZ	carlo
CARNG	charng
CARTVN	carlton
CARYK	clark
CAS	cas
CASMZ	chasms
CASTYN	cawston
CATANY	chaitanya
CAV	cave
CAVDA	chavda
CAVHAN	chauhan
CAVN	calvin
CAVVYN	carolyn
CAVVYV	cleavey
CAVZ	chavez
CAY	cary
CAYKN	chaiken
CAYLD	calder
CAYLDZ	valdez
CAYZ	cadiz
CH	che
CKRD	cakebread
CLATVN	clanton
CLYVS	carlys
CLYYAN	chelyabinsk
CMALY	chemaly
CMBRLYN	chamberlain
CMBRZ	chimborazo
CMBZY	chembezi
CNADR	chenader
CN	cain
CND	candy
CNDLR	chandler
CNSLVR	nestler
CNTH	chenteh
CNY	candy
CPDY	chopde
CPZ	cryptozoic
CRAG	craig
CRASKAYNT	nebraskan
CRBL	cherbel
CRC	circe
CRCYL	courcoul
CRPY	cherepy
CRSKYNAY	cristina
CRVBYNY	carbone
CRVYC	cryptozoic
CRY	cary
CRY	cary
CRYL	cheryl
CRYSKYNTY	chrescyntie
CRYSTAL	crystal
CRYSYNTH	chrescyntie
CSBRV	chesbro
CS	cs
CSNY	chesny
CSNY	chesny
CSTR	caster
CTAL	chetal
CT	cat
CTVYN	cathryn
CVA	chavda
CVA	chavda
CV	cave
CV	cave
CV	cave
CV	cave
CV	cave
CVDHARY	choudhary
CVKRY	conakry
CVKSY	chokshi
CVLKA	chwolka
CVN	calvin
CVNPYG	chunping
CVRN	chevron
CVSAK	chusak
CVVANAK	chovanak
CVY	chevy
CVY	chevy
 LR	alar
CYA	cayman
CYA	cayman
CYAKY	conakry
CYANG	chiang
CYBANSKY	cybanski
CY	coy
CY	coy
CYCSTR	chichester
CYK	cybanski
CYK	cybanski
CYK	cybanski
CYKN	chaiken
CYKRY	conakry
CYKY	chayefsky
CYKZ	elkowitz
CYLDZ	valdez
CYLT	celt
CYLTH	clotho
CYLTJ	celetje
CYLTJH	celetje
CYLY	chely
CYLYJH	elijah
CYLYNGVRS	challengers
CYLYNGVRT	chillingworth
CYM	cayman
CYN	coyne
CYN	coyne
CYNN	cayenne
CYNV	coyne
CYP	cyprian
CYP	cyprian
CYPLVYDN	schipluiden
CYPMN	cheapman
CYPN	cyprian
CYRAG	cybermage
CYRAK	cormack
CYSM	chrysostom
CYSMN	coisman
CYSTY	christy
CYSVLM	chisholm
CYTA	crystal
CYTAM	cheetham
CYTAN	chetan
CYT	cuneyt
CYT	cuneyt
CYTRDY	chitrady
CYTVVD	cheatwood
CYTVYN	clayton
CYTYK	chittick
CYV	clyde
CYV	clyde
CYZVBA	chizoba
CYZV	cryptozoic
CYZVRV	chizuru
DABAC	danubian
DABAS	debras
DABL	diaboli
DABNY	dabney
DABS	darbys
DABSVN	dawson
DABVS	danubes
DABVYS	darbys
DABYL	diaboli
DABYNSKY	dubinsky
DABYNSN	dobinson
DABYNSVN	dobinson
DABYNZ	dabin
DADA	dada
DAD	dada
DADGYVN	dudgeon
DADH	deadhead
DADK	dade
DADLY	dandler
DADS	dadas
D'A	dea
DADV	dade
DADYR	drader
DAF	darfur
DAGAN	dagan
DAGAN	dagan
DAG	dag
DAG	dag
DAG	dag
DAGLY	dagley
DAGN	dagan
DAGR	dalager
DAGRTY	daugherty
DAGRZ	daguerre
DAGVAC	dagan
DAGZ	dag
DAHAK	dahuk
DAHAML	duhamel
DAHN	daphne
DAHRTY	daugherty
DAHVD	deadhead
DAHVK	dahuk
DAJ	daatje
DAJ	daatje
DAJYVN	darjeeling
DAKAS	dakars
DAK	dakar
DAK	dakar
DAK	dakar
DAKHVRN	dockhorn
DAKLVZ	desalvo
DAKMN	dakin
DAKN	dakin
DAKRYNG	darling
DAKS	dakars
DAKS	dakars
DAKTRZ	datri
DAKV	dakin
DAKVRS	dakars
DAKYNG	dakin
DAKYNZ	dakin
DAKZ	dakin
DALAJR	dalager
DALAN	dalian
DALAS	dallas
DALAYR	dalager
DALBK	dalbec
DALBRGR	dulberger
DALBYR	dowaliby
DAL	dal
DAL	dal
DAL	dal
DALFR	dulfer
DALMN	dalmatian
DALMS	dalmatians
DALMYYA	dalmia
DALNZ	danz
DALRS	daimlers
DALRYMPL	dalrymple
DALTVN	dalton
DALY	daly
DALY	daly
DALY	daly
DALY	daly
DALYNAR	dolinar
DALYNGR	darling
DAMAR	dhamar
DAMBL	djamila
DAMLR	daimler
DAMPLTVN	dumpleton
DAMVN	damon
DAMVNTT	dumontet
DAMYAN	damian
DAMYANV	damiano
DAMYLA	djamila
DAMYNGS	demings
DAMYNY	damiano
DAMYNYKAS	diamantaras
DAMYTRV	diamantaras
DAMYVN	damien
DANA	dana
DANALD	danald
DANA	dana
DANAVAN	devanathan
DAN	dan
DANDAS	dundas
DAN	dan
DAN	dan
DAN	dan
DANDY	dandler
DANFRD	dunford
DANFY	dangerfield
DANG	dangel
DANG	dangel
DANGTAY	dongtai
DANGVY	dangoor
DANGYV	dangoor
DANGYVN	darlington
DANHAM	denham
DANH	danih
DANJL	dangel
DANKAN	danekind
DANKV	danko
DANKV	danko
DANKY	danko
DANLVP	danilo
DANLY	danilo
DANNBARGR	danenbarger
DANNLY	danny
DANR	dancer
DANSMVR	dinsmoor
DANSTR	dunster
DANSY	danas
DANSYNG	dancing
DANTN	danton
DANVAN	danubian
DANY	dancy
DANY	dancy
DANYDYN	dunedin
DANYL	dangel
DANYL	dangel
DANYL	dangel
DANYLSVN	danielson
DANYLV	danilo
DANYLZ	danilo
DANYS	dannys
DANYYLS	daniels
DANZ	danz
DAPAY	diaspora
DAPNYK	doupnik
DAPRK	draper
DAPRRY	darryl
DAPRY	draper
DARANG	darling
DARA	darla
DARBY	darby
DAR	dare
DARHAM	durham
DARL	darla
DARLY	darley
DARLYNGTN	darlington
DARNAL	darnall
DARNL	darnall
DARNL	darnall
DART	dart
DARV	darvon
DARVN	darvon
DARYGVS	darrigues
DARYL	daryl
DAS	das
DAS	das
DASN	dawson
DASVN	dawson
DASYNG	daswani
DASYVK	gdansk
DAT	dart
DATH	darth
DATJH	daatje
DATRY	datri
DATSVN	dawson
DATVN	dalton
DATVYT	dartmouth
DATY	delikatny
DATY	delikatny
DAVAD	danald
DAVARK	delaware
DAVBR	dauber
DAVD	david
DAVD	david
DAVD	david
DAV	dave
DAV	dave
DAV	dave
DAVKNYZ	danz
DAVKYNZ	dakin
DAVN	darvon
DAVNPRT	davenport
DAVNY	dancy
DAVNYNG	dawning
DAVNYNG	dawning
DAVRS	daimlers
DAVRYN	daverin
DAVSAN	daswani
DAVS	daves
DAVSN	davison
DAVSVN	davison
DAVT	davenport
DAVVD	david
DAVVD	david
DAYAL	danial
DAYAN	dalian
DAYAN	dalian
DAYANYSYA	dalians
DAYANYSYS	dardanelless
DAYAZ	duchaylard
DAYBALA	dyballa
DAYBL	diaboli
DAYCYNC	dacron
DAY	day
DAY	day
DAYDRYC	dandridge
DAY	day
DAYK	dahuk
DAYKSVN	dawson
DAYKY	dakin
DAYKYNK	duyckinck
DAYKYNZ	dakin
DAYLAYGAN	dalmatian
DAYLVN	dailene
DAYMND	diamond
DAYN	dayton
DAYN	dayton
DAYR	dayr
DAYRDRYK	dierderick
DAYR	dayr
DAYRKTVR	dartmoor
DAYRT	dart
DAYS	daleys
DAYT	dayton
DAYVD	david
DAYVRJH	darth
DAYVRJH	darth
DAYVRT	davenport
DAYVRTH	darth
DAYVRTJ	dievertje
DAYVRTJ	dievertje
DAYVRYA	dauria
DAYVVN	dayton
DAYVYN	dayton
DBATVNYA	debathonia
DBLR	deibler
DBYT	delbert
DDFYLD	deadfield
DDJN	goddijn
DDRYK	dedrick
DDY	dady
DFRVY	defroy
DGLY	dagley
DGRAF	degraff
DGRF	degraff
DGRLVND	degerlund
DGVTARDY	degotardi
DHA	doha
DHAMAR	dhamar
DHNR	dehner
DHNRT	dehnert
DHVK	dahuk
DJAMYLA	djamila
DJLY	djamila
DKAN	dekan
DKK	dekok
DKLRK	dunkirk
DKR	dakar
DKSTR	dikstra
DKYAH	zedekiah
DKY	dicky
DK	dik
DLAL	dalal
DLANY	delaney
DL	dal
DLH	delhi
DLMAN	dolman
DLNY	delaney
DLRD	dallard
DLRYV	dalrymple
DLTN	dalton
DLTVVYA	deltuvia
DLVRA	deloura
DLVRYZ	delacruz
DLVYS	daleys
DLY	daly
DLYKATNY	delikatny
DLYS	daleys
DLYSYV	daleys
DMA	dema
DMA	dema
DMKAK	demcak
DMKH	demke
DML	dehmel
DMLR	demler
DMN	damon
DMPSTR	dempster
DMR	delmar
DMRZ	dmitri
DMSQ	dimashq
DMYLA	djamila
DMYNYSVS	demostheness
DMYS	dahomeys
DNALD	danald
DNAQY	donaghy
DNAVLT	denault
DN	dan
DNDLR	dandler
DN	dan
DNDRYJ	dandridge
DNG	deng
DNHAM	denham
DNJVR	denver
DNKVALTR	denkewalter
DNKYND	danekind
DNL	danald
DNMN	denman
DNNL	dennell
DNRYJ	doonesbury
DNSR	dingsor
DNTVN	danton
DNV	denver
DNVKS	donetsks
DNYH	danih
DNYL	disneyland
DNYLZ	disneyland
DNYNG	dancing
DNYS	dannys
DNYSVN	dionysian
DRABK	drabek
DRADR	drader
DRAGAN	dragan
DRAGANYS	draganis
DRAGN	dragan
DRAGR	dragomir
DRAKMN	drukman
DRAL	dordal
DRALT	federalist
DRAMATYS	dramatis
DRAM	dream
DRAP	draper
DRAPR	draper
DRAST	federalist
DRATMN	dratman
DRATY	durante
DRAVN	dravidian
DRAVR	drader
DRAYNH	durrance
DRAYR	drader
DRBS	darbys
DRBY	darby
DRCMN	drachman
DRDH	dierderick
DRG	drag
DRGVMYR	dragomir
DRGVN	dragon
DRGVNS	dragons
DRK	dirk
DRKSL	dirks
DRMVT	dermott
DRNAL	darnall
DRNK	drnek
DRNTR	drenter
DRSNR	dressner
DRTCN	dortchen
DRTH	darth
DRV	darvon
DRV	darvon
DRVDYNG	druding
DRVDYS	dravidians
DRVMAND	drummond
DRVMR	dreamer
DRVNY	darvon
DRVNYS	dervenis
DRVR	drover
DRVT	drout
DRVYK	drevik
DRVYT	drout
DRVZN	dzerzhinsky
DRYDJY	dryden
DRYFVS	dreyfus
DRYJR	dreyer
DRYK	derek
DRYK	derek
DRYM	dalrymple
DRYMR	dreamer
DRYMZ	dalrymple
DRYNKS	drinks
DRYNZ	derienze
DRYR	dreyer
DRYRY	drury
DRYS	darbys
DRYSKVL	driskill
DRYSKYL	driskill
DRYV	dory
DRYV	dory
DRYVT	drout
DRYXA	dream
DS	ds
DSL	desle
DSMVLYNZ	desmoulins
DSMVND	desmond
DSMYT	desmet
DSNVYRZ	desnoyers
DSRAZYRS	desrosiers
DSRVZYRZ	desrosiers
DSTLY	distel
DSVTV	desoto
DTLFS	detlefs
DTMN	dettman
DTRYJ	dimitry
DTS	dots
DTVYLR	detweiler
DVA	davao
DVAK	dipak
DVALYBAY	dowaliby
DVAN	donovan
DVANYR	deaner
DVAR	edvard
DVARTH	darth
DVAYKYNK	duyckinck
DVBAY	dubay
DVBRATZ	dobbratz
DVBRYDJ	dubridge
DVBRYKYN	dobrikin
DVBRYZ	dobbratz
DVBSVN	dobson
DVBVYS	debbys
DVBYNSVN	dobinson
DVBYNYN	dubinin
DVBYR	dauber
DVCARM	ducharme
DVCAYLARD	duchaylard
DVCT	doctor
DVCYNC	dominic
DVDA	davidian
DVDAMANY	dodamani
DVD	david
DVDGVN	dodgen
DVDJ	goddijn
DVDL	dodell
DVDLY	dudley
DV	dov
DV	dov
DVFVR	dufour
DVGAN	dogan
DVGAN	dogan
DVG	dog
DVGYVN	degen
DVHA	doha
DVHH	dutch
DVHRTY	doherty
DVHVR	dehner
DVHYRST	dewhirst
DVJN	dijon
DVK	drevik
DVK	drevik
DVLAN	dilan
DVL	duval
DVLKYA	delikatny
DVLMAN	dolman
DVLR	duvalier
DVLY	dealy
DVLYN	devlin
DVMBA	domba
DVM	dem
DVM	dem
DVMN	demon
DVMNYKV	dominick
DVMYKV	domeyko
DVMYKZ	domeyko
DVMYNGV	domingo
DVMYNYKAS	dominicas
DVMYNYK	dominick
DVMYNYK	dominick
DVMYNYKS	dominicks
DVMYNYKYVS	dominicks
DVMYNYN	dominion
DVMYNYVS	domingues
DVNACY	donachie
DVNA	dvina
DVNALD	donald
DVNAT	devanathan
DVNATV	donati
DVNATY	donati
DVNAY	donaghy
DVN	deven
DVN	deven
DVNG	deng
DVNHAM	denham
DVNKN	danekind
DVNLY	donnelly
DVNPK	devenpeck
DVNPYK	devenpeck
DVNS	devins
DVNTSK	donetsk
DVNVAN	donovan
DVNYNY	denny
DVNYS	dennys
DVPALM	depalm
DVPLR	doppler
DVPLT	doppelt
DVPRY	davenport
DVPYVYS	dupuis
DVRA	devereaux
DVRAND	durand
DVRAND	durand
DVRAN	doran
DVRAN	doran
DVRAPT	durupt
DVRAS	doras
DVRASY	doraiswamy
DVRATH	dorathee
DVRATY	durante
DVRAVKS	adirondacks
DVRAYA	dracula
DVRAZYV	dorazio
DVRCAK	drake
DVRCN	dortchen
DVRDAL	dordal
DVRFMAN	dorfman
DVRHAM	durham
DVRKN	dorken
DVRKYN	dorken
DVRL	dorel
DVRLD	degerlund
DVRMA	dorma
DVRND	durand
DVRND	durand
DVRN	daverin
DVRN	daverin
DVRRANS	mediterraneans
DVRST	dorset
DVRSY	dorsey
DVRSY	dorsey
DVRTCN	dortchen
DVRT	divertje
DVRTH	dorthy
DVRTJ	divertje
DVRTJH	divertje
DVRTVN	dortmund
DVRTY	dorthy
DVRTY	dorthy
DVRVC	doric
DVRVTY	dorothy
DVRVYN	darvon
DVRY	dory
DVRYNDA	dorinda
DVRYS	dorseys
DVRYS	dorseys
DVRYSVMY	doraiswamy
DVS	daves
DVSKV	dusko
DVSN	davison
DVSTALYK	dostalik
DVSTY	dusty
DVTA	delta
DVVAYKYNK	duyckinck
DVVL	duval
DVY	davy
DVYKYNK	duyckinck
DVYKYNK	duyckinck
DVYN	dobyns
DVYNDR	devender
DVYNY	deviney
DVYNYNG	downing
DVYR	dayr
DVYSR	devisser
DVYT	dayton
DVYTV	dayton
DVYVYR	duvivier
DVYYKYNK	duyckinck
DVZAT	duzat
DVZYYR	dozier
DYAB	diab
DYA	diya
DYA	diya
DYALA	diyala
DYAMANTARAS	diamantaras
DYAMDY	darmadi
DYAMVND	diamond
DYANA	deana
DYAN	dylan
DYAZ	diaz
DYBAT	debathe
DYBATH	debathe
DYBATVNYA	debathonia
DYB	dyballa
DYBL	dyballa
DYBT	debathe
DYBTVNYA	debathonia
DYBV	dyballa
DYBYT	delbert
DYCYR	duchaylard
DYDA	duda
DY	day
DY	day
DY	day
DYDRYSZ	deidres
DYDRYX	deidre
DYDYRYCS	diederichs
DYGAN	dogan
DYGAZMN	deguzman
DYGH	dighe
DYGNARV	degennaro
DYGRAF	degraff
DYGRF	degraff
DYGRV	degraw
DYGV	drying
DYGVYD	digweed
DYKANYNK	duyckinck
DYKAVTY	delikatny
DYK	dykes
DYK	dykes
DYKL	dekel
DYKNS	dykins
DYKNZ	dykins
DYKNZ	dykins
DYKSAY	dikstra
DYKS	dykes
DYKSN	dickson
DYKSTRA	dikstra
DYKSVN	dickson
DYKSVN	dickson
DYKV	dykes
DYKV	dykes
DYKY	dicky
DYKY	dicky
DYKYNZ	dykins
'DYL	adel
DYLAN	dylan
DYLAYR	duchaylard
DYL	daryl
DYLMA	dilma
DYLN	dylan
DYLNY	delaney
DYLR	duchaylard
DYLVRS	delmers
DYLY	dealy
DYLY	dealy
DYLYNGR	dellinger
DYLYNGTN	darlington
DYLYP	dalrymple
DYLYP	dalrymple
DYLYV	dealy
DYMAD	demavend
DYMA	dema
DYMA	dema
DYMARS	demars
DYMARST	demarest
DYMARYP	dimaryp
DYMAS	dumas
DYMASK	dumas
DYM	dymond
DYMN	dymond
DYMRS	demars
DYMSAK	demcak
DYMVK	dimock
DYMYNG	deming
DYMYTAR	dimitar
DYMYTRY	dimitry
DYMYTRYS	dimitris
DYMYTRYV	dimitry
DYMYTRYV	dimitry
DYMYTRYVS	demetrius
DYNA	dyna
DYNA	dyna
DYNA	dyna
DYNAMYT	dynamite
DYNBYM	denebeim
DYN	dyna
DYN	dyna
DYN	dyna
DYNG	drying
DYNGLV	deangelo
DYNGSVR	dingsor
DYNGY	dinghy
DYNGY	dinghy
DYNL	dinler
DYNLR	dinler
DYNN	dinn
DYNPYK	devenpeck
DYNR	deaner
DYNS	dobyns
DYNS	dobyns
DYNSMVR	dinsmoor
DYNT	dynamite
DYNV	dwayne
DYNY	denny
DYNYNGR	deininger
DYPAK	dipak
DYPAYVLA	depaola
DYPAYVLV	dipaolo
DYPBVY	dipboye
DYPLD	dippold
DYPRSYV	depressive
DYPRTR	deporter
DYPYTRV	dipietro
DYR	dayr
DYR	dayr
DYR	dayr
DYRDRK	dierderick
DYRDRYK	dierderick
DYRK	dirk
DYRK	dirk
DYRKS	dirks
DYRVKV	drevik
DYRVRTJ	dievertje
DYSANTV	desanto
DYSAV	desalvo
DYSAY	domesday
DYS	dyers
DYSGY	disegi
DYSMVND	desmond
DYSNT	dessent
DYSTL	distel
DYTJY	dientje
DYTMAR	dietmar
DYTR	dexter
DYTVRZ	dexter
DYTVTALA	ditutala
DYVA	diya
DYVAKARVNY	divakaruni
DYVANATAN	devanathan
DYVAN	dylan
DYVAR	devarque
DYVAYN	dewayne
DYVAYN	dewayne
DYVAYZR	dayr
DYVHA	devanathan
DYVN	dyson
DYVNH	devanathan
DYVNPK	devenpeck
DYVNYDA	dionida
DYVRT	divertje
DYVRT	divertje
DYVRTH	dorthy
DYVRTJ	divertje
DYVRTJH	divertje
DYVRTJH	divertje
DYVVSR	devisser
DYVYA	divya
DYVY	divya
DYVYD	dymond
DYVYD	dymond
DYVYD	dymond
DYVY	divya
DYVYDSVN	davidson
DYVYDYAN	davidian
DYVYLDH	disneyland
DYVYS	odysseys
DYVYSN	dyson
DYVYSVN	dionysian
DYVYT	devito
DYYALA	diyala
DYZNY	dzerzhinsky
DYZR	dozier
DYZVN	dizon
DZ	danz
DZGAGNH	desgagne
FABLR	faber
FABRH	fabre
FABRV	fabre
FABRYS	fabris
FABYANV	fabiano
FACS	frances
FAD	fadl
FADL	fadl
FADNBRG	fudenberg
FADVR	flanders
FADYLA	fadila
FADYL	fadil
'FAF	afaf
FAGAN	fagan
FAGANS	fagans
FAJN	fagen
FAJYVAR	fujiwara
FAKS	farkas
FALCVK	falchuk
FALK	falk
FALKNR	faulkner
FALKRSVN	fulkerson
FALKV	falk
FALKVNR	faulkner
FALN	fallon
FALSAM	falasha
FALTAK	foltak
FALTLS	faultless
FALTVN	fulton
FALVN	fallon
FALY	farley
FALYVT	fallate
FALZ	fortaleza
FAMYVS	famus
FANDRYC	fandrich
FANG	fanger
FANGVS	frangakis
FANTS	frantisek
FARA	farag
FARAG	farag
FARAGV	farago
FARAT	farragut
FARKAS	farkas
FARL	farley
FARLY	farley
FARMR	farmer
FARSBRG	forsberg
FARST	fairhurst
FARTK	farouk
FARVANYA	farwaniyah
FARVANYAH	farwaniyah
FARVGYA	farrugia
FARVK	farouk
FARVK	farouk
FARVQ	farooq
FARVZ	fairuz
FARYD	farid
FARY	farry
FARYHA	fariha
FARYVR	farer
FASBRG	forsberg
FAS	fash
FAS	fash
FASL	fasel
FATYMA	fatima
FATYS	fauntleroys
FAVAZ	fawaz
FAVL	fauvel
FAVNS	fagins
FAVNS	fagins
FAVST	faust
FAVST	faust
FAVST	faust
FAVST	faust
FAVZYA	fawziyya
FAVZY	fawziyya
FAVZYYA	fawziyya
FAXRY	farry
FAYF	fafat
FAYK	falk
FAYLS	faisals
FAYN	fayne
FAYNK	frank
FAYNLY	fauntleroy
FAYNRTY	frankfort
FAYNSTVN	frankenstein
FAYNTVN	farrington
FAYRBANK	fairbank
FAYRVZ	fairuz
FAYT	fayette
FAYYZ	fayiz
FAYZA	faiza
FAYZ	fayiz
FAYZ	fayiz
FAYZL	faizel
FAZA	faiza
FAZ	faiz
FAZL	faizel
FAZYA	fawziyya
FAZY	fawziyya
FAZY	fawziyya
FBRV	fabre
FCNR	fechner
FDL	fadl
FDR	feder
FDR	feder
FDRL	federle
FDRMN	federman
FDVR	feder
FDYLA	fadila
FDYL	fadil
FHD	fahd
FHT	fichte
FK	falk
FLAGLLY	flaglelee
FLAHRTY	flaherty
FLAKYGR	fluckiger
FLARDYNGA	flardinga
FLAT	flat
FLAT	flat
FLAVKA	felawka
FLAY	finlay
FLAYGYR	flygare
FLAYS	fulanis
FLDMAN	feldman
FLDMAR	feldmar
FLDMN	feldman
FLDR	felder
FLDSPAR	feldspar
FLJ	fletje
FLK	falk
FLKYNZ	folkins
FLMR	feldmar
FLSTY	flesti
FLTH	fletcher
FLTJ	fletje
FLTJH	fletje
FLTYV	felicity
FLVCH	fluche
FLVDYN	flodin
FLVRA	flora
FLVR	flor
FLVR	flor
FLVRK	florek
FLVRNS	florines
FLVRS	flores
FLVRY	flory
FLVRYN	florian
FLVRZ	flor
FLVT	flint
FLVVRZ	fluur
FLVYD	floyd
FLYJH	elijah
FLYKS	folkes
FLYKYNGR	flickinger
FLYM	folsom
FLYMYNG	fleming
FLYNDRZ	flinders
FLYNT	flint
FLYNY	flynn
FLYSZ	florys
FLYVRY	fleury
FLYZARDV	felizardo
FMMTH	femmetje
FMT	fermat
FMTJ	femmetje
FMYA	femea
FNCARC	fiasconaro
FNDR	fender
FN	fan
FN	fan
FNG	feng
FNGR	fanger
FNR	fanger
FNSKY	fenske
FNTVN	fenton
FNTYMAN	fentiman
FNVYK	foniok
FNY	fanny
FNYS	fannys
FRA	fera
FRAGVRGYA	frageorgia
FRAM	frame
FRAMSAN	framson
FRAMSVN	framson
FRANDSN	frandsen
FRAN	fran
FRANGAKYS	frangakis
FRANKL	frankel
FRANKL	frankel
FRANKLYN	franklin
FRANKV	franke
FRANKV	franke
FRANKVY	frankie
FRANKVYS	frankies
FRANKVYZ	frankie
FRANS	frans
FRANSR	franser
FRANSSYDTJ	franscyntje
FRANSVYZ	franscyntje
FRANSYKA	fransiska
FRANSYNTAY	franscyntje
FRANSYNTH	franscyntje
FRANSYNTJH	franscyntje
FRANSYNTY	franscyntje
FRANSYNTYH	franscyntje
FRANSYNTZ	franscyntje
FRANSYSKA	fransiska
FRANSYSKA	fransiska
FRANSYSKAS	fransiska
FRANSYSKVS	fransiska
FRANSYSYVS	francoises
FRANTYSK	frantisek
FRANTZN	frantzen
FRAQ	iraq
FRARY	february
FRASR	fraser
FRAST	federalist
FRASTY	federalist
FRAYDA	faraday
FRAYDMAN	freedman
FRAYDMN	freedman
FRAYDY	faraday
FRAY	franny
FRAYGRSA	fritgersa
FRAYTGRSA	fritgersa
FRAZR	frazer
FRAZYR	frazer
FRAZYYR	frazier
FRDA	freda
FRDAYNND	ferdinand
FRD	ford
FRDKYN	fradkin
FRDRKYNG	frederking
FRDRYK	fredrik
FRDRYK	fredrik
FRDRYK	fredrik
FRDRYK	fredrik
FRDRYKV	fredrik
FRDT	fredette
FRDYA	freda
FRDY	freddy
FRDY	freddy
FRDYG	ferdig
FRG	farag
FRGT	forget
FRGVSN	ferguson
FRH	farah
FRJ	franscyntje
FRJN	efren
FRLANG	furlong
FRLY	farley
FRM	fermi
FRNANDS	fernandes
FRNANDV	fernando
FRNANDZ	fernandez
FRNASYSKAS	fransiska
FRNASYSKAZ	fransiska
FRNC	france
FRNK	frank
FRNK	frank
FRNKH	franke
FRNKL	frankel
FRNKL	frankel
FRNKLYN	franklin
FRNKSVN	frankson
FRNKVYS	frankies
FRNKVYZ	frankie
FRNSAYNT	franscyntje
FRNS	ferns
FRNSNYT	franscyntje
FRNSNYT	franscyntje
FRNSVYS	furness
FRNSYNTY	franscyntje
FRNSYSKA	fransiska
FRNSYSKA	fransiska
FRNZL	frenzel
FRQ	farooq
FRR	furr
FRSR	fraser
FRTYK	fertik
FRVANYAH	farwaniyah
FRVANYH	farwaniyah
FRVK	frink
FRVK	frink
FRVMYN	fremont
FRVNYAH	farwaniyah
FRVZ	fritz
FRYBRG	freeburg
FRYDA	freda
FRYDBRGR	friedberger
FRYD	fred
FRYDGYR	fridgeir
FRYDH	fordham
FRYDL	friedl
FRYDMAR	friedmar
FRYDMN	fridman
FRYDMN	fridman
FRYDRYK	fredrik
FRYDYN	freidin
FRY	fry
FRY	fry
FRYHA	fariha
FRYKS	farkas
FRYLND	freeland
FRYLYNG	freiling
FRYLYNGR	freilinger
FRYLZ	fortaleza
FRYMAL	freemal
FRYMVT	freyermuth
FRYNGTVN	farrington
FRYNK	frink
FRYNK	frink
FRYR	fourneyron
FRYR	fourneyron
FRYRMAT	freyermuth
FRYS	freys
FRYS	freys
FRYS	freys
FRYTAG	freitag
FRYTAS	freitas
FRYT	forsyth
FRYTGRSA	fritgersa
FRYTN	fritton
FRYTS	frits
FRYTV	forsythe
FRYTVL	fretwell
FRYTZYVS	fritzius
FRYVALD	freiwald
FRYVVGL	freivogel
FRYZ	fritz
FRYZR	frazer
FRYZR	frazer
FSDAL	fosdal
FST	fast
FSYG	fasig
FTC	fetch
FTCN	fetchen
FTRA	fetra
FTR	fetra
FVD	fed
FVJY	fiji
FVJYTA	fujita
FVJYVKA	fujioka
FVKV	fike
FVLDZ	felder
FVLGAM	fulghum
FVLKANYS	falklands
FVLK	foulk
FVLKS	folkes
FVLMN	feldman
FVLN	feland
FVLR	feiler
FVLR	feiler
FVLY	feely
FVMRTVN	fumerton
FVNDAL	fundal
FVNDV	fondo
FVNGN	fongen
FVNG	feng
FVNKY	funky
FVNTNVT	fontenot
FVN	fin
FVNYVK	foniok
FVRBS	forbes
FVRBZ	fairuz
FVRD	ford
FVRDHAM	fordham
FVRDSANDN	furdesanden
FVRJY	franscyntje
FVRK	fork
FVRLANG	furlong
FVRMN	forman
FVRMN	forman
FVRNR	fournier
FVRNY	fourney
FVRNY	fourney
FVRNYR	fourneyron
FVRR	furr
FVRRV	ferree
FVRSAYT	froissart
FVRSAYT	froissart
FVRSBLAM	forsblom
FVRSBRG	forsberg
FVRS	ferns
FVRSYL	forsale
FVRT	forte
FVRTS	forts
FVRY	feury
FVSNG	fosseng
FVT	fiat
FVTRR	fuetterer
FVTS	fiats
FVTYNVS	fotinos
FVY	foy
FVYS	freys
FVYY	fawziyya
FVZARD	fozzard
FVZY	fuzzy
FVZYH	fuzhou
FXRYA	freya
FXRY	feury
FXRYYA	fakhriyya
FXYR	flygare
FYABAN	fiabane
FYAKSY	farkas
FYASKVNARV	fiasconaro
FYBR	ferber
FYDALGV	fidalgo
FYDL	fidel
FYDLR	fidler
FYDVR	feder
'FYF	afif
FYGARD	figard
FYGVRA	figura
FYHAN	feehan
FYK	feck
FYKS	fisks
FYLAKS	fulanis
FYL	feil
FYLK	foulk
FYLPAT	flat
FYL	feil
FYL	feil
FYLPS	felipes
FYLR	feiler
FYLVS	felixs
FYLVZ	filzek
FYLYAS	filias
FYLY	feely
FYLYP	felipe
FYLYPS	felipes
FYLYPS	felipes
FYLZ	filzek
FYMTJH	freyermuth
FYMYJH	freyermuth
FYNAN	feynman
FYNAN	feynman
FYNC	finch
FYN	fayne
FYN	fayne
FYNK	fink
FYNKL	finkle
FYNLY	finlay
FYNLY	finlay
FYNLY	finlay
FYNSTAD	finstad
FYNY	fayne
FYNYN	flynn
FYNYS	fenyes
FY	fay
FYPS	felipes
FYRBNKS	fairbanks
FYRBRYN	fairbairn
FYR	flygare
FYRHRST	fairhurst
FYRMA	firma
FYRN	fourneyron
FYRVDR	fredric
FYRVK	fertik
FYRVZ	fairuz
FYRVZ	fairuz
FYSBYN	fishbein
FYS	fays
FYS	fays
FYSK	fisk
FYSR	fisher
FYTA	fetra
FYTC	fetch
FYTZJRALD	fitzgerald
FYTZVL	fitzwell
FYVR	flygare
FYVSTL	feustel
FYZA	faiza
FYZ	fayiz
FYZH	fuzhou
FYZL	faizel
FZYA	fawziyya
GABA	gaba
GABARA	gabara
GABBL	gabel
GABLR	gabler
GABRYLH	gabriele
GABRYLH	gabriele
GABRYYLSVN	gabrielsson
GABVR	gabor
GABYN	gabon
GACR	gacrux
GADBRY	gadbury
GADBT	gadbury
GADBVRY	gadbury
GADBVYS	gadbois
GADFRVYD	godfroid
GADFRY	gadbury
GADGL	gadil
GADMN	gaiman
GADRV	gaudreau
GADSN	gadsden
GADSVARD	goudswaard
GADVYN	gadsden
GADY	gandy
GADYJN	goddijn
GADYL	gadil
GAF	graf
GAF	graf
GAFNY	gaffney
GAFRAN	ghufran
GAFYN	gaffin
GAGNH	gagne
GAHRTY	gaherty
GAJNH	gandhi
GAJR	guadalajara
GALA	galea
GALAGHR	gallagher
GALAGR	gallagher
GALAHAD	galahad
GALAN	galvan
GALANT	gallant
GALATYN	gallatin
GALAVY	galbavy
GALBAVAY	galbavy
GALC	gaelic
GALDN	geraldine
GAL	gaal
GAL	gaal
GAL	gaal
GAL	gaal
GALJ	guadalajara
GALKV	galko
GALN	galen
GALP	gallop
GALPYN	galpin
GALT	gaillot
GALV	galvan
GALVLA	galila
GALVSN	galveston
GALVVY	galbavy
GALVY	galbavy
GALYBRT	galibert
GALY	galley
GALY	galley
GALY	galley
GALY	galley
GALYLA	galila
GALYLH	gallagher
GALYLH	gallagher
GALYTY	gallaty
GALYVN	galvan
GALYZYA	galizia
GAMAK	gamage
GAMAL	gamal
GAMBYNV	gambino
GAML	gamal
GAML	gamal
GAMRV	gamero
GAMRVS	gaeris
GAMVN	gammon
GAMYJ	gamay
GAMYSH	gilgamesh
GANAPATY	ganapathy
GANAR	grabnar
GANATRA	ganatra
GANAVAN	ghanaian
GANDLC	grandfield
GANDRSVN	gunderson
GANDRZYK	gonderzik
GANDVRP	glandorf
GANDY	gandy
GAN	gan
GANG	gang
GANG	gang
GANGVLY	gangolli
GANL	granli
GANRVS	gantrys
GANS	gans
GANSVN	ganesan
GANTRAM	guntram
GANTR	ganter
GANTR	ganter
GANTR	ganter
GANTRP	ganter
GANTRT	gantert
GANTVRP	ganter
GANTVRPH	gunthorpe
GANTY	gantry
GANVN	granvin
GANVYL	gangolli
GANYR	gainor
GANYSAN	ganesan
GANZAK	ganzak
GANZALZ	gonzalez
GAPTA	gupta
GAPYSTY	gopisetty
GARADVAN	garagan
GARAFALV	garofalo
GARANS	guaranis
GARBH	gharbiyah
GARBY	gharbiyah
GARDNR	gardner
GARDYNR	gardner
GARFYLD	garfield
GARFYNKL	garfinkel
GARLYK	garlick
GARMZ	garms
GARN	garon
GARNR	garner
GARNT	garnett
GARNY	garner
GARSKY	gursky
GARSS	gabrielsson
GARSVL	garshol
GARSYA	gharbiyah
GART	garth
GARTMN	gartmann
GARTRYJ	garry
GARTYN	gartin
GARVD	garrod
GARVFALV	garofalo
GARVLA	gabriela
GARVTV	garito
GARYK	garlick
GARYK	garlick
GARYS	garrys
GARYTV	garito
GASARD	gossard
GAS	gas
GASKAT	saskatoon
GASKVN	gaskin
GASKVYN	gaskin
GASKVYYN	gaskin
GASKYN	gaskin
GASKYNZ	gaskin
GASLR	gashler
GASLR	gashler
GASLYK	guslick
GASLYNG	gosling
GASPAR	gaspar
GASPR	gaspar
GASTA	gastineau
GASTAVS	gustavs
GASTAVVS	gustavos
GASTLAV	eastlake
GASTLV	gastli
GASTYLV	gastli
GASTYN	galveston
GASTYNYV	glastonbury
GASVL	garshol
GASY	grasty
GASYK	gaskin
GASYNK	gascoyne
GATA	gaetan
GAT	gat
GAT	gat
GATHARD	gotthard
GATKVMB	gatcombe
GATLYB	gateley
GATLY	gateley
GATLYN	gatlin
GATMN	gartmann
GATMN	gartmann
GATRYJ	gantry
GATSF	gates
GATS	gates
GATS	gates
GATVYN	gatun
GATYS	gantrys
GATYZ	gatz
GATZ	gatz
GATZVYLR	gutzwiller
GAVAZNY	gavazzeni
GAV	gavin
GAVRD	garrod
GAVR	gair
GAVTYR	gautier
GAVYNDAN	ugandan
GAVYND	ghazvanid
GAVYN	gavin
GAYA	gaya
GAYAT	galatea
GAYBS	gabons
GAYDA	gayda
GAYDRY	gadbury
GAYDVAL	gaudrault
GAYDV	gayda
GAYGL	gangolli
GAY	gay
GAYLR	gayler
GAYLVN	galvan
GAYMN	gayman
GAYMVND	ganymede
GAYNL	gaynell
GAYNVR	gaynor
GAYNVR	gaynor
GAYR	gayler
GAYT	ghayth
GAYVN	gayman
GAYYTZ	gaetz
GAZK	ganzak
GAZMN	gaiman
GBY	gilby
GDARD	goddard
GDBRY	gadbury
GDK	gdansk
GDRALT	gaudrault
GDR	golder
GDYRA	gaudreau
GDYRH	gendrich
GDYR	goodyear
GDYS	gladys
GF	gift
GFRAN	ghufran
GLAS	gilas
GLASKV	glasscock
GLASYR	glaser
GLASYYR	glaser
GLATZ	glatz
GLAYR	glaser
GLDASTYYN	goldsteen
GLDBRG	goldberg
GLDBRGR	goldberger
GLDFSMAN	geldefsman
GLDFSMN	geldefsman
GLDFVT	goldfoot
GLD	gold
GLDKMP	goldkamp
GLDMN	goldman
GLDR	golder
GLDYNG	golding
GLDZMN	goldman
GLDZVRSY	gladders
GLF	gulf
GL	gil
GLNDVRF	glandorf
GLN	glen
GLRYK	gilroy
GLS	gils
GLSYRZ	glaser
GLTR	gelter
GLVB	golub
GLVJ	guadalajara
GLVRYA	gloria
GLVVY	ogilvy
GLYB	golub
GLYC	gaelic
GLYCMN	gleichman
GLYK	gleick
GLYKSMN	glicksman
GLYN	glynn
GLYNZ	glynn
GLYSVN	gleason
GLYVS	gladys
GLYZR	gleizer
GMBL	gamble
GMG	gamage
GML	gamal
GML	gamal
GMYJ	gamay
GNAGY	gnagy
GNKS	genks
GNVSYS	guernseys
GNYSYLDA	gnishilda
GNZALS	gonzales
GNZALS	gonzales
GNZALZ	gonzalez
GNZALZ	gonzalez
GNZ	ganzak
GPH	gopher
GPJ	gepje
GRAB	graben
GRABNAR	grabnar
GRABN	graben
GRABYNR	grabiner
GRAD	grad
GRAF	graf
GRAFT	graft
GRAG	garagan
GRAGTY	geraghty
GRAHAM	graham
GRAHAM	graham
GRAH	grah
GRAHRNA	grahorna
GRALYN	gralian
GRAMSS	gramsas
GRANBRGR	grunberger
GRANDASTRVM	grandmaster
GRAND	grand
GRAN	gran
GRANTAM	grantham
GRANT	grant
GRANVYN	granvin
GRANYT	granite
GRANZYV	granzeau
GRARDYN	gerardin
GRASKYN	gruskin
GRASR	graser
GRATR	grater
GRAV	gorav
GRAV	gorav
GRAV	gorav
GRAV	gorav
GRAYM	graham
GRAYNGR	grainger
GRAYSLDYZ	griseldis
GRAYSYLD	griswald
GRAYVAS	gracielas
GRAYY	gray
GRAYYNGR	grainger
GRAYYV	gray
GRBS	gerbes
GRBYAH	gharbiyah
GRBYH	gharbiyah
GRDAN	gordan
GRDN	gordan
GRDNR	gardner
GRDY	grady
GRFYT	graft
GRG	garg
GRG	garg
GRG	garg
GRGVR	gregor
GRGVR	gregor
GRHARD	gerhard
GRHART	gerhart
GRHART	gerhart
GRJVAYSN	grossjohann
GRKV	gorki
GRL	girl
GRLY	gurley
GRLYK	garlick
GRMAK	germack
GRMBAN	gremban
GRM	gorm
GRNANDR	grenander
GRND	grand
GRNDMSTR	grandmaster
GRNDYDYR	grandidier
GRN	gran
GRNGR	granger
GRNJR	garner
GRNJR	garner
GRNLY	grindley
GRNSYNG	grensing
GRNT	grant
GRNVYL	grenville
GRNYCR	granicher
GRNY	grundy
GRQTY	gerrity
GRSAPH	gersappe
GRSDVRF	gersdorf
GRS	gris
GRS	gris
GRSLDYS	griseldis
GRSR	graser
GRSTL	gerstl
GRSTY	grasty
GRSTYNN	grasteinen
GRTA	greta
GRTCN	gretchen
GRT	grit
GRT	grit
GRTRVD	gertrude
GRTRVYD	geertruyd
GRVBY	gharbiyah
GRV	grov
GRVGVRY	gregory
GRVHVL	grohol
GRVLAYT	geervliet
GRVLYT	geervliet
GRVM	grimm
GRVNR	groner
GRVNVALD	greenwald
GRVNYNK	groenink
GRVS	graves
GRVSJVHAN	grossjohann
GRVSK	grosek
GRVSR	grosser
GRVSY	grasty
GRVT	geervliet
GRVT	geervliet
GRVTHAVS	grothause
GRVVR	grover
GRVVY	garvey
GRVYNCM	gorinchem
GRVYN	greyson
GRVYNLND	greenland
GRVYNVLD	groenveld
GRYBH	gharbiyah
GRYBL	gribble
GRYBYH	gharbiyah
GRYF	griff
GRYF	griff
GRYFR	graifer
GRYFR	graifer
GRYFR	graifer
GRYFY	griffy
GRYFYS	griffis
GRYFYTS	griffiths
GRYFYTZ	gorwitz
GRYG	greg
GRY	gary
GRYGR	gregor
GRYGVR	gregor
GRYKV	gromyko
GRYLK	grilk
GRYLNBK	grillenbeck
GRYNBRG	greenberg
GRYNDLY	grindley
GRYNG	goering
GRYNGH	greenough
GRYN	greyson
GRYNGR	grainger
GRYNHAM	grinham
GRYNJ	greyson
GRYNJR	groner
GRYNSVN	grinsven
GRYNVALD	greenwald
GRYNV	greyson
GRYNVP	greenop
GRYNVVD	groenveld
GRYNYAS	greanias
GRYNYJ	grundy
GRYPNKRL	griepenkerl
GRYR	gruyeres
GRYSAYLD	griswald
GRYS	garrys
GRYSLD	griswold
GRYSLDYS	griseldis
GRYSMVR	grismore
GRYSR	grosser
GRYST	grist
GRYSVALD	griswald
GRYSVLD	griswald
GRYSVN	greyson
GRYSYLD	griswald
GRYSYLDH	griseldis
GRYT	grit
GRYTS	gretas
GRYTZ	gritz
GRYTZN	gerritzon
GRYTZVN	gerritzon
GRYVL	grenville
GRYVLYT	geervliet
GRYVNVD	groenveld
GRYYN	greyson
GRYYNVALD	greenwald
GRYZLY	grizzly
GRYZVN	gerritzon
GSAN	ganesan
GS	gs
GSKVYN	gaskin
GSKVYNH	gaskin
GSKYN	gaskin
GSKYNS	gaskins
GSKYNZ	gaskin
GSTAVVS	gustavos
GST	gosta
GSTL	gastli
GTYS	gettys
GVADA	grenada
GVANG	guang
GVAN	galvan
GVAN	galvan
GVANYAV	guanyao
GVARD	gerard
GVBL	goble
GVBYN	gebing
GVCAN	grecian
GVDA	govindan
GVDA	govindan
GVDA	govindan
GVDAL	goudal
GVDARD	goddard
GVDATA	gudata
GVDAT	gudat
GVDAYNAF	guadalcanal
GVD	goverd
GVDGR	goodger
GVDHV	goodhew
GVDL	godel
GVDMAN	godman
GVDMN	godman
GVDNAF	guadalcanal
GVDRAM	goodrum
GVDRAN	govindan
GVDRV	govinder
GVDRV	govinder
GVDRYC	gendrich
GVDSN	godson
GVDSVN	godson
GVDVYN	godewyn
GVDVYN	godewyn
GVDYNG	golding
GVDYN	godewyn
GVDYR	goodyear
GVDYVAYN	gurudevan
GVDYVYN	godewyn
GVGAN	goegan
GVGR	geiger
GVGVAN	georgian
GVHD	gohde
GVH	gelbvieh
GVHYN	goheen
GVKYANV	glicksman
GVLAND	goland
GVLAN	golan
GVLDYNG	golding
GVL	govil
GVLSBY	glastonbury
GVLT	geervliet
GVLVMB	golomb
GVLY	gilby
GVMZ	gomez
GVMZ	gomez
GVNAR	genaro
GVNNA	gonna
GVNTVRP	gunthorpe
GVNVT	glenlivet
GVNY	gony
GVNZALS	gonzales
GVNZALS	gonzales
GVNZALV	gonzalo
GVNZALZ	gonzalez
GVPALA	gopala
GVPALAN	gopalan
GVPTA	gupta
GVPTH	gopinath
GVPVL	gospel
GVPYNAT	gopinath
GVRALAVALA	goralwalla
GVRAL	gural
GVRALP	guralp
GVRAN	goran
GVRAPARTAP	gurupartap
GVRASPY	grasty
GVRAV	gorav
GVRBRG	gorberg
GVRDF	gersdorf
GVRD	goverd
GVRD	goverd
GVRDN	gordan
GVRDYN	gorden
GVRGAN	georgian
GVRGANZ	georgian
GVR	glover
GVR	glover
GVRKY	gorky
GVRL	girl
GVRLY	gurley
GVRM	gorm
GVRMT	gourmet
GVRNAL	gornall
GVRNY	gurney
GVRTVN	gorton
GVRV	gorav
GVRVSAMY	gurusamy
GVRVYTZ	gorwitz
GVRY	gerry
GVRYK	gromyko
GVRYNCM	gorinchem
GVRYNDR	gurinder
GVRYNG	goering
GVRYNMN	geronimo
GVRYS	gerrys
GVSF	gotseff
GVS	gavins
GVSTAV	gustav
GVSTAVS	gustavs
GVSTAVVS	gustavos
GVSTLV	gastli
GVSVL	gospel
GVSVYL	goswell
GVSY	gipsy
GVTHARD	gotthard
GVTJS	gootjes
GVTLYB	gottlieb
GVTY	getty
GVTYK	gitnick
GVVDGR	goodger
GVVDYNG	gooding
GVVRD	goverd
GVVVSYS	gipsys
GVVYNDR	govinder
GVYAT	guyatt
GVYDV	gayda
GVY	garvey
GVYKARYS	jogjakartas
GVYLAM	gillam
GVYL	gayle
GVYL	gayle
GVYL	gayle
GVYLRMV	guillermo
GVYN	gwyn
GVYN	gwyn
GVYVDA	gayda
GVYYDV	ganymede
GVYYJR	gooijer
GVYYLYM	gwillim
GVYYN	gwyn
GVZVYTZ	goerwitz
GYANASY	guyanas
GYAT	guyatt
GYBSN	gibson
GYBSVN	gibson
GYBVNY	gibboni
GYBVNZ	gibboni
GYBVR	gettysburg
GYDRY	guidry
GYDV	gayda
GYDVN	gurudevan
GYDZ	godzilla
GYFT	gift
GY	gay
GYGR	geiger
GYJSBRTAS	gijsbertus
GYJSBRTVS	gijsbertus
GYLAGLY	gillogly
GYLAM	gillam
GYLAM	gillam
GYLBAY	galbavy
GYLBRT	gilbert
GYLFRD	guilford
GYLFVRD	guilford
GYL	gayle
GYL	gayle
GYL	gayle
GYL	gayle
GYLMN	gilman
GYLMN	gilman
GYLMR	gilmer
GYLN	golan
GYLNR	gilner
GYLPYN	gilpin
GYLR	gayler
GYLRM	guillerm
GYLRMV	guillermo
GYLRVY	gilroy
GYLRY	gilroy
GYLSPAY	gillespie
GYLSPY	gillespie
GYLT	geleta
GYLVT	glenlivet
GYLYAM	gilliam
GYLY	egyptology
GYLY	egyptology
GYLYS	egyptologys
GYLYS	egyptologys
GYLYTA	geleta
GYLYZ	gonzalez
GYLYZ	gonzalez
GYML	gumbel
GYMNV	gayman
GYMNZ	gimenez
GYN	gwyn
GYNKZ	genks
GYNSBRG	ginsberg
GYNTN	ginton
GYNTVN	ginton
GYPJH	gepje
GYPN	egyptian
GYRARD	gerard
GYR	guyer
GYR	guyer
GYRHART	gerhart
GYRTRVYD	geertruyd
GYRTSN	geertsen
GYRVLAYT	geervliet
GYRVLYT	geervliet
GYSBRTVS	gijsbertus
GYS	guys
GYSH	gish
GYSYLDA	gnishilda
GYTARD	guitard
GYT	egypt
GYT	egypt
GYTGY	egyptology
GYTLMN	gittelman
GYTLYN	gitlin
GYTN	egyptian
GYTNYK	gitnick
GYTS	egypts
GYTVMR	gitomer
GYTVND	gaitonde
GYVF	geoff
GYVLYTY	gallaty
GYVN	gwyn
GYVVANY	giovanni
GYVVN	givon
GYVYN	gwyn
GYVZ	gomez
GYYANKVLA	giancola
GYZAV	gizaw
HABA	haba
HABRDR	habereder
HABR	haber
HABR	haber
HABRKAM	harkcom
HABRLC	haberlach
HABRMN	haberman
HABRT	habert
HABS	habers
HABVRA	habura
HABVRG	hamburg
HABYN	harbin
HABZ	haber
HACHALTR	hochhalter
HACYNSVN	hansen
HACYNZ	hangzhou
HACYSVN	hamson
HADGZ	hambidge
HADLND	hadland
HADLSTVN	huddleston
HADLY	hadley
HADRAMAT	hadramawt
HADRAMAVT	hadramawt
HADSN	hardison
HADSVN	hardison
HADSVN	hardison
HADVBA	ahmadabad
HADYA	hadaya
HADY	haddy
HADYL	hadil
HAFBK	hoffbeck
HAFMN	hageman
HAFMN	hageman
HAFMN	hageman
HAFNYLYNG	hanning
HAFR	hafer
HAFSAH	hafsah
HAFS	hafs
HAGA	haga
HAGAN	hagan
HAGARD	haggard
HAGARD	haggard
HAGDAL	hugdahl
HAG	haga
HAGKYNZ	hawken
HAGLR	hagler
HAGLYN	hagelin
HAGMN	hageman
HAGMN	hageman
HAGN	hagan
HAGR	hagar
HAGS	hanguls
HAGSVN	hagelin
HAGTN	harrington
HAGYN	hagen
HAHTAHA	huhtala
HAJ	haj
HAJKYNZ	hawken
HAJR	hajar
HAJRZ	hajar
HAJS	cajuns
HAJYR	hajery
HAJZ	hafiz
HAKABAY	haleakala
HAKDT	hackett
HAK	hak
HAK	hak
HAKLY	hackley
HAKNYS	harkins
HAKSA	hackshaw
HAKSAV	hackshaw
HAKS	hanks
HAKSL	haskel
HAKSV	hanks
HAKVLYNN	hakulinen
HAKVYL	haskel
HAKY	hackley
HAKYNG	hacking
HALAM	hallam
HALAN	harlan
HALAT	halat
HALDR	haldre
HALFLDR	holfelder
HALGR	haleger
HAL	hal
HAL	hal
HALKDYS	halkedis
HALK	halleck
HALKNR	holkner
HALM	halm
HALMN	casselman
HALND	hadland
HALN	halon
HALPYN	halpin
HALR	halar
HALR	halar
HALRT	hallert
HALSTD	halsted
HALST	halsted
HALTGRN	hultgren
HALTSYNGR	holtsinger
HALTVN	healton
HALTZ	hiltz
HALVB	halab
HALYBRTVN	halliburton
HALYDY	haldre
HALYFYLD	hollifield
HALY	haley
HALY	haley
HALYMN	casselman
HALYVL	hall
HALZR	hagler
HAMACY	hamachi
HAMAH	hamah
HAMANS	hamans
HAMANZ	haman
HAMARKVYYST	hammarquist
HAMBYG	hamburg
HAMBYJ	hambidge
HAMD	hamad
HAMFRY	hamer
HAMFRYZ	hafiz
HAMFRYZ	hafiz
HAMH	hamah
HAML	hamel
HAML	hamel
HAMMANZ	hammans
HAMNS	hamans
HAMPRYVN	hamparian
HAMPSAYR	hampshire
HAMPSYR	hampshire
HAMPTVN	hampton
HAMR	hamer
HAMSAYR	hamilcar
HAMVND	hammond
HAMVNDZ	hammond
HAMY	hami
HAMYL	hamel
HAMYLTN	hamilton
HAMYLTVN	hamilton
HANAFVRD	hannaford
HANA	hanaa
HANBVT	hanebuth
HANDL	handel
HANDRSVN	henderson
HANG	huang
HANGRFVRD	hungerford
HAN	han
HANKH	hanukkah
HANKLR	hunkler
HANKZ	hanke
HANSAKR	hunsaker
HANSN	hansen
HANSN	hansen
HANSR	hansher
HANSVN	hansen
HANSVN	hansen
HANT	hanebuth
HANTYNGTVN	huntington
HANV	hanover
HANYA	haniyya
HANYFA	hanifa
HANY	handy
HANYH	hanebuth
HANYMN	hannemann
HAPKARFT	hardikar
HAPKRAFT	hopcraft
HAPKRFT	hopcraft
HAPKYNZ	hawken
HAPR	harper
HAPSVN	capistran
HARALD	harald
HARALDSN	haraldsen
HARARY	harare
HARATZ	haratz
HARBD	harbud
HARBR	harber
HARBR	harber
HARBR	harber
HARBRN	harburn
HARBRYJ	harber
HARBVD	harbud
HARBVR	harber
HARBYG	harbidge
HARBYJ	carbajal
HARDN	harden
HARDYMN	hardiman
HARDYNG	harding
HARDYN	harden
HARDYSVN	hardison
HARGRAVZ	hargreaves
HAR	har
HARKL	hammarskjold
HARKR	harker
HARKVM	harkcom
HARKYN	harkin
HARKYNZ	harkin
HARLD	harald
HARLD	harald
HARL	harald
HARLND	harland
HARLN	harlan
HARLV	harlem
HARMAN	harman
HARMANVS	harmanus
HARMN	harman
HARMNVS	harmanus
HARMVTV	haramoto
HARMZ	harmer
HARNR	harincar
HARP	harpe
HARPR	harper
HARPVLD	harpold
HARR	harry
HARRYG	harrig
HARSA	harsha
HARS	hares
HARS	hares
HARTAG	carthage
HARTAH	cartaxo
HARTFYLD	hartfield
HART	hart
HART	hart
HARTL	hartel
HARTLP	hartlep
HARTLY	hartley
HARTMN	hartman
HARTR	harter
HARTVL	hartel
HARTVYL	hartel
HARTYGAN	hartigan
HARVARD	harvard
HARV	harv
HARVHYSA	haruhisa
HARVLD	harold
HARVL	harvell
HARVN	harbin
HARVN	harbin
HARVNY	haruni
HARVY	harvey
HARYCN	haroon
HARYHARAN	hariharan
HARYKN	haricken
HARYNKAR	hardikar
HARYS	harrys
HARYSVN	hardison
HARYV	hardy
HARYZ	haratz
HASAKAH	hasakah
HASAL	hascall
HASBRVK	hasbrouck
HASBY	hasbro
HAS	haas
HAS	haas
HASKAL	haskel
HASK	haskel
HASKL	haskel
HASKL	haskel
HASKYNZ	carskadon
HASLVM	haslum
HASMN	casselman
HAST	haste
HASTTLR	hostetler
HASTVN	hastings
HASTYNGZ	hastings
HASYK	haskel
HATAP	hartlep
HATCSVN	wheatstone
HATCYNSVN	carstensen
HATCYNZ	catanzaro
HATCYSVN	wheatstone
HAT	hart
HATLNDNSYS	holtlandensis
HATLY	hartley
HATM	hatem
HATMYKR	hatmaker
HATR	harter
HATRL	hatrell
HATVN	hawtin
HATVN	hawtin
HATVRY	harter
HAVARD	havard
HAVDVN	hawdon
HAVGTAYLYNG	houghtailing
HAV	harv
HAV	harv
HAV	harv
HAVK	hlavenka
HAVK	hlavenka
HAVKR	hawker
HAVKYN	hawken
HAVKYNZ	hawken
HAVL	havel
HAVLY	hailey
HAVLZ	havel
HAVN	haven
HAVN	haven
HAVS	havanas
HAVSR	hasbro
HAVTVN	hawtin
HAVTYLYNG	hartline
HAVTYN	hawtin
HAVVLA	havola
HAVVNN	hann
HAVY	harvey
HAVYS	haleys
HAYBRD	habereder
HAYBZ	haber
HAYC	haich
HAYDAR	haidar
HAYD	haydn
HAYDMN	hardiman
HAYDN	haydn
HAYGDAN	hagan
HAYKY	hranicky
HAYLND	hadland
HAYLT	haylett
HAYLVRD	halford
HAYLY	hailey
HAYM	hakim
HAYNGH	hangzhou
HAYN	haydn
HAYN	haydn
HAYNLY	handel
HAYNS	haydns
HAYNS	haydns
HAYNY	haynes
HAYNZ	hangzhou
HAYNZ	hangzhou
HAYPLY	harpold
HAYR	hayter
HAYRVNYMVS	hieronymus
HAYSLVP	hyslop
HAYSVN	hamson
HAYTR	hayter
HAYTS	hayworths
HAYTZ	haratz
HAYVARD	hayward
HAYVKYNSVN	hawkinson
HAYVKZ	hlavenka
HAYVL	havel
HAYZ	hafiz
HAYZ	hafiz
HAZN	hazen
HBNTVN	hebenton
HBRN	harburn
HBRVQ	hebrew
HBVRN	harburn
HBYBA	habiba
HBYBH	habib
HDAD	haddad
HDAK	chandrasekhar
HDAVY	hadavi
HDAYA	hadaya
HDAYA	hadaya
HDAYDAH	hudaydah
HD	hadj
HDLND	hadland
HDLND	hadland
HDLVND	hedlund
HDLY	hadley
HDRAMAVT	hadramawt
HDRAMVT	hadramawt
HDRMAT	hadramawt
HDRYK	hedrick
HDSA	hindustan
HDS	hades
HDYA	hadaya
HDYDA	hudaydah
HDYDH	hudaydah
HDYH	hudaydah
HDYL	hadil
HDYN	hedin
HFRVN	heffron
HFSA	hafsah
HFSAH	hafsah
HFS	hfs
HFSH	hafsah
HGARTY	hegarty
HGLND	hagland
HGTYLYNG	houghtailing
HGY	hegyi
HGY	hegyi
HGYR	hager
HHMN	hehman
HJR	hajar
HJRY	hajery
HK	hak
HKR	harker
HKR	harker
HKSAV	hokusai
HKSV	hanks
HKT	hakluyt
HKTVR	hector
HKYM	hakim
HKYNG	hawking
HKZN	hekezen
HLAB	halab
HLAL	helal
HLAN	hulan
HLAVYN	hlavin
HLB	halab
HLBLYNG	helbling
HLBYG	helbig
HLBYNG	helbing
HLD	heald
HLDN	holden
HLFMN	helfman
HLGA	helga
HL	hal
HLKANT	hellekant
HLK	helke
HLLR	haller
HLMN	helman
HLMN	helman
HLMNSTAYN	helmenstine
HLMR	hilmer
HLMZ	helmholtz
HLMZ	helmholtz
HLNA	helena
HLND	hyland
HLNDR	hollander
HLN	halon
HLN	halon
HLR	halar
HLSTRVM	hellstrom
HLT	helt
HLTLANDNSYS	holtlandensis
HLTLNDNSYS	holtlandensis
HLTVN	hilton
HLV	hlavin
HLVJ	hilletje
HLVM	holum
HLY	holy
HLY	holy
HLYNDN	hollinden
HLYVL	hall
HLZGNG	holzgang
HLZMN	holzman
HMAH	hamah
HMAM	hamam
HMANS	hamans
HMANZ	haman
HMAR	hallmark
HMBAYJ	hammarskjold
HMBYJ	hambidge
HMDAN	hamdan
HMD	hamad
HMH	hamah
HML	hamel
HMP	hempe
HMPSAYR	hampshire
HMPSR	hampshire
HMRA	hamra
HMR	hamer
HMR	hamer
HMR	hamer
HMSTD	hemstede
HMSYRH	hampshire
HMYD	hamid
HMYLTN	hamilton
HMYLTVN	hamilton
HMZA	hamza
HMZ	hamza
HMZH	hamah
HNA	hanaa
HNA	hanaa
HNAN	hanan
HNCLYF	hinchliffe
HND	hand
HNDL	handel
HNDRSN	henderson
HNDRSVN	henderson
HNDRYCVZ	hendricus
HNDRYCY	hendricus
HNDRYKA	chandrasekhar
HNDRYKAS	chandrasekhars
HNDRYK	hendriks
HNDRYKH	chandrasekhar
HNDRYKJ	hendrikje
HNDRYKJH	hendrikje
HNDRYKS	hendriks
HNDRYKS	hendriks
HNDRYKS	hendriks
HNDRYKSH	hendrikse
HNDRYKSN	hendrickson
HNDRYKSVN	hendrickson
HNDRYKVS	hendriks
HNDRYKY	hendrikje
HNDY	handy
HNDZ	hernandez
HN	han
HN	han
HNJ	hentje
HNJY	hentje
HNKL	henkel
HNKS	hanks
HNL	henle
HNLY	heinly
HNNFNT	hennenfent
HNRYK	henrik
HNRYT	henriet
HNSLY	hensley
HNSN	hansen
HNT	hunt
HNTH	hanebuth
HNTJ	hentje
HNTJH	hentje
HNTYG	hentig
HNYA	haniyya
HNYFA	hanifa
HNYFH	confucian
HNYGAN	henegan
HNYG	honig
HNY	handy
HNY	handy
HNYJ	hentje
HNYK	hank
HNYNGSN	henningsen
HNY	handy
HNZ	hinz
HPKRAFT	hopcraft
HPLR	hepler
HQYR	huyer
HRABY	hrabi
HRAK	horak
HRAN	horan
HRANYKY	hranicky
HRAYZYNG	hertzsprung
HRBAYJ	carbajal
HRBRT	herbart
HRBVRT	herbert
HRBYJ	carbajal
HRDASFYLD	herdsfield
HRD	herd
HRD	herd
HRDSFYLD	herdsfield
HRDZFYLD	herdsfield
HR	har
HRLAYNDYZ	harland
HRLNDYS	herlindis
HRLVY	harley
HRLYNDYS	herlindis
HRMAN	harman
HRMAN	harman
HRMAN	harman
HRMAN	harman
HRMANS	hermans
HRMN	harman
HRMN	harman
HRMN	harman
HRMN	harman
HRMNVS	harmanus
HRMNYVS	harmanus
HRMS	harms
HRMVSV	hermoso
HRMZ	hormuz
HRNAKY	hernacki
HRNANDZ	hernandez
HRNDVN	herndon
HRN	horn
HRN	horn
HRN	horn
HRNKR	hornecker
HRNSBAY	hornsby
HRRA	herrera
HRSFAL	horsfall
HRT	hart
HRTLYNG	hertling
HRTVK	hertweck
HRV	harv
HRVN	huron
HRVNYMVS	hieronymus
HRVS	harvards
HRVY	harvey
HRYK	henrik
HRYKN	haricken
HRYNG	harding
HRYNGSAV	herringshaw
HRYS	harrys
HRYSVN	hardison
HRYT	harith
HRYVL	harvell
HSAKA	hasakah
HSAKAH	hasakah
HS	hs
HS	hs
HSH	harsh
HSKAH	hasakah
HSKH	hesketh
HSMANS	heismans
HSMNS	heismans
HSNA	hasna
HSN	hosn
HSN	hosn
HST	haste
HSTR	hester
HSTYNGZ	hastings
HSYMANZ	hesemans
HSYN	hyson
HSYN	hyson
HSYN	hyson
HSYN	hyson
HTCR	hatcher
HTKVKS	hakkas
HTRYK	hetrick
HTZLR	hetzler
HVADLY	headley
HVA	havana
HVAR	havard
HVBR	huber
HVBRMN	hoberman
HVBVRVG	heiberg
HVBVRV	huber
HVBVRVQ	hebrew
HVCYNSVN	hutchinson
HVDAYDAH	hudaydah
HVDGY	hodge
HVD	hviid
HVDKYNS	hodgkins
HVDKYNZ	hodgkin
HVDSN	hodson
HVDSVN	hodson
HVFGARD	hofgaard
HVFRD	hoford
HVFRYN	heffron
HVFT	hooft
HVGAN	hogan
HVGARD	hugard
HVGARD	hugard
HVGARTY	hegarty
HVG	hug
HVG	hug
HVG	hug
HVGLND	highland
HVGNBVM	hoogenboom
HVGN	hogan
HVGS	hgs
HVGTAYLYNG	houghtailing
HVGTYLYNG	houghtailing
HVGV	hipgrave
HVGVYN	hoogeveen
HVHNSVN	hohensohn
HV	harv
HV	harv
HVK	hlavenka
HVKN	hawken
HVLAND	heiland
HVLDN	holden
HVLDZVRS	holders
HVL	havel
HVL	havel
HVLKAMB	hohokam
HVLKNR	holkner
HVLM	holm
HVLMN	helman
HVLMZ	helmholtz
HVLNDNSYS	holtlandensis
HVLRVYD	holroyd
HVLS	havolines
HVLSTN	holsten
HVLTLNDNSYS	holtlandensis
HVLYMN	hollyman
HVLZN	holzen
HVLZVARS	hilarys
HVMAK	ohmaki
HVM	heim
HVM	heim
HVMN	homan
HVNG	hong
HVNYGBRG	honigberg
HVP	heep
HVP	heep
HVPR	hepler
HVQTYLYNG	hertling
HVQYM	hoyman
HVRGAN	horgan
HVRKAN	horkan
HVRN	horn
HVRNR	horner
HVRSFVRD	horsford
HVRST	herst
HVRTMN	hortmann
HVRTR	harter
HVRVAT	horvat
HVRVT	horvat
HVRVVYTZ	horowitz
HVRVYTZ	horowitz
HVRYGMV	horrigmo
HVRYHAN	hourihan
HVRY	henry
HVRYNG	herring
HVRYV	henry
HVS	hovis
HVSMN	heisman
HVSTVN	heston
HVTN	hawtin
HVVART	havarti
HVVN	haven
HVVR	hoover
HVYA	hadiya
HVYBRG	heiberg
HVYD	hyde
HVYGN	huygens
HVYJN	cootjans
HVYMAN	hoyman
HVYNG	hewing
HVYSR	huyser
HVYT	hakluyt
HVYTYNK	hoitink
HVYYSKN	huisken
HVZ	hvezda
HYBAX	hyderabad
HYBRG	heiberg
HYBRT	hebert
HYBVRN	hebborn
HYCMN	hitchman
HYCNS	oxycontins
HYDAJAT	hidajat
HYDLAND	headland
HYDN	haydn
HYDN	haydn
HYDNR	heidner
HYDR	hydra
HYDRYC	heidrich
HYDRYS	hydras
HYFA	haifa
HYFLR	heffler
HYFTZ	heifetz
HYGARTY	hegarty
HYGL	hegel
HYGN	huygens
HYGRMN	hegermann
HYGVNT	higonnet
'HYH	ehrlich
HY	hay
HYJDAN	wijdan
HYJMN	hyman
HYKARV	hikaru
HYK	heeswyk
HYKMN	hickman
HYKSVN	hawkinson
HYKV	heeswyk
HYKY	hickey
HYKY	hickey
HYLBRY	hillberry
HYLDBRAND	hildebrand
HYLD	hyland
HYL	hoyle
HYL	hoyle
HYL	hoyle
HYL	hoyle
HYL	hoyle
HYLKR	hilker
HYLMR	hilmer
HYLNBRND	hillenbrand
HYLND	hyland
HYLND	hyland
HYLNTH	hellenistic
HYLRY	hilary
HYLS	honeywells
HYLSNTYGR	hilsenteger
HYLSVN	hilson
HYLT	haylett
HYLTH	hollerith
HYLT	haylett
HYLTJ	heyltje
HYLTJH	heyltje
HYLTJH	heyltje
HYLTJ	heyltje
HYLTN	hilton
HYLYARD	hillyard
HYLY	holy
HYLYRSTYN	hellerstein
HYLYS	hilarys
HYLYTH	hollerith
HYLZ	hiltz
HYM	hyman
HYMN	hyman
HYMN	hyman
HYMSTD	hemstede
HYNCLY	hinchley
HYNCY	hinchey
HYND	hyland
HYNDRYKA	chandrasekhar
HYNGAN	henegan
HYNG	hong
HYN	hyun
HYNJ	hentje
HYNLY	heinly
HYNR	henri
HYNS	hynes
HYNS	hynes
HYNS	hynes
HYNSVN	heymanson
HYNTVN	oxycontin
HYNTZ	heintz
HYNV	hynes
HYNVNN	heinonen
HYNVZ	hinz
HYNZ	hinz
HYNZ	hinz
HYNZ	hinz
HYNZ	hinz
HYNZ	hinz
HYPGRYV	hipgrave
HYP	hyslop
HYPS	hyperions
HYRAY	hydra
HYRDGN	heerdegen
HYRD	hayward
HYRLY	hurley
HYRN	hyperion
HYRNH	herringshaw
HYRN	hyperion
HYRT	hayworth
HYRVNYMAS	hieronymus
HYRVNYMVS	hieronymus
HYRVTA	hirota
HYSAN	hisan
HYS	hays
HYSKVKS	hoskins
HYSKVT	hesketh
HYSLAP	hyslop
HYSL	hyslop
HYSLVP	hyslop
HYSMANS	heismans
HYSMNS	heismans
HYSR	huyser
HYTN	oxycontin
HYTR	hayter
HYTR	hayter
HYTS	hayworths
HYTSVN	hitson
HYTVN	oxycontin
HYTZ	hitz
HYTZ	hitz
HYVARD	hayward
HYVGN	huygens
HYV	hyvonen
HYVKYNZ	heinz
HYVM	hyman
HYVNGAN	henegan
HYVNSV	hyunsoo
HYVVYT	hayworth
HYVZ	hvezda
HYVZR	holzer
HYYN	hyun
HYZ	hinz
HYZMAN	holzman
HYZMANS	heezemans
HYZMNS	heezemans
HYZMNZ	holzman
HYZYMNZ	heezemans
HZLTVN	hazelton
HZMNZ	holzman
JABJH	jacobje
JAB	joab
JAB	joab
JAD	jared
JAD	jared
JAD	jared
JAGARD	jagard
JAG	jago
JAGR	jager
JAGV	jago
JAHMANH	jahmane
JAHNS	jahangirs
JAKAMYNTH	janakiraman
JAKSVN	jackson
JAKVAS	jakartas
JAKVBH	jakobsson
JAKVB	jakobsson
JAKVBJH	jacobje
JAKVBJ	jacobje
JAKVBS	jakobsson
JAKVBSVN	jakobsson
JAKVBSVN	jakobsson
JAKVBY	jakobsson
JAKVBZ	jakobsson
JAKVMYNTAY	jacomyntie
JAKVMYNTYH	jacomyntie
JAKVMYNTY	jacomyntie
JAKVMYT	jacomyntie
JAKVS	jakes
JAKVYZ	jacky
JAKVZ	jackie
JAKYVZ	jacky
JALA	jala
JALVNN	jalonen
JAMVNA	jamuna
JANA	jana
JANARDHAN	janardhan
JANATVN	jonathon
JANCS	janches
JANG	jang
JANG	jang
JANG	jang
JANGNYKL	jungnickel
JANGR	jahangir
JANGTAYY	jongtae
JAN	jan
JAN	jan
JAN	jan
JAN	jan
JANK	jansky
JANK	jansky
JANKYNSVN	jenkinson
JANSH	jans
JANS	jans
JANSJH	jansje
JANSJ	jansje
JANSKY	jansky
JANSN	jansen
JANSN	jansen
JANSVN	jansen
JANSVN	jansen
JANTH	jaantje
JANT	janet
JANT	janet
JANTJ	jaantje
JANTVJ	jaantje
JANTYH	jaantje
JANVTH	janet
JANVT	janet
JANVTJH	janotje
JANY	jansky
JANYKA	janecka
JANZ	janzen
JANZ	janzen
JAP	japan
JAPJH	jaepje
JAPJ	jaepje
JARAS	jarash
JARBVT	jarbot
JARDYN	jardine
JARS	jamars
JART	jarbot
JARVALA	jarwala
JARVYS	jarvis
JARYTJN	zjarritjen
JASCK	jaschek
JAS	jans
JASPR	jasper
JASPRZ	jasper
JASTAM	justham
JASTAS	juanitas
JASTJH	justje
JASTJ	justje
JAST	ojaste
JASTJY	justje
JASTYH	ojaste
JASTYN	jamestown
JASTYN	jamestown
JASTYN	jamestown
JASTYN	jamestown
JASTYS	jansenists
JASVA	jocasta
JASVYNDR	jasvinder
JATJY	jaantje
JATYNDR	jatinder
JAVF	jawf
JAVYD	javed
JAVYKA	janecka
JAVYR	javier
JAYAN	jayan
JAYANT	jayant
JAYARAM	jayaram
JAYN	jayan
JAYN	jayan
JAYNVR	janairo
JAYP	jayapura
JBHH	jehovah
JBH	john
JBYR	jabir
JDY	jody
JF	jawf
JF	jawf
JFKK	jeffcock
JFRY	jeffry
JFRYZ	jeffry
JHAMANH	jahamane
JHANG	jhang
JHAN	jehan
JHAR	johar
JHMANH	jahmane
JHRA	jahra
JKBS	jakobsson
JK	jack
JKMN	jackman
JKMN	jackman
JKSVN	jackson
JKVBS	jakobsson
JKVBSVN	jakobsson
JKVBZ	jakobsson
JKYN	jacklyn
JLA	jala
JLAL	jalal
JL	jul
JLJ	jeltje
JLNY	jalani
JLTH	walth
JLT	jeltje
JLTJH	jeltje
JLVMARK	jelvemark
JMAL	jamal
JMAL	jamal
JMAR	jamar
JML	jamal
JML	jamal
JMML	jamel
JMVLA	jamulla
JMYLA	jamulla
JMYLAH	jamilah
JMYLA	jamulla
JMYL	jamel
JMYLH	jamilah
JMYLH	jamilah
JMYL	jamel
JNAH	jenah
JNA	jana
JNDRYAV	indra
JNDRYC	jatinder
JNG	jang
JNG	jang
JN	jan
JNK	junk
JNK	junk
JNKS	jenks
JNKS	jenks
JNKYNSVN	jenkinson
JNKZ	jahnke
JNT	janet
JNTJS	jaantje
JNTRY	entropy
JNYFR	jenifer
JNYKH	jenneke
JNYK	junk
JNYNGZ	jenings
JNYRV	janairo
JNYSYLDA	gnishilda
JPSN	jeppesen
JPY	jaepje
JRADA	jerada
JRALD	jerald
JRARD	erhard
JRARD	erhard
JRARDY	ierardi
JRGNZ	jorgen
JRHARD	erhard
JRMYAS	jeremias
JRMY	jeremy
JRMYK	jeremy
JRMYS	jeremys
JRS	jrs
JRSTL	jerusalem
JRTRVD	jarred
JRVNYMVS	jeronimus
JRVNYVS	jeronimus
JRVYS	jeremys
JRYNG	jeng
JRYNGR	junger
JRYTSMA	jorritsma
JRYTY	jarbot
JRYTZVN	gerritzon
JSF	josef
JSPR	jasper
JSTR	jester
JSTVN	justin
JSYKA	jeske
JSYK	jaschek
JTRV	jethro
JTSAM	jetsam
JVAB	joab
JVANA	juana
JVANDR	juvander
JVANG	juang
JVAN	jovian
JVAN	jovian
JVANYTA	juanita
JVAV	java
JVAY	juay
JVBAL	jubal
JVBJ	jobje
JVB	job
JVB	job
JVBYN	jebsen
JVDAS	judas
JVD	javed
JVDY	jody
JVDY	jody
JVF	jawf
JVF	jawf
JVFL	juvenal
JVGLA	jougla
JVHANA	johanna
JVHAN	jehan
JVHANSN	johansen
JVHANSN	johansen
JVHANSVN	johansen
JVHANSVN	johansen
JVHANSVN	johansen
JVHANY	juhani
JVHANZ	juhani
JVHANZ	juhani
JVLAY	julia
JVL	juvenal
JVL	juvenal
JVLTZ	jeltje
JVLYANTH	juliaantje
JVLYANTJH	juliaantje
JVLYANTJ	juliaantje
JVLYANT	juliaantje
JVLYANY	jelleyman
JVLYF	jolliff
JVLY	joly
JVLY	joly
JVLY	joly
JVNAS	jonas
JVNGAN	jungian
JVNGANZ	joungane
JVN	jovian
JVN	jovian
JVN	jovian
JVNV	javanese
JVNY	jenny
JVNYN	jonin
JVNYVR	juvander
JVPRV	joppru
JVRAH	jurah
JVRA	joura
JVRAN	jirman
JVRAVLV	jouravlev
JVRGNZ	jorgen
JVRJ	zjarritjen
JVRJN	zjarritjen
JVRJN	zjarritjen
JVRJYA	jurua
JVRJYV	zjarritjen
JVRK	jelvemark
JVRVYTZ	juarez
JVRY	jory
JVRYNG	weaverling
JVRYSMA	jorritsma
JVRYTSMA	jorritsma
JVS	javas
JVSLYN	joslin
JVSTH	justham
JVSTJ	justje
JVSTY	justo
JVSVA	josefa
JVSVYG	joswig
JVSYP	josip
JVTLYN	jutland
JVVN	jovian
JVYDYP	joydeep
JVYNR	joyner
JVYNR	joyner
JVYSF	josef
JVYS	joys
JVYT	jayant
JVYT	jayant
JVZA	juza
JVZF	josef
JVZFVS	jenifers
JVZP	jeep
JVZY	jezire
JVZYH	jehovah
JVZY	jezire
JVZY	jezire
JYAF	jawf
JYA	jayan
JYAKVB	jakobsson
JYAN	jayan
JYANY	jayan
JYAVRDANY	janardhan
JYBSVN	jebsen
JYBYNS	jacobins
JYGANG	jigang
JY	jay
JY	jay
JYJSBRTVS	gijsbertus
JYKMN	jackman
JYLAM	jayaram
JYLBRT	joubert
JYL	jekyll
JYLT	jeltje
JYLYAN	jelleyman
JYLZ	jekyll
JYM	jaymes
JYML	jamal
JYMSVN	jameson
JYMY	jimmy
JYMYNY	jiminey
JYMZ	jimenez
JYMZ	jimenez
JYMZ	jimenez
JYNAKYRAMAN	janakiraman
JYNG	jeng
JYN	jayan
JYN	jayan
JYN	jayan
JYN	jayan
JYN	jayan
JYNS	jaynes
JYNTVN	johnston
JYNYK	junk
JYNZ	jimenez
JYPH	joesph
JYRARDYN	jayawardene
JYRMASKA	jeremias
JYRVSK	jirousek
JYSH	josh
JYS	joys
JYSR	jesper
JYSTR	jester
JYSVZ	jayson
JYTA	jitta
JYVK	jelvemark
JYVRDANV	jordan
JYVVANY	jovian
JYVVYL	jekyll
JYVYL	jekyll
JYZAN	jizan
JYZN	jizan
JYZSBRTVS	gijsbertus
JZYRH	jezire
KAB	kalb
KABRYLV	karayel
KACLYNG	kuchling
KACV	kacalek
KACVN	kacandes
KACY	kacalek
KACYH	karachi
KADLASK	kalashnikov
KADMN	kaden
KADMVS	kalemis
KADN	kaden
KADRYBYSYK	kadribasic
KADRYKYS	kudreikis
KADV	kado
KADYN	kaden
KAFRY	karty
KAFY	kafka
KAFYN	kaifeng
KAGBVRN	pangborn
KAGL	kagle
KAGL	kagle
KAGLYN	kalyan
KAGSAL	kagoshima
KAGSVL	kagle
KAHAN	kahane
KAHVN	kahane
KAKALK	koukalik
KAKANDS	oaklands
KA	kai
KAKBRYD	cakebread
KAKDKAR	kakodkar
KAKRAFT	kalafut
KAKRYL	karayel
KAKSHD	karakash
KAKTVS	krakatoas
KAKY	kamskaya
KAKYVLA	kayla
KAKYVR	kakure
KALA	kalia
KALAFATAS	kalafatas
KALAFVT	kalafut
KALAHAN	kalahari
KALANAN	kalpana
KALATVR	kalathur
KALBAVT	kalafut
KALB	kalb
KALB	kalb
KALBRYJ	kallberg
KALBYDA	kulbida
KAL	kalb
KALDL	kaldis
KALDVL	kalevala
KALDVL	kalevala
KALDYS	kaldis
KALHYN	kalashnikov
KALHYNH	kalashnikov
KAL	kalb
KALKAN	kalkan
KALKLASVR	kasmalkar
KALMAN	kalman
KALMN	kalman
KALMN	kalman
KALMYS	kalemis
KALPAK	kalpak
KALPANA	kalpana
KALPS	kalpesh
KALPYN	kalpana
KALR	kalahari
KALRTY	karty
KALRY	kalahari
KALSGH	kalish
KALSVN	karlsson
KALSYN	karlsson
KALT	kalt
KALTVN	walton
KALV	kalev
KALVM	kalemis
KALVNLV	kalevala
KALVRT	kalt
KALVYN	kalyan
KALYA	kalyan
KALYAN	kalyan
KALYANY	kalliany
KALYARV	kalahari
KALY	kalmyk
KALYGY	kallberg
KALYLA	kalila
KALYNSAN	kansan
KALYNT	kalyan
KALYNZ	kalyan
KALYS	kodalys
KALYS	kodalys
KALYSYAK	kalisiak
KALYYVS	kodalys
KAMACV	karamazov
KAMALA	kamala
KAMAL	kamal
KAMAMA	kamehameha
KAMAR	kamdar
KAMAT	kamath
KAMB	kamb
KAMBS	kamb
KAMBYTZ	korambath
KAMBYY	kamb
KAMBZ	kamb
KAMDAR	kamdar
KAMHVLZ	kamholz
KAM	kam
KAM	kam
KAML	kamal
KAMLN	kamelen
KAMLYS	kamlish
KAMN	kamen
KAMNS	kamens
KAMPAGNA	campagna
KAMPAR	kamper
KAMPBL	kampala
KAMP	kampe
KAMPR	kamper
KAMPTVN	kapetan
KAMPVS	kamphuis
KAMPYLV	kampala
KAMPYVTR	kamper
KAMR	kamdar
KAMRVD	kamerud
KAMRVN	karvinen
KAMRVS	kramers
KAMSKAYA	kamskaya
KAMSTAK	kalisiak
KAMYA	kamiya
KAMYNG	kaifeng
KAMYN	kamen
KAMYV	kalmyk
KANAKAKVRN	kanakakorn
KANA	kana
KANAK	kanak
KANAL	kanal
KANAL	kanal
KANAN	kannan
KANAVA	kanaka
KANBVY	yekaterinburg
KAN	kan
KANDAYV	kanda
KANDLY	kandell
KANDV	kandi
KANDVYYT	kandinsky
KANDY	kandinsky
KANFR	kanpur
KANFYLD	canfield
KANG	kang
KANG	kang
KANG	kang
KAN	kan
KANKNT	kanakakorn
KANLN	kaitlin
KANLY	kanal
KANLY	kanal
KANN	kannan
KANR	kanpur
KANRLY	kinnersley
KANRVY	kanamori
KANSL	kans
KANSTABARYS	constabaris
KANSTABV	konestabo
KANTARA	cantara
KANTH	kant
KANT	kant
KANT	kant
KANTRA	kantian
KANTR	kanter
KANTRL	kantola
KANV	kamenev
KANVRY	kanamori
KANYA	krasnoyarsk
KANYF	kandolf
KANYG	kang
KANYNGHAM	kanchenjunga
KANYS	krasnoyarsk
KANYSNA	kannan
KANYTZ	kazantzakis
KANYVN	kantian
KANZY	kanze
KAPA	kappa
KAPANGA	kapanga
KAP	kapp
KAPK	kalpak
KAPLAN	kaplan
KAPLN	kaplan
KAPLYNK	kaplenk
KAPNR	kapner
KAPRAL	kapral
KAPS	kaposi
KAPSVN	kapson
KAPVR	kamper
KAPYLA	kapila
KARABVLVT	karabulut
KARAGR	kariger
KARAHR	karachi
KARA	kara
KARANJLV	karabulut
KARAN	karan
KARARA	karaca
KARASA	karasu
KARAS	karas
KARASKV	kalashnikov
KARASV	karasu
KARAYL	karayel
KARBAJAL	carbajal
KARBALA	karbala
KARBN	karen
KARBVNLY	karabulut
KARBVNYA	karenina
KAR	kar
KARDAL	kardal
KARDL	kardal
KARDL	kardal
KARDLYS	kardelis
KARDNAS	karinas
KARDYNALY	kardal
KARGYL	karayel
KARHART	earhart
KARKARN	kanakakorn
KARKAS	karakash
KARLAYL	karayel
KARL	karl
KARL	karl
KARLKVYST	karlquist
KARLS	karls
KARLSVN	karlsson
KARLTVN	karlsson
KARLTVN	karlsson
KARLVS	karls
KARLVT	karabulut
KARLYN	karlsson
KARLYN	karlsson
KARMAN	karmann
KARMVDY	karamazov
KARMVNA	karenina
KARMYCAYL	karayel
KARN	karn
KARN	karn
KARNLYAN	carnelian
KARNR	karner
KARNRY	karner
KARNYA	karenina
KARNY	karn
KARNY	karn
KARNZ	karn
KARP	karp
KARPLAS	karplus
KARPNTR	carpenter
KARPNTYR	carpenter
KARSTNSN	carstensen
KARSTNZ	kastner
KARSVN	karlsson
KARSVN	karlsson
KART	karty
KARTNR	karner
KARTRAYT	katryntje
KARTR	karner
KARTVYZ	karty
KARTY	karty
KARTYK	kartik
KARTYR	karty
KARTYS	kmarts
KARVLYN	karlsson
KARVR	karner
KARVSV	kharkovs
KARVSV	kharkovs
KARVYN	karyn
KARYAGA	karaganda
KARY	karty
KARY	karty
KARYDA	karida
KARYDYAN	karridian
KARYH	karish
KARYJR	katryntje
KARY	karty
KARYLV	karayel
KARYRA	karras
KARYS	karyns
KASAK	kalisiak
KASAMA	kasama
KASAM	kasama
KASANVVA	kansan
KASARA	kasahara
KASAT	kasat
KASGRVH	kasterchem
KASL	kasmalkar
KASLMN	kalman
KASM	kassem
KASMN	klansman
KASMYCY	klausmeier
KASNR	kastner
KASNYR	krasnoyarsk
KASPRZAK	kasprzak
KASRTYNV	kastein
KASRYL	karayel
KASTA	kazakhstan
KASTANV	kazakhstan
KASTLV	kaitlin
KASTLV	kaitlin
KASTNR	kastner
KASTNR	kastner
KASTRCM	kasterchem
KASTRGYN	castergine
KASTR	kastner
KASTRV	kastrup
KASTRYKAM	kasterchem
KASTRYKVM	kasterchem
KASTRYVM	kasterchem
KASTVL	kastein
KASTVRY	kasturi
KASTY	kasaty
KASTYLV	kasaty
KASTYN	kastein
KASVF	kasouf
KASVN	kasun
KASY	kasey
KASYNG	kaohsiung
KASYNLY	krasnoyarsk
KASYNSKY	krasnoyarsk
KASYV	kasey
KATA	katina
KATALANV	katwala
KATAN	kantian
KATARYN	katharine
KATB	kateb
KATBRT	katryntje
KATCY	katowice
KATKART	katiyar
KATL	kathol
KATL	kathol
KATLMN	katleman
KATLR	kanter
KATLYR	katiyar
KATN	katen
KATR	kanter
KATRNTJ	katryntje
KATRYJ	katryntje
KATRYJN	kathryn
KATRY	kathryn
KATRYNA	katrina
KATRYNA	katrina
KATRYN	kathryn
KATRYN	kathryn
KATRYN	kathryn
KATRYN	kathryn
KATRYN	kathryn
KATRYNTH	katryntje
KATRYNTJH	katryntje
KATRYNTJ	katryntje
KATRYNTY	katryntje
KATVALA	katwala
KATVPYS	katopis
KATY	katy
KATYNG	keating
KATZ	katz
KAVASYN	kalashnikov
KAVAYY	karayel
KAV	kave
KAV	kave
KAVDLYNG	katelyn
KAVDYL	kardel
KAVH	kaveh
KAVH	kaveh
KAV	kave
KAVLY	kalmyk
KAVLY	kalmyk
KAVLYNG	kalyan
KAVN	keaven
KAVRZ	kasprzak
KAVS	kharkovs
KAVSTN	kastein
KAVYTA	kavita
KAYA	kaya
KAYAK	kayak
KAY	kay
KAYK	kayak
KAYLAS	kaylas
KAYL	kayla
KAYN	karyn
KAYN	karyn
KAYNY	karyn
KAYPR	kamper
KAYRAS	karas
KAYRD	kamerud
KAYRVF	kairoff
KAYSR	kayser
KAYT	kuwayt
KAYT	kuwayt
KAZDAN	kazdan
KAZGRYF	kairoff
KAZMAYR	kazmaier
KAZVHYRV	kazuhiro
KAZVNVZY	kazantzakis
KAZY	kazi
KAZYR	klazura
KAZYRR	karr
KBAKYAN	kabakian
KBAKYBV	kabakibo
KBANYS	kianos
KBRG	ekberg
KBR	kabir
KBYR	kabir
KBYR	kabir
KCNG	kecheng
KDAVR	kedar
KD	kid
KDL	kardal
KDL	kardal
KDR	kedar
KDYM	kodachrome
KDYN	kaden
KDYRA	keidra
KDYR	kinder
KDYSYA	kurdistan
KDYSYH	kurdish
KFART	karty
KHV	keshav
KK	kok
KLABVRN	claborn
KLAF	kalafut
KLAG	klug
KLAG	klug
KLAGSTVN	langston
KLAK	kalpak
KLAMN	klansman
KLAMR	klammer
KLANFYLD	clanfield
KLANSY	klans
KLANTVN	kantian
KLARJH	klaartje
KLARK	karak
KLARK	karak
KLAR	kelkar
KLARTAY	klaartje
KLARTH	klaartje
KLARTJH	klaartje
KLARTJ	klaartje
KLARTJY	klaartje
KLART	klaartje
KLARTY	klaartje
KLARYJ	klaartje
KLASA	klassa
KLASJ	klans
KLASJH	kalashnikov
KLASMYR	klausmeier
KLASN	klassen
KLASNR	klausner
KLAT	klatt
KLATZ	klotz
KLAVDYA	kilauea
KLAVDY	kolstad
KLAVSY	klaus
KLAVYTR	klawiter
KLAYN	klan
KLAYN	klan
KLAYR	klammer
KLAYSJ	klaus
KLAYSVN	klassen
KLAYSVN	klassen
KLAYTVN	keaton
KLAZ	klazura
KLAZVRA	klazura
KLAZYNG	kaifeng
KLBAY	kilbane
KLB	kalb
KLBRN	wilburn
KLBVRN	wilburn
KLBVRN	wilburn
KLBY	kilby
KL	kalb
KLDNY	kolodny
KLDVL	kuldell
KLDVY	kolodney
KLFLT	kalafut
KLKAR	kelkar
KL	kalb
KL	kalb
KLMANZ	kalman
KLMBV	kaleb
KLMN	kalman
KLMP	klemp
KLNFYLD	clanfield
KLN	klan
KLN	klan
KLNR	kellner
KLRTAY	klaartje
KLRTY	klaartje
KLRVS	kilroys
KLT	kalt
KLTN	keltner
KLTNR	keltner
KLVB	kaleb
KLVBK	kloubek
KLVKYNAS	kloukinas
KLVLY	kelly
KLVMPNR	kilimanjaro
KLVNFRV	klausner
KLVSN	klausner
KLVTH	kalathur
KLVYNN	kelvinen
KLYBR	klyber
KLYBRN	klyber
KLY	kelly
KLY	kelly
KLYF	eklof
KLYFRD	elford
KLYFT	kalafut
KLYFTVN	kalafut
KLYK	kalmyk
KLY	kelly
KLY	kelly
KLYLA	kalila
KLYMR	klemmer
KLYMVF	kelimoff
KLYNGRVT	klingler
KLYNK	klinck
KLYN	kalyan
KLYN	kalyan
KLYNSVRG	kleinsorge
KLYNZ	kalyan
KLYR	klyber
KLYR	klyber
KLYR	klyber
KLYR	klyber
KLYRTYH	keerthi
KLYS	kelleys
KLYSH	kalish
KLYTVN	keltner
KLYVY	kelley
KMA	kama
KMAL	kamal
KMAL	kamal
KMBRY	kimberey
KMBS	kimberlys
KMBZ	kamb
KMDR	kamdar
KMFVYS	kimberlys
KMFYLD	camfield
KM	kam
KMKR	kemker
KMLLV	kimball
KMPASTR	kempster
KMPBL	kampala
KMP	kemp
KMP	kemp
KMPR	kamper
KMPSTR	kempster
KMPVS	kempis
KMPY	kampe
KMR	khmer
KMR	khmer
KMR	khmer
KMRVN	kumaran
KMSPTR	kempster
KMSTR	kempster
KMYLAH	kamilah
KMYLA	kamala
KMYLH	kamilah
KMYR	kammeyer
KNAMVRY	kanamori
KNAVAY	kennaway
KNDAL	kendal
KNDL	kendal
KNDRYK	kendrick
KNDV	kandi
KNDVLF	kandolf
KNDY	kennedy
KNDYG	kendig
KNDY	kennedy
KNG	kang
KNG	kang
KN	kan
KN	kan
KN	kan
KNNYNG	kenning
KNPVL	knispel
KNRAD	konrad
KNRAD	konrad
KNRAD	konrad
KNRADVS	konrads
KNRAT	kraft
KNRDYNG	konerding
KNR	kanpur
KNSYNGTV	kensingto
KNTA	kenta
KNTARV	kentaro
KNVB	knob
KNVFYNKH	knufinke
KNVL	knievel
KNY	keny
KNY	keny
KNYKRBKR	knickerbacker
KNYNGTVN	kennington
KNYN	kenyan
KNYSKY	kandinsky
KNYVN	kenyon
KNYVN	kenyon
KNZ	kenz
KPJH	kapje
KPL	kapila
KPLY	kepley
KPR	koper
KPRT	kephart
KPTAN	kapetan
KPYSTRAN	kusterman
KRAB	krab
KRA	kara
KRACLY	karabulut
KRACLY	karabulut
KRACN	kragen
KRACR	kramer
KRAKART	krakatoa
KRAKFRD	karakorum
KRAKFVRD	karakorum
KRAK	karak
KRAK	karak
KRAKT	krakatoa
KRAMARY	kramer
KRAMHVRN	kramer
KRAMR	kramer
KRANDLMYR	crandlemire
KRANSVYK	krasnoyarsk
KRANSVYYK	krasnoyarsk
KRANZVYK	krasnoyarsk
KRAP	koorapaty
KRAPR	kramer
KRAQTVN	keaton
KRARAS	karas
KRASBY	krasnoyarsk
KRAS	karas
KRASN	krasen
KRASYK	krasnoyarsk
KRATR	kratzer
KRATRZ	kratzer
KRATYGR	krattiger
KRATZR	kratzer
KRAVFVRD	kierkegaard
KRAVL	kapral
KRAVLY	karabulut
KRAVN	kragen
KRAVN	kragen
KRAVSVN	krasen
KRAY	karayel
KRAYDR	krasnodar
KRAYG	kraig
KRAYG	kraig
KRAYJ	kraaij
KRAYJ	kraaij
KRAY	karayel
KRAYSVL	karayel
KRAZN	kragen
KRAZYR	kratzer
KRBLA	karbala
KRBL	kerbel
KRBSR	krebser
KRBTRY	krebser
KRBVNYL	kerbel
KRBYT	karabulut
KRC	kroc
KRDAL	kardal
KRDLA	kerila
KRDL	kardal
KRDRY	krasnodar
KRFT	kraft
KRFTVN	kresten
KRG	krug
KRG	krug
KRGR	kerger
KRGR	kerger
KRHANG	kerhong
KRH	krech
KR	kr
KRK	kirk
KRKRAFT	krakatoa
KRKRAFT	krakatoa
KRLY	kimberly
KRLYVS	kimberlys
KRMR	kramer
KRMYK	kalmyk
KRMYT	kermit
KRNAY	karina
KRNFRD	kingsford
KRN	karn
KRN	karn
KRN	karn
KRNL	kornele
KRNLYS	kringles
KRNLYVS	kringles
KRNS	kerns
KRNSVYK	kerensky
KRNVL	kornele
KRNYZ	krenz
KRNZ	krenz
KRPS	karplus
KRRAY	karras
KRS	krs
KRS	krs
KRS	krs
KRSKYNTYH	kristijntje
KRSLYK	kerslake
KRSN	krasen
KRSNR	krasner
KRSNR	krasner
KRSNV	krasner
KRSPV	kristopher
KRST	krista
KRSTN	kerstin
KRSTS	kristas
KRT	kert
KRTLND	kirkland
KRTR	kratzer
KRTYN	kerstin
KRTZR	kratzer
KRVASH	karakash
KRVASZ	karasu
KRVB	krob
KRVCFVRD	orford
KRV	kirov
KRVD	karida
KRVG	krug
KRVKFVRD	kierkegaard
KRVK	krok
KRVKN	kropotkin
KRVL	karol
KRVM	karim
KRVM	karim
KRVMH	korambath
KRVM	karim
KRVM	karim
KRVMN	kriman
KRVMR	kromer
KRVMY	kromer
KRVMYTS	kermits
KRVNHYM	kasterchem
KRVNY	kerensky
KRVNZ	krenz
KRVPYK	kropik
KRVSBY	krissy
KRVSCN	kruschen
KRVS	kharkovs
KRVSH	kresh
KRVSN	kresna
KRVSN	kresna
KRVTYV	kristy
KRVVD	kerwood
KRVYL	karayel
KRVYN	karyn
KRVYR	krasnoyarsk
KRVZ	krenz
KRVZYR	kretzer
KRY	kory
KRYCFYLD	critchfield
KRY	kory
KRYDA	karida
KRYDR	krasnodar
KRYGAN	kerrigan
KRYG	kirinyaga
KRYG	kirinyaga
KRYGR	kriger
KRYGR	kriger
KRY	kory
KRYK	korzybski
KRY	kory
KRY	kory
KRYLA	kerila
KRYLAS	karlas
KRYL	karayel
KRYLYZ	karayel
KRYM	karim
KRYMN	kriman
KRYN	karyn
KRYN	karyn
KRYN	karyn
KRYNZ	krenz
KRYPYV	koorapaty
KRYQR	krasnoyarsk
KRYR	krasnoyarsk
KRYSAN	kyrgyzstan
KRYSAYNTAY	krystal
KRYS	korys
KRYSC	krasic
KRYS	korys
KRYS	korys
KRYSH	kresh
KRYSJH	krisje
KRYS	korys
KRYS	korys
KRYSP	kristopher
KRYSPN	kyrgyzstan
KRYSPYJN	krisoijn
KRYSPYN	kyrgyzstan
KRYSSAYNTYH	kasemsant
KRYSTA	krystal
KRYSTA	krystal
KRYSTAL	krystal
KRYSTAL	krystal
KRYSTAL	krystal
KRYST	krystal
KRYSTLR	kristler
KRYSTMN	kyrgyzstan
KRYSTMN	kyrgyzstan
KRYSTN	kyrgyzstan
KRYSTR	krister
KRYSTV	krystal
KRYSTVF	krystal
KRYSTVFR	krister
KRYSTVFRSVN	kesterson
KRYSTVN	kyrgyzstan
KRYSTVN	kyrgyzstan
KRYSTYANA	kyrgyzstan
KRYSTYAN	kyrgyzstan
KRYSTYAN	kyrgyzstan
KRYSTYANSN	kirghistans
KRYSTY	kristy
KRYSTY	kristy
KRYSTYJNTH	kristijntje
KRYSTYJNTJH	kristijntje
KRYSTYJNTJ	kristijntje
KRYSTYNA	kristina
KRYSTYN	kyrgyzstan
KRYSTYNH	kyrgyzstan
KRYSTYN	kyrgyzstan
KRYSTYN	kyrgyzstan
KRYSTYN	kyrgyzstan
KRYSTYNTY	kristijntje
KRYSVAYJN	kyrgyzstan
KRYSVJYN	krisoijn
KRYSVYJN	krisoijn
KRYSVYN	kyrgyzstan
KRYSVZN	kyrgyzstan
KRYSY	krissy
KRYSY	krissy
KRYSY	krissy
KRYSZ	korys
KRYTR	kretzer
KRYVAS	krystals
KRYVASZ	krystals
KRYVN	karyn
KRYVSN	kyrgyzstan
KRYVVNVZ	krenz
KRYYK	korzybski
KRZNA	karina
KSAVAN	kesavan
KSAV	keshav
KSAY	kushay
KS	ks
KSK	kesek
KSKYN	keskin
KSL	kislo
KSL	kislo
KSLN	keshlan
KSLR	kessler
KST	kast
KSTLAK	kostelak
KSTL	kristol
KSTLVT	koestler
KSTNR	kastner
KSTRAP	kastrup
KSTR	kester
KSTRCM	kasterchem
KSTRSVN	kesterson
KSVAN	kesavan
KSVN	kesavan
KSYDY	kingsford
KSYM	kassem
KSYM	kassem
KTAN	ketan
KTARA	kotara
KTB	kateb
KTCAM	ketcham
KT	ket
KT	ket
KTLAR	kelkar
KTL	ketil
KTL	ketil
KTLT	kelty
KTLY	ketley
KTNZRV	kastner
KTSYMATYDS	catsimatides
KTVLA	ketola
KTVYN	katelyn
KTY	katy
KTY	katy
KTYL	kettyle
KTZ	katz
KVAAYNTN	kantian
KVAKNBAS	kaunas
KVAKNBVS	quackenboss
KVA	kovar
KVAL	kalevala
KVALSYK	kalisiak
KVANBAY	kania
KVANG	kwang
KVANG	kwang
KVANG	kwang
KVAN	kevran
KVANLAN	kantian
KVANRAD	koenraad
KVANRAD	koenraad
KVANRADT	vancortlandt
KVANRADVS	konrads
KVANRDT	earnhardt
KVANRYD	kamerud
KVANTVN	kantian
KVARSKY	kovarski
KVARTZYTH	quartzite
KVASMAN	klansman
KVAST	kwast
KVASYM	kassem
KVATRYN	kathryn
KVAVRYNG	yekaterinburg
KVAYLYSY	kodalys
KVAYMAN	kaufman
KVAYNTANA	kantian
KVAYNTVN	kantian
KVAYT	kuwayt
KVBA	kobsa
KVB	kibo
KVB	kibo
KVBLA	kubla
KVBN	kobben
KVBSA	kobsa
KVBV	kibo
KVBV	kibo
KVBYB	kobb
KVBYLAH	kublai
KVBYLA	kubla
KVCAR	kuchar
KVC	koch
KVCRAN	kevran
KVCY	kovalcik
KVCYH	koch
KVDAMAH	kamath
KVDAMA	kama
KVDVGNV	keegan
KVDY	kidby
KVGANDA	konganda
KVGLAN	keelan
KVGLYN	katelyn
KVGVMA	kogoma
KVHAN	khan
KVHN	kuhn
KVJH	kaveh
KVJYAS	kojaks
KVKAL	kokal
KVKALYK	koukalik
KV	kave
KVKBRN	kanakakorn
KVK	kok
KVKFYLD	wakefield
KVK	kok
KVKNBAS	kloukinas
KVKNJ	kevorkian
KV	kave
KVK	kok
KVKRYL	karayel
KVKSVN	kazakhstan
KVKTAVAY	koktavy
KVKVNN	kokkonen
KVKVRK	kirkpatrick
KVKYA	kamskaya
KVLASA	kolasa
KVL	kevlar
KVL	kevlar
KVLKA	kelkar
KVLMN	kellman
KVLN	kolen
KVLN	kolen
KVLN	kolen
KVLNV	kellner
KVLR	kevlar
KVLSAR	kolesar
KVLS	knievels
KVLSVN	klassen
KVLT	kelty
KVLTY	kelty
KVLVL	kalevala
KVLYCALA	kolichala
KVLY	kelly
KVLY	kelly
KVLYHA	koliha
KVLYN	katelyn
KVLYNG	kipling
KVLYNGVVD	kipling
KVLYNS	katelyns
KVLYNZ	katelyn
KVLYR	klyber
KVLYS	kelleys
KVMAR	kumar
KVMARV	kumar
KVMBR	kimberey
KVMPTVN	kempster
KVMR	kumar
KVMR	kumar
KVMVRV	kemerovo
KVMVRYTA	komorita
KVN	keven
KVNG	keng
KVNG	keng
KVNKA	kinkade
KVN	keven
KVN	keven
KVNRAD	konrad
KVNRAD	konrad
KVNRADVS	konrads
KVNRAT	kendra
KVNRAT	kendra
KVNRAYT	indrajit
KVNRYAT	kenyatta
KVNT	kent
KVNV	kamenev
KVNVPKA	konopka
KVNVR	kenner
KVNVVR	kenner
KVNYNG	koning
KVPJANZ	esperanza
KVPJ	kapje
KVP	kip
KVPLN	kipling
KVPLND	kipling
KVPLS	keplers
KVPNZ	kenz
KVPR	koper
KVPR	koper
KVPS	kips
KVRADYNY	kandinsky
KVRAM	kram
KVRAN	kevran
KVRAN	kevran
KVRAPATY	koorapaty
KVRBT	kiribati
KVRBYN	kirby
KVR	kovar
KVRDAS	kordas
KVRDS	kordas
KVRDYK	korzybski
KVRDZ	kordes
KVRKAM	kevorkian
KVRKVL	kirkland
KVRL	karl
KVRLY	kimberly
KVRN	kevran
KVRNLH	kornele
KVRNLVS	kringles
KVRNLYS	kringles
KVRNLYVS	kringles
KVRNLYVSN	kringles
KVRNLYZ	kornele
KVRNVAL	kornele
KVRNYVL	kornele
KVRNZ	krenz
KVRP	korp
KVRSL	kerslake
KVRSLV	kerslake
KVRSN	kursun
KVRSTN	kerstin
KVRT	kert
KVRTH	keerthi
KVRTL	kristol
KVRTLND	kirkland
KVRTLNT	kristijntje
KVRTRAYT	kortright
KVRTZ	kratzer
KVRVNLA	kerila
KVRVYN	karyn
KVRYA	kirinyaga
KVRY	kory
KVRY	kory
KVRYDVR	krasnodar
KVRYGAN	kerrigan
KVRY	kory
KVRY	kory
KVRYLA	kerila
KVRYL	karayel
KVRZAYN	kyrgyzstan
KVSADA	kurosawa
KVSAK	kusack
KVSAY	kushay
KVSH	kish
KVSJH	kish
KVSJ	koosje
KVSKY	kousky
KVSKYMAKY	koskimaki
KVSLV	kislev
KVSMANS	klansmans
KVSMANZ	kinsman
KVSMAS	klansmans
KVSMNS	klansmans
KVSNKV	kosenko
KVSTA	kosta
KVSTA	kosta
KVSTANZA	costanza
KVST	kosta
KVSTN	kosten
KVSTRMN	kusterman
KVSTYLV	kristol
KVSTYS	kristys
KVSVGH	kosuge
KVSYN	kosygin
KVSYRA	kusterman
KVSZ	kasprzak
KVTA	kavita
KVTCAY	ketcham
KVT	kavita
KVTCY	kitch
KVTJANZ	ketan
KVTLA	kotla
KVTMAYR	kottmeier
KVTNY	keltner
KVTRVNYV	kathrine
KVTY	kelty
KVTZ	kutz
KVVAR	kovar
KVV	kave
KVVS	kievs
KVYALSKY	kowalski
KVYALYK	kalmyk
KVY	kevyn
KVYCY	kovalcik
KVYK	kayak
KVYKNBAS	kloukinas
KVYKNBVS	kevorkians
KVYL	kyle
KVYL	kyle
KVYL	kyle
KVYLYN	katelyn
KVYMN	kimon
KVYN	kevyn
KVYN	kevyn
KVYN	kevyn
KVYN	kevyn
KVYN	kevyn
KVYN	kevyn
KVYN	kevyn
KVYNRAD	koenraad
KVYNRAD	koenraad
KVYNRAD	koenraad
KVYNRAT	kendra
KVYNRAYT	indrajit
KVYNRDVS	konrads
KVYNRYDVS	konrads
KVYNRYT	kingsnorth
KVYNTANA	konganda
KVYNTN	kenton
KVYNT	katryntje
KVYNTVN	kenton
KVYPR	kuyper
KVYRYN	kyrgyzstan
KVYSMAN	kinsman
KVYST	krystal
KVYT	kuwayt
KVYT	kuwayt
KVYYKL	kokal
KVYYLYN	katelyn
KVYYMAN	kinman
KVYYMN	kimon
KVYYNLN	keynesian
KVYYNTANAR	quintanar
KVYYNTVN	kenton
KVYY	kevyn
KVYYST	kyrgyzstan
KVYYT	kyrgyzstan
KVYYTZ	kewitz
KVYZMN	koizumi
KVZN	kazan
KVZV	kutuzov
KVZY	korzybski
KVZY	korzybski
KVZYN	knutzen
KYALASA	kailasa
KYASVN	kasun
KYAT	kenyatta
KYB	khyber
KYBH	korambath
KYBL	kubla
KYBL	kubla
KYBLR	kibler
KYBLR	kibler
KYBV	khyber
KYCN	kocian
KYCRV	kocourek
KYCYN	kocian
KYD	kid
KYD	kid
KYDL	kendal
KYDRA	keidra
KYF	kief
KYF	kief
KYFR	keifer
KYFR	keifer
KYGAN	kyrgyzstan
KYGYNZ	kyrgyzstan
KYHL	kohl
KYHV	kuibyshev
KYJV	katryntje
KYKBRD	kierkegaard
KYKBRYD	kierkegaard
KY	kay
KY	kay
KY	kay
KY	kay
KYK	kayak
KYKVMA	kikuma
KYLAN	keelan
KYLBAY	kilbane
KYLBRV	killebrew
KYLBY	kilby
KYLBYN	kilbane
KYLG	kilg
KYLGVR	kilgore
KYLH	koliha
KYLHVRN	kielhorn
KYL	kyle
KYL	kyle
KYL	kyle
KYLPK	kalpak
KYLR	keeler
KYLR	keeler
KYLR	keeler
KYLRMT	killermet
KYLT	kelty
KYLY	kyle
KYLYVN	katelyn
KYLZ	kilzer
KYMBAL	kimball
KYMBRLY	kimberly
KYMBRY	kimberey
KYM	kolyma
KYM	kolyma
KYMPA	kimppa
KYMV	kolyma
KYMVN	kimon
KYMVRA	kimura
KYMZ	kamholz
KYNA	keynesian
KYNAN	keynesian
KYNANN	keinanen
KYNARD	kinard
KYN	karyn
KYNCN	kinchen
KYNGASTVN	kingston
KYNGFAY	kingfai
KYNGRY	kingery
KYNGSFVRD	kingsford
KYNGSTVN	kingston
KYNGZTN	kyrgyzstan
KYNH	kenneth
KYN	karyn
KYN	karyn
KYN	karyn
KYN	karyn
KYN	karyn
KYN	karyn
KYN	karyn
KYN	karyn
KYNKNN	keinknen
KYNKYD	kinkade
KYNMN	kinman
KYNMN	kinman
KYNRSLY	kinnersley
KYNSLA	kinsella
KYNSL	kinsell
KYNSMN	kinsman
KYNSVN	keynesian
KYNT	katryntje
KYNT	katryntje
KYNTL	kintel
KYNY	keny
KYNY	keny
KYNYNY	kenny
KYNYVN	kenyon
KYNZ	kenz
KYNZMAN	kinman
KYNZY	kenz
KYP	kuyper
KYP	kuyper
KYP	kuyper
KYPLYNG	kipling
KYPYNG	keeping
KYRA	kyrgyzstan
KYRAN	kyrgyzstan
KYRAS	kieras
KYRBAY	kiribati
KYRBY	kirby
KYR	kyrus
KYRK	kirk
KYRTA	kyrgyzstan
KYRTY	karty
KYRVN	karvinen
KYRYL	karayel
KYRYSY	kyrgyzstan
KYSA	krystal
KYS	katys
KYS	katys
KYS	katys
KYS	katys
KYSLV	kislev
KYSNRVS	krishnamurtis
KYSR	kayser
KYSR	kayser
KYSTVFR	kester
KYSVN	keynesian
KYSY	kayser
KYSYDY	kingsford
KYSY	kayser
KYSYNJR	kissinger
KYSYN	kosygin
KYTAGVCY	kitaguchi
KYTAMVRA	kitamura
KYTC	kitch
KYTCN	kitchen
KYT	kyte
KYT	kyte
KYT	kyte
KYT	kyte
KYT	kyte
KYTL	krystal
KYTLY	ketley
KYTS	kyotos
KYTY	kyte
KYTYNG	keating
KYV	kayvon
KYVCY	kovalcik
KYV	kayvon
KYVK	kayak
KYVKYVLYS	kukulies
KYVMR	kumar
KYVNG	keong
KYVNG	keong
KYVNG	keong
KYVS	kayes
KYVSMATV	kasemsant
KYVYVALY	kivivalli
KYVZVN	kyrgyzstan
KYZR	kizer
KZMNZ	kommunizma
'LAALDYN	alaaldin
LABAT	labatt
LABDN	labdon
LABDVN	labdon
LABKYN	lubkin
LABLA	labella
LABL	labella
LAB	lamb
LABRAD	labroad
LABRYVLA	labriola
LABSR	labore
LABYN	labdon
LACLN	lachlan
LACNS	laocoons
LACYNY	lancing
LADASKY	ladasky
LADR	lander
LADRVT	laderoute
LADVN	labdon
LADVVYKA	ladoga
LADVVYKVS	vladivostoks
LADVYG	ladwig
LADYK	ladak
'LADYN	aladdin
LADYVYL	ladeuil
LAFAM	lapham
LAFAVNTYN	lafountaine
LAFGRYN	lofgren
LAFVRKAD	lafourcade
LAFY	laffey
LAGRLYNG	lagerling
LAGRSTRVM	lagerstrom
LAGVMVRVF	lagomorph
LAGVN	lagoon
LAHLMA	lahelma
LAHYJ	lahij
LAJ	lajos
LAJRBRG	lagerberg
LAKAY	lanka
LAKH	lakesha
LAKLH	lakesha
LAK	laky
LAK	laky
LAK	laky
LAK	laky
LAKR	slankard
LAKS	laakso
LAKSV	laakso
LAKSYN	blackstone
'LAKVABAH	alaqabah
LAKVTVRH	leatherock
LAKVVD	lakewood
LAKY	laky
LAKY	laky
LAKYSA	lakesha
LALKYN	lulkin
LAL	lal
LALS	laurels
LALY	laly
LALYT	lalit
LAMARK	lamark
LAMASTVS	lamastus
LAMBARD	lombard
LAMBARDV	lombardi
LAMBDA	lambda
LAMBLY	lamboley
LAMBRN	lamborn
LAMBRT	lambert
LAMBRVS	lambros
LAMBVLY	lamboley
LAMBVRN	lamborn
LAMBVRN	lamborn
LAM	lam
LAM	lam
LAMPLAYT	lamplight
LAMPN	lampen
LAMPY	lampi
LAMPYT	lampitt
LAMRS	lamars
LAMVRS	lamers
LAMYKYN	lamykin
LANA	lana
LANDAGR	landauer
LANDASTRVM	lundstrom
LANDAYR	landauer
LANDBRG	lindberg
LANDGRN	lindgren
LANDGRYN	lindgren
LANDKVYYST	landsat
LAND	land
LANDL	landahl
LAND	land
LANDMN	landman
LANDN	landen
LANDR	lander
LANDRS	landers
LANDRVM	landrum
LANDRY	landry
LANDRZ	landrum
LANDYN	landen
LANDYN	landen
LANDYS	landrys
LANGDVN	langdon
LANG	lang
LANG	lang
LANG	lang
LANGLY	langley
LANGNZ	langnes
LANGSA	langs
LANGSAV	longshaw
LANGSTVN	langston
LANGSV	langs
LANGV	lange
LANGYR	langmuir
LANJ	juliaantje
LANKA	lanka
LANKART	lonkart
LANKSTAF	longstaff
LANKTVN	lankton
LAN	lan
LAN	lan
LAN	lan
LAN	lan
LANR	elanor
LANR	elanor
LANSDYL	lonsdale
LANSFRD	lunsford
LANS	lanas
LANSTZ	lantz
LANSYNG	lansing
LANTA	lanetta
LANT	lantz
LANTLVSAMAD	lantlosamade
LANTRMAN	lanterman
LANTZ	lantz
LANTZ	lantz
LANVM	lannom
LANVSY	ulyanovsk
LANY	lanny
LANY	lanny
LANZ	lanz
LAPASV	lapaso
LAP	lap
LAPLAYN	laplaine
LAP	lap
LAPVRD	laird
LAPVRS	clapeyrons
LAPVRT	laporta
LAPVTA	laputa
LAPVVRS	clapeyrons
LAPYDARY	lapidary
LAPYSKV	laske
LARA	lara
LARALY	laralee
LARDYNGA	flardinga
LARJA	lauverjat
LARJ	learjet
LARN	larren
LARNS	larsens
LARNS	larsens
LARSN	larsen
LARSN	larsen
LARSVN	larsen
LARTR	larter
LARVC	laroche
LARVKVYH	lakeisha
LARV	lariviere
LARVRL	larurel
LARYF	lareef
LARYSA	larissa
LARYVYR	lariviere
LARZ	alvarez
LASKALA	lascala
LASKA	laska
LASKARY	lascari
LASK	laska
LASKVS	laskos
LAS	las
LAS	las
LAS	las
LASNYK	lasnik
LAST	last
LASTRA	lastra
LASTR	lastra
LASTRY	lastra
LASTYNG	lansing
LASVN	lanson
LASYNGR	losinger
LATALA	latala
LATA	lakota
LATAM	latham
LATBRY	lathbury
LATBVRY	lathbury
LATKYNZ	lupatkin
LAT	last
LATZ	lantz
LAVANDH	lawande
LAVAYN	latvian
LAVD	laud
LAV	olav
LAV	olav
LAVLS	laurels
LAVMN	lademann
LAVNKA	lanka
LAVNYVS	lannys
LAVRAY	laxminarayan
LAVRNS	laverns
LAVSTAD	lovstad
LAVTN	lawton
LAVTVN	latvian
LAVYGNH	lavigne
LAVYN	lanyon
LAVYT	lafayette
LAVZAK	lauzac
LAYAN	layamon
LAYBS	lambros
LAYBZ	leibniz
LAYDVYNA	ladonna
LAYDYA	ladoga
'LAYDYN	aladdin
LAYHV	laiho
LAYKZ	lamykin
LAY	lacy
LAYL	layla
LAY	lacy
LAYMAK	lamark
LAYMB	lamb
LAYND	land
LAYNG	laing
LAYN	lanyon
LAYN	lanyon
LAYRD	laird
LAYTBRN	lateran
LAYTMN	lanterman
LAYTNYNG	lancing
LAYV	layer
LAYV	layer
LAYV	layer
LAYVLY	laly
LAYVRYTSN	lauritsen
LAYVSAY	lakeisha
LAYVVY	lavey
LAYVY	lavey
'LAYYN	alain
LAZARA	lazara
LAZARD	lazard
LAZARV	lazaro
LBANRD	libannord
LBANVRD	libannord
LBDAN	hildebrandislant
LBDVN	labdon
LBN	laban
LBRYNYDYS	labrinidis
LBVN	lyubovny
LBVR	elbert
LBVRT	elbert
LCLH	lilith
LCMN	lachman
LCMR	lechmere
LCNR	lechner
LDFVRD	ledford
LDJ	lodewijk
LDK	ladak
LDVAYDJ	lindgard
LDVYK	lodewijk
LF	elf
LFLR	leffler
LFTVS	loftus
LG	leg
LHAN	lehan
LHLH	lehle
LHMAN	lehman
LHMAN	lehman
LHMN	lehman
LHMN	lehman
LHNRR	lehnerer
LHRNTZ	lohrentz
LHRYAN	laxminarayan
LHYJ	lahij
LHY	leahy
LJ	elsje
LKAMBR	lambert
LKRN	wilkerson
LKRVS	wilkersons
LKS	likes
LKSN	lockshin
LKVST	blockbuster
LKY	laky
LMBRN	lamborn
LMBRN	lamborn
LMBRT	lambert
LMBVRNH	lamborn
LMBVRN	lamborn
LMBVRN	lamborn
LMBVVRN	lamborn
LM	lam
LMP	lamp
LMPYNG	lamping
LMRZ	elmore
LMVN	ilmin
LMYR	elmer
LNDAHL	landahl
LNDAVR	landauer
LND	land
LNDRY	landry
LNDRZ	londre
LNDVAY	lendvai
LNDY	lindy
LNDYN	landen
LNDYNV	lendino
LNDZ	melendez
LNGLY	langley
LNGLYNG	lengeling
LNGMYD	langmaid
LNGMYD	langmaid
LNGSS	langerhanss
LNGSTN	langston
LNGSTVN	langston
LNKY	lewinsky
LNLVSAMAD	lantlosamade
LNLVZAMYD	lantlosamade
LNNDN	lennon
LNRT	lehnert
LNS	lens
LNSVN	lanson
LNTLVSAMAD	lantlosamade
LNTLVSAMYD	lantlosamade
LNTYN	lenten
LPARD	lepard
LPART	leppart
LPLA	leppla
LP	lap
LPVRS	lopresti
LPVRTA	laporta
LPVVRS	lopresti
LRAP	lursinsap
LRBZ	lorenz
LRD	lord
LRMN	lerman
LSARD	lessard
LSLY	lesley
LSR	laser
LSR	laser
LST	last
LSYAK	lesiak
LTBRY	lathbury
LTJY	letje
LTRYJ	lathbury
LTV	latvia
LVALAY	laplace
LVATS	levants
LVAYNGH	langseth
LVAYNJ	juliaantje
LVAYN	lanyon
LVBV	lebedev
LVBVTYN	libberton
LVBYN	libyan
LVC	loc
LVDMN	lodman
LVDVRF	ludorf
LVDVVYKA	goldkamp
LVDVVYKAS	olduvais
LVDVYJK	lodewijk
LVDVYKA	goldkamp
LVDVYKAS	olduvais
LVDVYK	lodewijk
LVDVYKS	vladivostoks
LVDVYKVS	klondikes
LVDVYSVS	leedss
LVFARV	lofaro
LVFASV	lofaso
LVFBARV	lofaro
LVFR	loafer
LVFSTRVM	lofstrom
LVGH	leigh
LVGNDRA	logendra
LVGZ	lavigne
LVJYK	lodewijk
LVKA	lukka
LVKARD	lockard
LVKAS	lusakas
LVK	lasovick
LVK	lasovick
LVK	lasovick
LVK	lasovick
LVK	lasovick
LVK	lasovick
LVKN	loken
LVKS	likes
LVKSTVN	blackstone
LVKV	loke
LV	elva
LV	elva
LV	elva
LVMAS	limas
LVMBARDV	lombardi
LVML	lemuel
LVM	loveman
LVMN	loveman
LVNAN	lindman
LVNAV	livonia
LVNDAN	lindman
LVND	lind
LVNDVN	linden
LVNJ	willemintje
LVN	elvin
LVN	elvin
LVNLY	lonely
LVNMV	linimon
LVNYG	livengood
LVNY	lyubovny
LVNY	lyubovny
LVNY	lyubovny
LVNYNGDAL	lonningdal
LVNZ	lunz
LVNZ	lunz
LVPATKYN	lupatkin
LVP	liverpool
LVPR	luper
LVPRSTY	lopresti
LVPYN	lipkin
LVPZ	lopez
LVRA	elvira
LVRA	elvira
LVRC	lorch
LVRD	lord
LVRJYV	lauverjat
LVRNA	lorna
LVRN	lavern
LVRNS	laverns
LVRNT	laurent
LVRNTZN	lorentzen
LVRNZ	lorenz
LVRNZN	lorenzen
LVRNZV	lorenzi
LVRNZY	lorenzi
LVRTVN	lorton
LVRTY	liberty
LVRY	lavery
LVRY	lavery
LVRY	lavery
LVRY	lavery
LVRY	lavery
LVSANTVS	losantos
LVS	luvs
LVS	luvs
LVSMVR	loosmore
LVSRV	leviseur
LVSSKV	glasscock
LVST	lovstad
LVSTR	lester
LVSTY	lusty
LVSYH	lesht
LVSY	livesay
LVSY	livesay
LVSY	livesay
LVSYTV	losito
LVTBG	luttbeg
LVTMPYV	lotempio
LVTR	lester
LVTYNZ	livingstone
LVTZ	lutz
LVVRA	elvira
LVVRJAT	lauverjat
LVVT	levant
'LVY	ogilvy
'LVY	ogilvy
LVYD	loyd
LVY	levy
LVY	levy
LVYNDN	lyndon
LVYNG	loyang
LVYN	elwyn
LVYN	elwyn
LVYNSVN	levinson
LVYS	levys
LVYSYLY	lysol
LVYSYVR	leviseur
LVYYNGH	longshaw
LVYYNG	loyang
LVYYSALY	lonsdale
LVYYZV	loizzo
LVYZ	liz
LVZANV	lozano
LVZYR	lozier
'LYA	alya
'LY	ely
'LYA	alya
'LYA	alya
'LYA	alya
LYA	elya
'LY	ely
'LY	ely
LYAM	layamon
LYANG	loyang
LYANZ	lanz
LYAV	ulyanovsk
LYBANNRD	libannord
LYBANVRD	libannord
LYBCN	liebchen
LYBL	lebel
LYBLYT	liblit
LYBMN	liebman
LYBRCAK	liberchuk
LYBRG	limburg
LYBRN	leybourne
LYBRTY	liberty
LYBRYK	librik
LYBSKAMB	lamb
LYBSN	liebson
LYBVRN	leybourne
LYBVYTZ	leibowitz
LYBYD	lebed
LYBY	lyubovny
LYCARSVN	licharson
LYCFYLD	litchfield
LYC	lycra
LYCMR	lechmere
LYCTN	lection
LYCVRVYYS	lycurgus
LYDAL	lidal
LYDA	lydea
LYD	loyd
LYDMAN	lodman
LYDN	leyden
LYDN	leyden
LYDRAK	ladak
LYDRDRAP	leiderdorp
LYDRDRP	leiderdorp
LYDRDRVP	leiderdorp
LYDRDVRP	leiderdorp
LYDR	lidor
LYDVR	lidor
LYDVYNA	lidwina
LYDYA	lydea
LYDYA	lydea
LYFAYV	lefaive
LYGYV	longyear
LYHY	leahy
LYK	lamykin
LYKYVRY	locker
LYLA	layla
LYLA	layla
LYLA	layla
LY	ely
LYLBK	lilback
LY	ely
LY	ely
LY	ely
LY	ely
LY	ely
LYLY	lyly
LYLY	lyly
LYLYND	leelynde
LYLYNTAL	lilienthal
'LYMA	olympia
'LYM	elysium
'LYMA	olympia
LYMBAX	limbaugh
LYMBVRG	limburg
LYM	lyme
LYMN	lymn
LYMR	lemer
LYMYNG	liming
'LYN	allyn
LYNAN	lindman
LYNARS	lenards
LYNDAL	lindal
LYNDAN	lindman
LYNDBK	lindback
LYNDBRG	lindberg
LYNDGARD	lindgard
LYNDGRN	lindgren
LYNDHLM	lindholm
LYND	lynda
LYND	lynda
LYNDL	lyndel
LYNDL	lyndel
LYNDMN	lindman
LYNDMN	lindman
LYNDN	lyndon
LYNDNMVT	lindenmuth
LYNDR	linder
LYNDRMN	linderman
LYNDRVTS	lindroth
LYNDSY	lindsey
LYNDVN	lyndon
LYNDZ	melendez
LYNDZY	melendez
LYNGAS	leningrads
LYNGLY	lingley
LYNHAN	linehan
LYNH	lynch
LYNKH	blenkhorn
LYNK	lysenko
LYNKLN	lincoln
LYNKVLN	lincoln
LYNKVYS	lewinskys
LYN	lyn
LYN	lyn
LYN	lyn
LYN	lyn
LYN	lyn
LYN	lyn
LYN	lyn
LYNSTRAT	lysistrata
LYNVAL	lindvall
LYNVNN	leinonen
LYNVRA	lenora
LYPARD	lepard
LYPKYN	lipkin
LYPSKAMB	lipscomb
LYPSKMB	lipscomb
LYPSKM	lipscomb
LYPSKVMB	lipscomb
LYPSKVMP	lipscombe
LYPST	lipset
LYPYJ	olympia
LYR	lyra
LYR	lyra
LYRN	leybourne
LYRYKAL	lyrical
LYRYK	librik
LYSBTH	lysbethje
LYSBTJH	lysbethje
LYSBTJ	lysbethje
LYSBTJY	lysbethje
LYSKANV	alaskan
LYSKMB	lipscomb
LYSKN	lisken
LYSKY	liskey
LYS	eloys
LYSN	lysenko
LYSN	lysenko
LYSTR	lysistrata
LYSTVN	liston
LYSVN	elysian
LYSVN	elysian
LYSY	elyse
LYSYN	elysian
LYT	lytle
LYTL	lytle
LYTLTVN	littleton
LYTLY	lytle
LYTMN	lightman
LYTN	leyton
LYTRL	littrell
LYTV	lytle
LYTVN	leyton
LYTVN	leyton
LYTVYN	leyton
LYVA	lydea
LYVANDN	landen
LYVANDVN	landen
LYVAYN	elysian
LYVBVNY	lyubovny
LYVH	lylah
LYV	lye
LYV	lye
LYV	lye
LYV	lye
LYV	lye
LYVNARD	leonard
LYVNARDV	leonardo
LYVNDVN	lyndon
LYVNGVD	livengood
LYVN	lyon
LYVNL	lyndel
LYVNSBRY	lounsbery
LYVNVRA	leonora
LYVNZ	lorenz
LYVVH	lylah
LYVV	levavy
LYVY	lyubovny
LYVYNGSTVN	livingston
LYVYN	lyon
LYVYN	lyon
LYVYS	levys
LYVYV	lyubovny
LYVYVS	levys
LYVYVY	lyubovny
'LYYAH	aliyyah
LYYL	lyell
LYYVVH	leythen
LYZA	liza
LYZA	liza
LYZARD	lizard
LYZARDZ	lizard
LYZBTY	elizabeth
LYZ	liz
LYZN	luzon
LYZR	lizard
LYZVT	liszt
MABANAG	mabanag
MABAY	mbabane
MABY	mawby
MAC	mac
MACTLD	machteld
MADABA	madaba
MADAKS	marduks
MADJ	madej
MADLYN	madelyn
MADLYN	madelyn
MADLYN	madelyn
MADN	madon
MADRVN	madrone
MADSN	madsen
MADVN	mahadevan
MADVRAY	madurai
MADYGAN	madigan
MADY	mady
MADYS	mandys
MADYSVN	madison
MADYV	mady
MAFRY	maffray
MAFYN	macfarlane
MAGAGNA	magagna
MAGARD	maggard
MAGDALYNTH	magdaleentje
MAGD	magda
MAGLYRV	magliaro
MAGR	mager
MAGRVDR	magruder
MAGS	maggs
MAGVAYR	magliaro
MAGVYR	magyar
MAGYL	magill
MAHADVAN	mahadevan
MAHAJAN	mahajan
MAHALT	mahault
MAHALY	mahaly
MAHA	maha
MAHAVLT	mahault
MAHTV	mahto
MAHVLT	mahault
MAHVT	mahwit
MAJV	maj
MAJY	marjory
MAJYV	marjory
MAKARAYG	macaraeg
MAKAYVLY	macaulay
MAKK	markku
MAKLAQLYN	maclaughlin
MAK	mak
MAK	mak
MAK	mak
MAKRYJ	marytje
MAKSVL	makil
MAKSY	macks
MAKSYM	maoism
MAKSYMYLYAN	maximilian
MAKV	markov
MAKVMBR	macomber
MAKVNVCY	mackinac
MAKVSY	markus
MAKY	macky
MAKYNVN	mackinnon
MAKYRAS	mackerras
MAKYSAK	masaaki
MAKZYM	mackenzie
MALAMVD	malamud
MALAN	malan
MALBRG	malberg
MALD	malde
MALDN	maldivian
MALKVK	mallick
MALKVM	malcolm
MALN	malan
MALNR	malnar
MALRVNY	maclaren
MALTYN	maltin
MALVN	maldivian
MALVNY	maloney
MALYGAN	malayan
MALYK	mallick
MAMA	mama
MAMFVRD	mumford
MAMN	maiman
MAMRT	mamet
MAMY	mame
MANAMA	manama
MANA	mana
MANA	mana
MANBR	manber
MANC	manca
MANDAL	mandal
MANDA	manda
MANDAR	mandar
MANDAVYL	mandaville
MANDL	mandl
MANDR	mandar
MANDY	mandy
MANGAN	mangan
MANGLANY	manglani
MANGR	manager
MANGYN	mangin
MANJYT	manjit
MANJYT	manjit
MANKA	maniskas
MANK	mayank
MANKRT	munkert
MANKS	maniskas
MANKVS	maniskas
MANKY	mayank
MANLY	manley
MANMA	manama
MAN	man
MANRV	manfred
MANSN	manson
MANSTR	manchester
MANSYL	mansfield
MANSYNGR	munsinger
MANTA	manetta
MANTL	mantle
MANTNZ	umanetz
MANTRAS	diamantaras
MANTVR	mantor
MANTYKS	mantles
MANTY	mantey
MANVLY	manley
MANVLY	manley
MANV	mane
MANV	mane
MANV	mane
MANV	mane
MANVRY	manoury
MANX	manx
MANYJA	manija
MANYKS	maniskas
MANY	many
MANY	many
MANYNG	manning
MANYSKAS	maniskas
MANYS	mandys
MANYT	manet
MANYV	many
MANZ	umanetz
MAPARTYDA	malpartida
MAPLZ	maple
MARALY	marsala
MARANY	marani
MARAT	marat
MARAZAS	marazas
MARBAC	marbach
MARBL	marble
MARC	marc
MARCYNDV	maricondo
MARDR	marder
MARDVC	marder
MARFY	mayerfeld
MARGALTA	margarita
MARGALYTY	margarietie
MARGANTH	marregante
MARGANT	marregante
MARGARTA	margarita
MARGARYTA	margarita
MARGARYTAY	margarita
MARGARYTJH	margarietje
MARGARYTJ	margarietje
MARGARYTJ	margarietje
MARGARYTJY	margarietje
MARGARYT	margaret
MARGARYT	margaret
MARGARYT	margaret
MARGARYTY	margarito
MARGLYN	margolin
MARGRTA	margarita
MARGRYJH	margrietje
MARGRYTA	margarita
MARGRYTH	margretha
MARGRYTH	margretha
MARGRYTJ	margrietje
MARGRYTJY	margrietje
MARGRYT	margret
MARGRYTYH	margretha
MARGVLYN	margolin
MARGVLYS	margolis
MARGVLYVKS	margolis
MARJNT	martijntje
MARKHAM	markham
MARKLY	markley
MARK	mark
MARK	mark
MARKS	marks
MARKSN	marksteiner
MARKSTYNR	marksteiner
MARKV	markov
MARKV	markov
MARKVM	markham
MARKVPVLY	markley
MARKVS	markus
MARKVS	markus
MARKVS	markus
MARKVYT	markowitz
MARKVYZA	marqueza
MARKVZ	markowitz
MARKYL	markiel
MARKY	markey
MARKYNGTVN	marchington
MARKYYVS	markus
MARLA	marla
MARLAT	marlatt
MARL	marla
MARLY	marley
MARLYN	marilyn
MAR	mar
MARN	marin
MARPL	marple
MARRL	marcel
MARSAL	marsala
MARSLA	marsala
MARSL	marisol
MARSLV	marisol
MARSLYNV	marilyn
MARS	mars
MARS	mars
MARSTVN	marston
MARSY	mars
MARTL	martel
MARTLND	martland
MARTN	marten
MARTNTJY	martyntje
MARTYJN	martijn
MARTYJN	martijn
MARTYJNTJH	martijntje
MARTYJNTJY	martijntje
MARTY	marty
MARTY	marty
MARTYNH	martyn
MARTYNJ	martyntje
MARTYNJ	martyntje
MARTYN	martyn
MARTYN	martyn
MARTYNSN	martinsen
MARTYNTH	martyntje
MARTYNTH	martyntje
MARTYNTJH	martyntje
MARTYNTJ	martyntje
MARTYNT	martyntje
MARTYNT	martyntje
MARTYNV	martyn
MARTYNVS	martens
MARTYNZ	martinez
MARTYNZ	martinez
MARTYNZ	martinez
MARTYZN	martyn
MARTYZNTJ	martyntje
MARTZ	martz
MARVAHA	marwaha
MARVCY	marcy
MARV	marv
MARVN	marvin
MARVN	marvin
MARVNY	maroney
MARVYN	marilyn
MARVYN	marilyn
MARVYT	marvit
MARXAM	markham
MARYA	maryann
MARYANA	mariana
MARYAN	maryann
MARYGANTH	marregante
MARYGANT	marregante
MARYH	marwah
MARYJH	marytje
MARYJH	marytje
MARYJKN	marijken
MARYJ	marytje
MARYJNT	martijntje
MARYKANDV	maryland
MARYKN	marijken
MARYLYN	marylynn
MARY	mary
MARY	mary
MARYN	martyn
MARYNV	martyn
MARYSH	marsh
MARYS	marys
MARYSVN	marston
MARYTH	martha
MARYTH	martha
MARYTJ	marytje
MARYTJ	marytje
MARYTJY	marytje
MARYTJY	marytje
MARYT	marytje
MARYT	marytje
MARYV	mary
MARYVS	marys
MARYYANY	maryanne
MARYZ	marz
MARZK	marek
MARZ	marz
MASAHYRV	masahiro
MASARA	masaru
MASATAKA	masataka
MASATV	masato
MASAYV	masaryk
MASBRG	mossburg
MASKARY	somashekar
MASKL	maskell
MASK	masek
MASKYAS	maniskas
MASLD	mansfield
MASLLY	masselli
MASNA	masna
MASNA	masna
MASRMN	masserman
MASTN	mastan
MASTYR	masters
MASVN	masin
MASYK	masaryk
MASY	mashey
MASYMV	massimo
MASYN	masin
MATAKV	matako
MATA	mata
MATANA	matana
MATAR	matar
MATAY	mata
MATJKA	matejka
MATLV	mantle
MAT	mat
MATSVDA	matsuda
MATSVMVTV	matsumoto
MATSVN	matson
MATVLA	matula
MATV	mactavish
MATVR	mantor
MATVS	mactavish
MATYNV	martyn
MATYS	martys
MATYS	martys
MATYV	marty
MATYVS	martys
MAVBAY	macumba
MAVBY	mawby
MAV	marv
MAV	marv
MAV	marv
MAVN	marvin
MAVPYN	maupin
MAVR	mavers
MAVRS	mavers
MAVSR	mauser
MAX	max
MAYFYLD	mayfield
MAYKLYS	madelyns
MAYKLZN	maryellen
MAYK	mayank
MAYKN	marijken
MAYKVHN	makuch
MAYKVK	markku
MAYLN	maryland
MAY	may
MAY	may
MAYMVN	maimone
MAYNDRT	mandelbrot
MAYN	mayan
MAYN	mayan
MAYNR	maynard
MAYR	mayr
MAYR	mayr
MAYR	mayr
MAYR	mayr
MAYR	mayr
MAYRN	marin
MAYRS	mayras
MAYRYK	masaryk
MAYRZ	marz
MAYSAL	marsala
MAYSA	maysan
MAYSL	marisol
MAYSTYK	masataka
MAYTAG	maytag
MAYTHAM	mathai
MAYT	maytag
MAYT	maytag
MAYTY	marty
MAYVHAY	mahaly
MAYV	mayo
MAYZ	marz
MAZRA	mazera
MBARK	mubarak
MCLD	machteld
MCTLD	machteld
MDABA	madaba
MDAVR	medawar
MDBA	madaba
MDH	madah
MDLYN	madelyn
MDNYK	mednick
MDNYT	madinat
MDRK	medrek
MDRR	maderer
MDS	mds
MDSN	madsen
MDSVN	madsen
MDVNA	medina
MDYNA	medina
MDYNH	madinah
MDYNH	madinah
MDYN	madelyn
MDYNNY	maddineni
MDYNT	madinat
MDYSVN	madison
MDYSVN	madison
MFRG	morgan
MFRK	merk
MFRVK	medrek
MGDALNT	magdaleentje
MGDALYNTJ	magdaleentje
MGDALYYNTJH	magdaleentje
MGDA	magda
MGDAYNTJ	magdaleentje
MGLAGLYN	maclaughlin
MGLAT	melhart
MGNAN	magnan
MGNASN	magnuson
MGNH	magellanic
MGNY	mignerey
MGR	mager
MGY	magyar
MGY	magyar
MGY	magyar
MGYNL	maginel
MGYS	magyars
MGYSY	magsaysay
MGYV	megyesi
MHADVAN	mahadevan
MHAMA	muhamma
MHARAK	mubarak
MHL	mehl
MH	mah
MHMA	muhamma
MHRAH	mahrah
MHRA	mithra
MHRG	macaraeg
MHRH	mahrah
MHRK	mehrkens
MHRM	mercurochrome
MHVYT	mahayanist
MJDL	majdal
MJ	maj
MJYA	mejia
MJYD	majid
MJYKAL	mikael
MJYK	matejka
MKAH	mekkah
MKALYR	malur
MKA	mika
MKARDL	mcardle
MKDALN	magdalena
MKDRMVT	mcdermott
MKDVLND	midland
MKDVNALD	mcdonald
MKDVNALD	mcdonald
MKDVYL	mandaville
MKFARLND	mcfarland
MKFARLYN	mcfarland
MKFRLYN	mcfarland
MKGAVYN	mcgavin
MKGRAT	mcgrath
MKGVVAN	megan
MKGVYRK	mcguirk
MKGVYR	magyar
MKGYRY	mignerey
MKH	makuch
MKH	makuch
MKHNRY	mchenry
MKKAH	mekkah
MKKAN	mikoyan
MKKARTY	moriarty
MKKARTY	moriarty
MKKAVN	mikkelsen
MKKNA	mickna
MKKNY	mikkelsen
MKKNZY	mckenzie
MKKRKN	morken
MKLAGLYN	maclaughlin
MKLAQLYN	maclaughlin
MKLARN	mclaren
MKLAVLYN	maclaughlin
MKLAVLYN	maclaughlin
MKLAVVGYNG	maclaughlin
MKLYN	mikulin
MKLYN	mikulin
MK	mak
MK	mak
MKMAHAN	mcmahan
MKMAHVN	mcmahon
MKMAHVN	mcmahon
MK	mak
MKMANYS	maimans
MKMVLN	memling
MKMYLAN	immelman
MKNAT	madinat
MKNYL	mckenney
MKNYL	mckenney
MKRA	mackerras
MKRAYH	mirach
MKRAY	mackerras
MKRDY	mockridge
MKRVN	mervin
MKRYS	makarios
MKSFYLD	mansfield
MKSN	mickelson
MKSYMV	mesmer
MKTAVYS	mactavish
MKVC	makuch
MKVTV	makoto
MKVY	markey
MKVY	markey
MKYL	mkel
MKY	macky
'ML	amal
MLA	malan
MLANDR	melander
MLANY	malan
MLAYYR	molaire
MLBAY	melba
MLCR	melcher
MLCYR	melcher
MLKA	melka
MLKVLM	malcolm
MLKVM	micklem
MLMN	melman
MLN	emlen
MLR	malur
MLTH	malthus
MLV	melva
MLVN	melvin
MLVR	malur
MLYBV	malibu
MLYDY	melody
MLY	emily
MLYNGR	mellinger
MLYN	madelyn
MLYNY	maloney
M'MA	mama
MMH	mcmahan
MMTA	mamta
MNAMA	manama
MNAMH	minamo
MNARD	menard
MNDL	mandl
MNDL	mandl
MNDL	mandl
MNDR	mandar
MNDVZA	mendoza
MNDYBL	mandible
MNDYK	mendyke
MNDY	mandy
MNDZ	mendez
MNFVL	manfull
MNGAN	mangan
MNGH	monongahela
MNG	meng
MNGS	mangus
MNHART	menhardt
MNH	manx
MNJYVN	mnemosyne
MNK	monk
MNKVSV	monks
MNKYVS	minskys
MNMA	manama
MNNYNG	manning
MNRV	minerva
MNSA	mansa
MNSN	manson
MNSTRYNA	menestrina
MNSVR	mansur
MNSVR	mansur
MNSVR	mansur
MNSVRY	mansuri
MNTL	mantle
MNT	mont
MNTQH	mintaqah
MNTSR	montserrat
MNTSYNN	mantsinen
MNTY	monty
MNTZR	mentzer
MNYJR	minyard
MNYKS	monks
MNY	many
MNY	many
MNYNG	manning
MNYN	mnemosyne
MNZR	mentzer
MNZS	munozs
MNZYZ	menzies
MPL	maple
MPL	maple
MQBRH	moqbara
MQRBY	moreby
MQSVD	maqsood
MRANDA	maranda
MRDYS	marduks
MRDYT	meredith
MRHAVS	marshas
MRJYNYV	marijken
MRKL	merkel
MRKLY	markley
MRKNT	menkent
MRKR	miranker
MRNDA	maranda
MRNY	maroney
M'RQ	mafraq
MRSR	mersereau
MRSRYA	mersereau
MRSRYV	mersereau
MRTN	marten
MRTNZ	martinez
'MR	amir
MRVAH	marwah
MRVAN	moravan
MRYGAN	merrigan
MRYJ	marytje
MRYK	masaryk
MRYKS	marduks
MRYMAN	merriman
MRY	mary
MRY	mary
MRYMN	merriman
MRYNLY	marinelli
MRYS	marys
MRYT	marytje
MRZ	marz
MSALXY	masalkhi
MSA	mesa
MSANDR	mesander
MSBARN	mashburn
MSKS	omsks
MSKYN	miskin
MSLYN	maslin
MSMAN	mossman
MSR	misra
MSS	mass
MSTAN	mastan
MST	mast
MST	mast
MSTRZ	mashtare
MS'VD	maqsood
MSYF	massif
MSYNA	masna
MSYNGR	messinger
MSYN	masin
MSYVS	moiseyevs
MTANA	matana
MTLYN	matlin
MT	mt
MT	mt
MTNA	matana
MTNA	matana
MTRNC	metternich
MTRNYC	metternich
MTRV	mitrovic
MTRYNC	metternich
MTSGR	munsinger
MTSVMVTV	matsumoto
MTSVN	matson
MTVR	monteverdi
MTYN	martyn
MTYN	martyn
MTYV	marty
MTYV	marty
MTYV	marty
MTYVS	martys
MTYVS	martys
MTYVSVN	mathewson
MTYVZ	martinez
MTZGR	metzger
MTZYNG	metzing
MVALR	malur
MVANZR	mounzer
MVBAY	embassy
MVBLY	mobley
MVDGYL	moudgill
MVD	med
MVDY	mindy
MVDY	mindy
MVFAD	mcfarland
MVGANTY	moganti
MVHAMA	muhamma
MVHAN	mohan
MVHR	mohar
MVKASA	mukasa
MVK	mok
MVKRYJ	marytje
MVLANDR	melander
MVLDN	moulden
MVLK	melka
MVL	marvell
MVLN	melen
MVLR	mailer
MVLR	mailer
MVLVY	melody
MVLYGAN	milligan
MVLY	emily
MVLYNARY	molinari
MVMFVRD	mumford
MV	marv
MVNAGAN	monagan
MVNAK	monack
MVNAKV	monack
MVNAZ	muniz
MVNDFRANS	mondfrans
MVNDVR	mondor
MVNKAR	menkar
MVNK	monk
MVNKS	monks
MVNKZ	menke
MVN	marvin
MVN	marvin
MVNRV	minerva
MVNS	melvins
MVNTAG	montag
MVNTAGV	montagu
MVNTALBANV	montalbano
MVNTA	monta
MVNTANARV	montanaro
MVNTANV	montano
MVNTGMRY	montgomery
MVNTGVMRY	montgomery
MVNT	mont
MVNTRAL	montreal
MVNTRV	montero
MVNTVYA	montoya
MVNTYJV	montijo
MVNVLYT	monolith
MVNYZ	muniz
MVNZLR	muenzler
MVRABYTV	morabito
MVRAD	murad
MVRAL	murali
MVRALS	morales
MVRALT	muralt
MVRA	mahavira
MVRANDV	morando
MVRAN	moran
MVRANV	morano
MVRAS	mahaviras
MVRAVAN	moravan
MVRAY	moray
MVRAYNS	moraines
MVRC	morch
MVRDAC	meranda
MVRDAK	merak
MVRFY	mirfak
MVRHAVS	marshas
MVRHAVS	marshas
MVRKL	merkel
MVRKN	morken
MVRLAN	morlan
MVRL	merle
MVRL	merle
MVRL	merle
MVRLYJ	morley
MVRLY	morley
MVRMAN	moorman
MVR	mavers
MVRNYNG	morning
MVRS	mavers
MVRS	mavers
MVRS	mavers
MVRSTAD	maurstad
MVRTAN	martian
MVRTN	merton
MVRTVN	merton
MVRTYMR	mortimer
MVRTYMR	mortimer
MVRTY	murthy
MVRTYMVR	mortimer
MVRV	marv
MVRVNY	moroney
MVRVYL	morville
MVRYL	marylou
MVRY	mury
MVRY	mury
MVRYN	mauryan
MVRYSN	morison
MVRYSVN	morison
MVRYSVN	morison
MVRYTA	morita
MVSAL	missal
MVSANA	messina
MVSFYS	microsofts
MVSLA	musella
MVSMN	mossman
MVS	mavis
MVSVN	maison
MVSVY	muscovy
MVSYG	muessig
MVSY	missy
MVSYR	mauser
MVSYVN	mnemosyne
MVSZ	mesozoic
MVTA	mehta
MVTANA	montana
MVT	marvit
MVTVR	monteverdi
MVTVRZ	monteverdi
MVTYSV	mistys
MVVR	mavers
MVYL	mylar
MVY	macvoy
MVYNYHAN	moynihan
MVYNZ	mintz
MVYR	meyer
MVYSAN	maysan
MVYS	muscovys
MVYSS	muysson
MVYSVN	muysson
MVYZ	muniz
MVYZVN	mozina
MVZYNA	mozina
MVZZ	mazzini
MYAV	maya
MYAYNDRT	mandelbrot
MYCALYS	michaelis
MYCA	mycenae
MYCAN	mycenaean
MYCAYLYS	michaelis
MYCL	michel
MYCLTJN	micheltjen
MYCLTN	micheltjen
MYCLTYN	micheltjen
MYCLYS	micheles
MYCN	mycenae
MYDLBRV	middlebro
MYDLTN	middleton
MYDLTVN	middleton
MYD	myrdal
MYDR	marylander
MYDY	mindy
MYGN	megan
MYGNRAN	migneron
MYGNRY	mignerey
MYGR	meger
MYGR	meger
MYGVYL	miguel
MYHALYK	mihalick
MYHAN	moynihan
MYJR	meijer
MYJRY	marjory
MYKAK	mayank
MYKALK	mikael
MYKA	mika
MYKAS	menkars
MYKAYL	mikael
MYKAYYL	mikael
MYKAYYLYZ	mikael
MYKAYYLZ	mikael
MYKK	mikki
MYKLACLN	maclachlan
MYKLJN	mikulin
MYKLM	micklem
MYKLSN	mickelson
MYKLSVN	mickelson
MYK	mayank
MYKNA	mickna
MYKR	meaker
MYKS	meeks
MYKS	meeks
MYKS	meeks
MYKT	miket
MYKVK	mikki
MYKVLYK	markley
MYKV	mendyke
MYKYNG	mekong
MYKYNZ	mckenzie
MYKZ	mckenzie
MYLAD	maryland
MYLAM	malayalam
MYLAM	malayalam
MYLAN	maryland
MYLARA	melara
MYLARD	millard
MYLAR	mylar
MYLASYS	melanesias
MYLBRT	milbert
MYLDRD	mildred
MYLGRAM	milgram
MYLKS	milks
MYLKV	milko
MYLKY	milky
MYLMAN	melman
MYLMAN	melman
MYLMV	malayalam
MYLN	maryland
MYLNR	marylander
MYLNVR	marylander
MYLNYVM	millennium
MYLR	mylar
MYLSTVN	milestone
MYLT	milt
MYLT	milt
MYLTN	melton
MYLVARD	milward
MYLV	myles
MYLVS	myles
MYLVT	milut
MYLYANZ	malayan
MYLYGAN	milligan
MYLYKN	milken
MYLY	marylynn
MYLY	marylynn
MYLY	marylynn
MYLYND	maryland
MY	may
MYMAS	myanmars
MY	may
MY	may
MYMY	emmy
MYNA	myrna
MYNA	myrna
MYNAMV	minamo
MYNARD	maynard
MYNARD	maynard
MYNARYK	minarik
MYNDRT	meindert
MYNGV	menge
MYNKY	minsky
MYN	mayan
MYN	mayan
MYN	mayan
MYN	mayan
MYN	mayan
MYNRAL	mineral
MYNR	maynard
MYNRVA	minerva
MYNRZ	maynard
MYNSR	monster
MYNSTRL	minstrel
MYNSY	minsky
MYNTAKAH	mintaka
MYNTAKVA	mintaka
MYNTKA	mintaka
MYNT	martyntje
MYNTR	minter
MYNTVN	minton
MYNTZ	mintz
MYNVARYNG	mainwaring
MYNYARD	minyard
MYNY	mayne
MYNZ	mintz
MYNZ	mintz
MYPL	maple
MYRA	myra
MYRA	myra
MYRANKR	miranker
MYRFLD	mayerfeld
MYR	emyr
MYRMAK	mirmak
MYR	emyr
MYR	emyr
MYR	emyr
MYRS	myers
MYRSY	myers
MYRTY	murthy
MYRVA	myra
MYRVL	myrdal
MYRVT	myrtle
MYRYDYT	meredith
MYRZ	merz
MYRZ	merz
MYRZ	merz
MYSA	maysan
MYSA	maysan
MYSAN	maysan
MYSAT	measat
MYSLAV	musella
MYSL	mosul
MYSL	mosul
MYSM	maoism
MYSN	maysan
MYSRA	misra
MYSTRY	mistry
MYSTYK	mistick
MYSVNR	masoner
MYSYK	masaryk
MYTAL	mithal
MYTAVA	maitawa
MYTCL	mitchel
MYTCM	mitchem
MYTNYK	mitnick
MYTRVVYK	maeterlinck
MYTSL	methuselah
MYTV	myrtle
MYTV	myrtle
MYTVN	mayston
MYTVNN	miettunen
MYV	moiseyev
MYVS	moiseyevs
MYVSN	maysan
MYVVZ	muniz
MYVZ	muniz
MYVZR	mizar
MYYH	myth
MYYR	myer
MYYRS	myers
MYZ	merz
MYZ	merz
MYZVN	mozina
MYZYRA	mizera
MZDH	mazdeh
MZYK	muzak
MZYVN	mozina
NAB	nabil
NABL	nabil
NABYL	nabil
NADAN	nevadan
NADANSVN	nathanson
NADVLNY	nadolny
NADYG	nadig
NAF	najaf
NAF	najaf
NAF	najaf
NAFZA	nafeeza
NAGASAKY	nagasaki
NAGASYVA	nagasiva
NAGNT	narragansett
NAGY	nagy
NAHAM	ingraham
NAJR	nair
NAJYAH	najiyah
NAJYA	najya
NAKAGAKY	nakagaki
NAKAMVRA	nakamura
NAKASVRA	nakasora
NAKASYMA	nakashima
NAK	nakao
NAKSVN	isakson
NAKVYYN	nanking
NAL	neal
NALYK	nallick
NAM	nam
NANDVANY	nandwani
NANLY	indranil
NAN	nan
NANS	nans
NANSY	nans
NANTVN	naunton
NAP	nagpur
NAP	nagpur
NAPTVN	napton
NAPVLYTANV	napolitano
NARAD	narad
NARDN	nardone
NARDV	nardi
NARDY	nardi
NARLA	narla
NARSAVAG	narsavage
NARV	naro
NASAV	narsavage
NAS	nas
NAS	nas
NATAN	nathan
NAT	nat
NATSN	nathanson
NAVAR	navarre
NAVARV	navarre
NAVAS	navas
NAV	nave
NAV	nave
NAVYA	nagoya
NAVYLV	navratilova
NAYA	najya
NAYDV	naugahyde
NAYFH	nayfeh
NAYFLR	naylor
NAYKRBYKR	knickerbocker
NAYKS	nanooks
NAYKS	nanooks
NAYKVLAS	niekolaas
NAYLR	naylor
NAYLZ	gonzalez
NAYMAH	naimah
NAYRMN	antaramian
NAYT	nat
NAYT	nat
NAZAHA	nazahah
NAZARYTYAN	nazaretian
NAZARYV	nazario
NBATAY	nabatiye
NBATYH	nabatiye
NBATY	nabatiye
NBL	nabil
'NBR	anbar
NBRS	nebres
NDA	nida
NDKARNY	nadkarni
NDN	neden
NDVD	nedved
NDYN	endymion
NFAN	enfant
NFDV	nefedow
NFJAN	neefjan
NFL	enfield
NFYSA	antofagasta
NFYZA	nafeeza
NFZA	nafeeza
NGTYV	negative
NGY	nagy
NHAVS	neuhaus
NHNH	nahnah
NJAF	najaf
NJF	najaf
NJVA	najwa
NJYAH	najiyah
NJYA	najya
NJYH	najiyah
NKLAS	niklas
NKLS	niklas
NKNZ	niknaz
NKV	nabokov
NKV	nabokov
NL	neal
NLKYN	nelkin
NLS	nils
NLSN	nelsen
NLT	neeltje
NMAZY	namazi
NPAN	norplant
NP	np
NPL	nepal
NPR	nagpur
NPTVN	napton
NPVRA	napora
NRAD	narad
NRDNFLT	nordenfelt
NRS	nairs
NRTRVP	northrop
NRVP	norup
NRY	nery
NRY	nery
NSLY	nesley
NSNAL	national
NSVA	nagasiva
NSVM	nossum
NSYDA	nashida
NSYHA	nasiha
NSYH	nash
NSYRA	nasira
NTAKR	nethacker
NTRTVN	netherton
NTYFA	nathifa
NTYHA	nathan
NVALA	nukala
NVAR	invar
NVAYL	naylor
NVAZ	nawaz
NVBL	nebel
NVBL	nebel
NVDA	nevada
NVDYNG	nuding
NVF	enif
NVGNT	nugent
NVJANS	nevejans
NVJANZ	nevejans
NVJNANS	nevejans
NVJNS	nevejans
NVJNT	nugent
NVKS	nevskys
NVKV	nabokov
NVLAN	nolan
NVLD	nelda
NVLF	nolf
NVL	nevel
NVL	nevel
NVNYS	ninoys
NVP	np
NVRA	nora
NVRBAY	wonderbra
NVRDA	neruda
NVRDBAY	nordby
NVRDBVRG	nordborg
NVRDDRAP	noorddorp
NVRDNSTVRM	nordenstrom
NVRDRAP	noorddorp
NVRDRVPH	noorddorp
NVRDT	nordt
NVRDVRP	noorddorp
NVRDVRP	noorddorp
NVRHA	norha
NVRKAT	navratilova
NVRN	nevrincean
NVRSRAP	norseman
NVRSVRP	noorddorp
NVRTKAT	northeast
NVRTVRPH	northorpe
NVRTVRP	northorpe
NVRVVD	novgorod
NVRY	nery
NVSAK	nosack
NVSL	novosel
NVT	newt
NVTZN	knutzen
NVTZ	notz
NVVALA	nukala
NVVRDDRP	noorddorp
NVVSL	novosel
NVVYK	novik
NVYA	noya
NVYFL	nyffeler
NVYJANZ	nevejans
NVYK	novik
NVYL	noyles
NVYL	noyles
NVYLS	noyles
NVYNGTVN	newington
NVYS	nevskys
NVZ	inez
NYBY	newby
NYCVLAS	nicolas
NYCVLS	nichols
NYDAL	nidal
NYDA	nida
NYDH	windex
NYDLZ	needles
NYD	naugahyde
NYFJAN	neefjan
NYFYN	neefjan
NYGLY	niggli
NYG	enying
NYGRA	nigra
NYGT	night
NYHALANY	nihalani
NYKALAS	unukalhais
NYKLAS	niklas
NYKLAS	niklas
NYKLAS	niklas
NYKLAS	niklas
NYKL	nickel
NYKL	nickel
NYKL	nickel
NYKL	nickel
NYKLS	niklas
NYKLS	niklas
NYKLS	niklas
NYKLS	niklas
NYKLSN	nickelsen
NYKLSN	nickelsen
NYKLSVN	nickelsen
NYKLV	nikolayev
NYKLZ	nikolai
NYKLZ	nikolai
NYK	nyikos
NYK	nyikos
NYK	nyikos
NYKRBAKR	knickerbacker
NYKRBKR	knickerbacker
NYKRBYKR	knickerbocker
NYKRSVN	nickerson
NYKS	nyikos
NYKSVN	enoksson
NYKVLA	nikolai
NYKVLAS	nickolas
NYKVLAS	nickolas
NYKVLAS	nickolas
NYKVLAS	nickolas
NYKVL	nickel
NYKVLSAN	nickelsen
NYKVLS	nickolas
NYKVLS	nickolas
NYKVLS	nickolas
NYKVLSVN	nickelsen
NYKVLYK	nikolay
NYKVLY	nikolay
NYKVLY	nikolay
NYKVLZ	nikolai
NYKVLZ	nikolai
NYKV	nyikos
NYKY	nevsky
NYKY	nevsky
NYKY	nevsky
NYKY	nevsky
NYLBRY	newbery
NYLJH	nilesh
NYLMG	neelmegh
NYLND	niland
NYL	naylor
NYL	naylor
NYLS	noyles
NYLS	noyles
NYLS	noyles
NYLS	noyles
NYLTH	monolith
NYLTJH	neeltje
NYLTJ	neeltje
NYLTJY	neeltje
NYLZ	gonzalez
NYMAH	naimah
NYMA	nyman
N'YMH	naimah
NYMH	naimah
NYMRAD	nimrod
NYMTZ	nimtz
NYMY	niamey
NYNDK	ninedek
NYNJA	ninja
NYN	nyman
NYN	nyman
NYNS	noyens
NYNSTAR	ninstar
NYNV	nyman
NYNVYS	ninoys
NYPAN	norplant
NYPNBRG	knippenberg
NYPTVN	neptune
NYR	nayar
NYR	nayar
NYS	indys
NYS	indys
NYSN	neisen
NYSPL	knispel
NYSYLDA	gnishilda
NYTYN	nitin
NYVAN	nyman
NYVARK	newark
NYVAYNGTN	newington
NYVAYNGTVN	newington
NYVBAY	nabatiye
NYVBRY	newbery
NYVBRY	newbery
NYVKVLAS	niekolaas
NYVKVYST	sunkist
NYVLND	newland
NYVMAN	nyman
NYVMAN	nyman
NYVMN	nyman
NYVMYR	newmeyer
NYVSAM	newsham
NYVTN	newton
NYVVYNGTVN	newington
NYVYSVN	nevison
NYVYYNGTVN	newington
NYYVKAMB	nakamura
NYYVTN	newton
'NYZH	inzhenery
NZAHAH	nazahah
NZAHA	nazahah
NZAHH	nazahah
NZYRAH	nazirah
NZYRA	nazirah
NZYRH	nazirah
PABLT	pablo
PABLV	pablo
PACVLKH	pacholke
PACYANV	pachiano
PADVA	padua
PADVLA	padula
PADYAL	padial
PADYLA	padula
PAGLAYS	paglias
PAGLYA	paglia
PAGLYS	paglias
PAGLYYARV	pagliaro
PAGT	pagett
PAJT	pat
PAKALA	pakala
PAKARD	packard
PAKNAS	pakenas
PAKS	paks
PAKS	paks
PAKT	prakrit
PAKVAT	pavarotti
PALAGY	palagyi
PALAK	pallack
PALFVRD	pulford
PALMRT	palmert
PAL	pal
PAL	pal
PALRMV	palermo
PALSKY	paplaskas
PALSN	paulsen
PALSYFR	pulsifer
PALTJH	paultje
PALTJ	paultje
PALTJY	paultje
PALVMBV	palumbo
PALYDV	palisades
PALY	paley
PALY	paley
PALY	paley
PALYS	palmyras
PAMFRY	pumfrey
PAM	pam
PANAGS	panagos
PANAS	panas
PANC	panici
PANDA	panda
PANDR	pandora
PANDVLFYNV	pandolfino
PANDYAN	pandian
PANDYT	pandit
PANDZ	pandit
PANFYL	panfil
PANGBVRN	pangborn
PANJABY	punjabi
PANKRAS	pandoras
PANKRS	pankhurst
PANN	panon
PAN	pan
PANT	pant
PANVALKR	panvalkar
PANVN	panon
PANYKV	pranke
PANYSY	pansy
PAPALARDV	pappalardo
PAPAY	papay
PAPLASKAS	paplaskas
PAPLTVN	poppleton
PAPLY	paypal
PAPN	pape
PAP	pape
PAP	pape
PAPVYK	paplaskas
PAQ	paquet
PARA	parra
PARAT	parratt
PARAYL	parayil
PARDN	pardon
PARDYNGTN	pardington
PARDYNGTVN	pardington
PARDY	pardi
PARDZ	pardi
PARHAM	parham
PARK	park
PARKYN	parkyn
PARKZ	park
PARMAR	parmar
PARNS	parnass
PARSANZ	parisian
PARSL	parsley
PARSN	parson
PARSVNS	parsons
PARSVNZ	parson
PARTVN	parton
PARTVS	partos
PARTY	pareto
PARYNGTVN	pardington
PARY	parry
PARYS	paraguays
PASKAL	parsifal
PASKV	pasko
PASKV	pasko
PAS	pas
PASTRNAK	pasternak
PASTVR	pasteur
PASYFYK	pasko
PASYR	passier
PATN	patna
PATR	patkar
PATRSVN	paterson
PATRSVN	paterson
PATRVKLVS	patroclus
PATRYK	patrik
PATRYK	patrik
PATRYK	patrik
PATRYS	patricas
PATRYSYA	parisian
PATRYZYV	patrizio
PATS	pates
PATTA	patetta
PATVCY	patrice
PATVKSNT	patuxent
PATYL	pathyil
PAVL	pavol
PAVLSN	paulsen
PAVLS	pavlovs
PAVLTH	paleolithic
PAVLT	paultje
PAVLYK	pavlik
PAV	pavol
PAVV	pavlov
PAYJ	paultje
PAYK	paik
PAYNH	pantheon
PAYN	payne
PAYNTVN	paynton
PAYNY	payne
PAY	paley
PAYPR	pampers
PAYRAMYD	pyramid
PAYTH	playtex
PAYTJ	paultje
PAYTR	paynter
PAYTR	paynter
PAYTVN	payton
PAYVLSVN	paulsen
PAYVLTJ	paultje
PAYVTH	playtex
PD	pd
PDRAM	pedram
PDRSN	pedersen
PDRSVN	pedersen
PDY	pandya
PG	peg
PGRAM	pegram
PGT	puget
PK	pak
PKR	packer
PKYNGZ	peking
PLAK	plack
PLAMN	plamen
PLAMR	plamen
PLANK	planck
PLAN	plaine
PLANT	plante
PLASTYNV	plastino
PLATFVRM	platform
PLAT	plat
PLAT	plat
PLATYV	plate
PLAYR	pillar
PLC	plache
PLHAM	pelham
PLKCYA	pellecchia
PLKY	polsky
PLNKNR	plencner
PLNTH	elnath
PLTAYR	plutarch
PLTCR	pletcher
PLTFRM	platform
PLTKVS	platkus
PLTNN	peltonen
PLT	pelt
PLT	pelt
PLTYV	poltava
PLTYYR	pelletier
PLVHN	ploehn
PLVMR	palomar
PLYGRYNY	pelligrini
PLYNSKYN	plinskin
PLYSKYN	pliskin
PLYT	playtex
PLYV	plyler
PNBAKR	pennebaker
PNDLTN	pendleton
PNDLTVN	pendleton
PNDYA	pandya
PNGADV	pengadu
PNG	pang
PNKRAS	pandoras
PNL	panfil
PN	pan
PNS	pans
PNTVN	panton
PNYMAN	penniman
PNYNSVLA	peninsula
PNYNZVLA	peninsula
PNY	pansy
PPH	epiphany
PPLR	doppler
PPYN	pepin
PRABST	probst
PRACT	paraclete
PRADV	prado
PRAGV	prager
PRAHL	prahl
PRAKTYKVM	praktikum
PRAL	prael
PRALT	perrault
PRAM	pram
PRAMVD	pramod
PRANAV	pranav
PRANGS	prongs
PRANK	pranke
PRAPYS	spirographs
PRASAD	prasad
PRASANA	prasana
PRASANT	prashant
PRASN	prasen
PRAS	pradas
PRATP	pratap
PRAT	porrat
PRATS	prates
PRATVL	pratul
PRATYK	prateek
PRATYKS	pratiksh
PRATYKV	praktikum
PRAVL	pravil
PRAVYN	praveen
PRAYB	paramaribo
PRAYL	parayil
PRAYM	pram
PRAYVN	praveen
PRAYVYT	paramount
PRBN	preben
PRC	percy
PRDYKARV	perdicaro
PRDYKYS	perdikis
PRDYS	pardes
PRKAS	pereckas
PRKS	parks
PRKYNS	perkins
PRKYNZ	parkyn
PRLMAN	perlman
PRLMN	perlman
PRL	perl
PRLR	perler
PRLY	perley
PRMAL	premal
PRNT	parent
PRNTYS	prentiss
PRPK	perpk
PRSATTAM	purshottam
PRSKAT	prashant
PRSL	parsley
PRSLT	parsley
PRSTN	preston
PRSTRVD	prestrud
PRSTRV	prestero
PRSTVN	preston
PRSVN	parson
PRSYNV	presbyterian
PRSYVAL	parsifal
PRVAMR	precambrian
PRVAN	provan
PRVGTV	progetto
PRVJT	projet
PRVMVNTVRY	promontory
PRVN	parvin
PRVPS	propes
PRVS	purvis
PRVTRV	prestero
PRVTVS	protus
PRVV	provo
PRVVST	prevost
PRVYN	procyon
PRVY	pruy
PRVYS	procyons
PRYA	priya
PRYAVLT	perreault
PRYBL	preble
PRYCARD	pritchard
PRYDY	preedy
PRYKLY	prickly
PRYKN	parkin
PRYKT	prickett
PRYLV	parayil
PRYMRV	primero
PRYMV	prime
PRYMYVS	premyslids
PRYNG	prong
PRYN	parkyn
PRYNS	procyons
PRYNSS	prensas
PRYNT	parent
PRYNY	parkyn
PRY	pery
PRYSKAT	prashant
PRYSLR	preisler
PRYSTLY	priestly
PRYSTLY	priestly
PRYST	priest
PRYSTVN	preston
PRYSYLA	priscilla
PRYSYNG	pershing
PRYTCARD	pritchard
PRYTY	pretty
PRYTY	pretty
PRYTZ	pritz
PRYVR	pryor
PRYVS	pryors
PRYVST	prevost
PRYYVTY	pretty
PRZ	perez
PSKYN	peskin
PSNKV	pasternak
PS	ps
PSTMA	postma
PST	post
PTCR	petcher
PTKR	patkar
PTLA	patella
PTRN	petren
PTR	peter
PTRSN	paterson
PTRSN	paterson
PTRSVN	paterson
PTRSVN	paterson
PTRVF	porterfield
PTRVNLA	petronella
PTRV	petrov
PTRVV	petrov
PTRVYC	petrovich
PTRYC	patric
PTRYK	patrik
PTRY	petry
PTRZ	patrizio
PTSY	patsy
PTV	petrov
PTYBN	pettibone
PTYBVN	pettibone
PTYL	pathyil
PTYNS	putins
PTY	patty
PTY	patty
PTY	patty
PTYTJYN	petitjean
PTZVLD	petzold
PVALMA	pearlman
PVA	pravda
PVGA	puga
PVGLYS	pugliese
PVG	peg
PVGVSYAN	pogosyan
PVHAN	puhan
PVHAR	pohar
PVHL	pohl
PVH	poh
PVKVRNY	pokorny
PVLAKVS	poulakos
PVLGAR	pulgar
PVLK	pavlik
PVLMYTYS	polemitis
PVLND	poland
PVLN	pavlovian
PVLN	pavlovian
PVLNT	polant
PVL	pavol
PVL	pavol
PVLSN	polson
PVLS	pavlovs
PVLS	pavlovs
PVLTR	poulter
PVLV	pavlov
PVLVVYN	pavlovian
PVLYNG	poling
PVLYPALY	polepalli
PVLY	polly
PVLYS	pollys
PVLYT	playtex
PVLYYAM	pulliam
PVLZ	pulitzer
PVMA	puma
PVMFRY	pumfrey
PVNA	pena
PVNT	pinto
PVNVZ	panza
PVPAT	popat
PV	pavol
PVP	pepe
PVP	pepe
PVRAHV	purahoo
PVRANYK	puranik
PVRJZ	perez
PVRKV	pirkko
PVR	proverbs
PVRTNVY	portnoy
PVRTRFYLD	porterfield
PVRVS	purvis
PVRYNTVN	purinton
PVRYR	pryor
PVSALA	poosala
PVSARY	pissaro
PVSN	posen
PVS	purvis
PVSTYL	postill
PVSV	purvis
PVSY	pusey
PVTKVNN	putkonen
PVT	prevost
PVTRY	petry
PVTYT	petit
PVTYT	petit
PVTZ	putz
PVVLZ	pulitzer
PVV	pavlov
PVYNT	poynting
PVYNTYNG	poynting
PVYRYR	pryor
PVYSL	premyslid
PVYV	pavlov
PVZYVS	puzos
PYAK	peak
PYATJY	paultje
PYATK	piatek
PYBADY	peabody
PYDH	opdahl
PYD	pyramid
PYD	pyramid
PYJH	upjohn
PYJT	projet
PYKAP	pickap
PYKARD	pickard
PYKASV	phekdas
PYKL	pickel
PYK	psyko
PYK	psyko
PYK	psyko
PYK	psyko
PYKRL	pickrell
PYKS	peaks
PYKVLBNY	pikelner
PYKZ	pinkowitz
PYLAR	pillar
PYLARZ	polaris
PYLATV	pilate
PYLAZV	poltava
PYL	pyle
PYL	pyle
PYLVSKY	polsky
PYLVYV	perley
PYLY	pyle
PYLYSNRY	pillsbury
PYNAKL	pensacola
PYNA	pollyanna
PYNCAZ	pinchas
PYNCRA	pinchera
PYNDAR	pindar
PYNDV	pinedo
PYNGNVT	pingenot
PYNG	poynting
PYNKVVYTZ	pinkowitz
PYNKY	pinky
PYN	payne
PYN	payne
PYN	payne
PYNSN	polynesian
PYNSVN	polynesian
PYNTH	pentax
PYNTN	paynton
PYNTR	paynter
PYNTR	paynter
PYNTR	paynter
PYNTVN	paynton
PYNTVN	paynton
PYNV	payne
PYNV	payne
PYNXAM	putnam
PYNYAN	pyongyang
PYNY	pyongyang
PYNZ	panza
PYPGRAS	pipgras
PYP	pype
PYP	pype
PYPR	piper
PYPVNY	epiphany
PYRAMYD	pyramid
PYRAN	pythagorean
PYRANY	pirani
PYRARD	pirard
PYRAVAT	pirawat
PYRKV	pirkko
PYRLMAN	perlman
PYRL	perl
PYRMN	pearman
PYR	pryor
PYRSN	pearsen
PYRSN	pearsen
PYRSN	pearsen
PYRS	pyers
PYRS	pyers
PYRSVN	pearsen
PYRT	port
PYRV	pyrex
PYRVZ	perez
PYRY	pery
PYRYR	pryor
PYRYZ	perez
PYRZ	perez
PYSAH	peasah
PYSAN	paysan
PYSH	piyush
PYSLY	paisley
PYSNS	polynesians
PYS	pyers
PYS	pyers
PYS	pyers
PYSTVN	pistun
PYTAN	pythagorean
PYTA	pythias
PYTH	python
PYTJ	pietje
PYTKV	pitkow
PYTMN	pitman
PYT	pyotr
PYT	pyotr
PYT	pyotr
PYT	pyotr
PYTR	pyotr
PYTR	pyotr
PYTR	pyotr
PYTRSVN	petersen
PYTRV	pyotr
PYTRZ	patrizio
PYTS	pyotrs
PYTYBVN	pettibone
PYVMLY	permalloy
PYVN	payton
PYVNYK	pivnick
PYV	pyle
PYVRYNTN	purinton
PYVTR	pyotr
PYYK	psyko
PYYRY	pery
PYYV	pygmy
PYZA	pizza
PYZLY	piziali
PYZS	puzos
PYZVLYTV	pizolato
PYZYALY	piziali
PYZYNY	pizzini
PYZY	pyziur
PYZYR	pyziur
PZARAYS	paraguays
QADSYH	qadisiyah
QALYA	quetzalcoatl
QASAN	eastman
QASM	qasim
QAYD	qadir
QAYS	quayles
QBYLH	qubilah
QDAMH	qudamah
QDYLA	qadisiyah
QDYL	quodling
QDYM	qudamah
QDYRA	qadira
QDYR	qadir
QDYSH	qadisiyah
QDYSYHA	qadisiyah
QLYA	quinlan
QLYBA	elba
QLYB	quigley
QLYLA	ella
QML	emel
QMR	qamar
QNTVN	quentin
QRBYA	orban
QRYBYH	qubilah
QSAN	queensland
QSN	quisling
QSYM	qasim
QSYM	qasim
QTRAN	quatrain
QVASYM	quasim
QVBYLH	qubilah
'QYLA	aqila
'QYLA	aqila
'QYL	aqil
'QYL	aqil
QYT	quast
QYVN	quin
RABKYN	rabkin
RABLD	rabold
RABL	rabel
RABNAV	rabenau
RABN	raben
RABN	raben
RAB	raba
RABRT	robert
RABRTSN	robertson
RABRTSVN	robertson
RAB	raba
RABTM	rabat
RABVYL	raboel
RABYDYAKS	greatbanks
RABY'H	rabiah
RABYJN	robijn
RABYN	raben
RABYN	raben
RABYNSN	rabins
RABYNSVN	robinson
RABY	raby
RABY	raby
RABYV	raby
RACL	oracle
RAC	erach
RADAK	radenburgerabroek
RADBRG	radenburgerabroek
RADBVD	radboud
RADBVN	radbone
RADHA	radha
RADHYKA	radhika
RADKLYF	radcliff
RADK	radek
RADMN	radjen
RADNBRC	radenburch
RADNBRGARBRVK	radenburgerabroek
RADNBRGRABRK	radenburgerabroek
RADNBRGRABRVK	radenburgerabroek
RADNBRGRBRVK	radenburgerabroek
RADNYK	radenburgerabroek
RAD	rad
RADRAMVNY	rudramuni
RADRFRD	vanderford
RADR	rader
RADR	rader
RADT	ronstadt
RADVA	radwa
RADVF	radcliff
RADVLFS	radcliffes
RADVLFVS	radcliffes
RADV	radev
RADVYG	radig
RADYAH	radeyah
RADYH	radeyah
RADYNG	radenburgerabroek
RADY	randy
RAFALKV	rafalko
RAFAL	rafal
RAFALSKY	rafalski
RAFA	rafa
RAFAYL	rafael
RAFAYLY	rafaeli
RAFNR	rainer
RAF	rafa
RAFRTY	rafferty
RAFYKYV	rafalko
RAFYL	rafael
RAFYN	raffin
RAFY	rafferty
RAGATZ	ragatz
RAGLND	ragland
RAGL	ragle
RAGNAR	ragnar
RAGNARSVN	ragnarsson
RAGNRD	fragonard
RAGNVALD	ragnvald
RAGRV	ragnar
RAGSDYL	ragsdale
RAHARJV	rahardjo
RAHBK	radhika
RAHRR	rohrer
RAHRYG	roehrig
RAHVL	rahul
RAHY	rahi
RAJCR	rajcher
RAJNDR	rajender
RAJN	radjen
RAJ	raj
RAJR	rajcher
RAJRZ	ramirez
RAJS	rajas
RAJV	rajeev
RAJYV	rajeev
RAKAH	barakah
RAKL	frankel
RAKL	frankel
RAK	radek
RAKVN	rabkin
RAKV	rabkin
RAKYKVT	rakita
RALF	ralf
RALF	ralf
RALF	ralf
RAMA	rama
RAMBL	rambo
RAMBV	rambo
RAMPLZ	rampling
RAM	ram
RAM	ram
RAMR	ramer
RAMS	ramas
RAMSY	ramsey
RAMSYR	ramseier
RAMTAN	ramthun
RAMVLVS	romulus
RAMVS	ramos
RAMY	reamy
RAMYRV	ramiro
RAMZ	ramez
RANA	rana
RANDL	randal
RANDR	rander
RANGL	wrangell
RANKYN	rankin
RANN	erann
RAN	eran
RAN	eran
RAN	eran
RANR	ragnar
RANTGN	rontgen
RANY	randy
RANY	randy
RANY	randy
RANYV	randy
RAPBRYK	ropebrake
RAP	ralph
RAPR	draper
RARK	razorback
RASA	rasha
RASCN	raskin
RASDAL	ragsdale
RASD	rashed
RASFVRD	rastafarian
RASKH	raskin
RASK	raskin
RASKYN	raskin
RASL	rasul
RASL	rasul
RASMN	rasmussen
RASNDAL	randal
RASNDYL	randell
RASNMAN	rosenman
RASPYNY	rasputin
RAS	ras
RAS	ras
RAS	ras
RAS	ras
RASTN	rastin
RASTRAM	zoroastrianism
RAST	raisty
RASTYN	rastin
RASTY	raisty
RASVM	erasmus
RASV	raso
RASV	raso
RASV	raso
RASYD	rashed
RATCSVN	ratcheson
RATGRT	rutgert
RATJRT	bradstreet
RATKS	pratiksh
RATMN	rathmann
RATRA	rattray
RAT	rat
RATRFVRD	waterford
RAT	rat
RATSTRVM	ruthstrom
RAVBATM	rabat
RAVDAH	raidah
RAVDA	ravindran
RAVDA	ravindran
RAVLND	ragland
RAVLT	raoult
RAVNR	ravindran
RAV	ravi
RAV	ravi
RAV	ravi
RAVRDY	raverdy
RAV	ravi
RAVRT	rafferty
RAVS	reavis
RAVT	raith
RAVYAH	radeyah
RAVYH	radeyah
RAVYNDRAN	ravindran
RAVYRAJ	raviraj
RAVY	ravey
RAVY	ravey
RAYBLT	rybolt
RAYDAH	raidah
RAYDJ	radjen
RAYDL	randal
RAYDN	rawdon
RAYFL	rafal
RAYLH	rayleigh
RAYLY	rayle
RAYMVND	raymond
RAYNR	rayner
RAYP	ralph
RAY	ray
RAYSL	rasul
RAYS	randys
RAYSTLYN	raistlin
RAYT	rubaiyat
RAYTZ	ragatz
RAYVARD	rahardjo
RAYVLYNGZ	rawlings
RAYV	ray
RAYVTYALA	rautiala
RAYZL	raizel
RAZDAN	razdan
RAZN	razdan
RAZVRBK	razorback
RBHVLZ	rebholz
RBRTSVN	robertson
RBVK	rubik
RBVSV	reboso
RBYAH	rabiah
RBYH	rabiah
'RBYL	arbil
RBYS	rubys
RDAH	raidah
RDA	reda
RDBVN	radbone
RDFYLD	redfield
RDLFVS	rodolfos
RDLVS	redlus
RDMN	redman
RDMYL	redmill
RDRYK	rodrick
RDVA	ordovician
RDVLF	rudolf
RDVNDV	redondo
RDYDH	riyadh
RDYH	radeyah
RDY	rudy
RFA	rafa
RFSNS	refsnes
RFSVN	refson
RF'T	rafat
RGD	raghd
RGV	ragnvald
RHLYNG	rehling
RHNY	rheni
RHYMAH	rahimah
RHYMH	rahimah
RHYM	rahim
RJAS	rajas
RJAT	rajat
RJ	raj
RKAH	rebekah
RKDAL	reckdahl
RKKAH	rebekah
RKSTN	reksten
RKVG	reckeweg
RLF	ralf
RLYVS	orlys
RLYVZ	rebholz
RMD	remde
RMFR	rempfer
RMLYNGR	remlinger
RMNCYK	romanchik
RMN	ramon
RMNS	ramons
RMPLYNG	rampling
RMVNY	romany
RMY	remy
RNALDZ	reinaldo
RNALT	renault
R'NA	rana
RNA	erna
RNAVD	renaud
RNBART	rennebarth
RNDHL	randhol
RNDR	rander
RNDY	randy
RNJ	resyntje
RNVYS	orkneys
RN	rn
RNY	rony
RNZLND	renzland
RNZ	renze
RPLAGL	replogle
RPRT	rupert
RPTVN	repton
RQAH	raqqah
RQA	raqqah
RQD	torquemada
'RRYFA	arrifa
RSA	rosa
RSL	rasul
RSL	rasul
RSNYK	resnick
RST	rest
RSVL	roosevelt
RSVLVYRT	resolveert
RSVNAT	resonate
RSVNDL	rosendale
RSYDA	rashida
RSYDH	riyadh
RSYD	rashed
RSYNH	rosenheim
RSYNJH	rosenjack
RSYNTH	rosenthal
RSYNTJ	resyntje
RSYVYN	roscolyn
RTKLYF	ratliff
RT	rat
RVAN	orvarsson
RVATR	realtor
RVAY	ray
RVAYZ	ramez
RVAZNR	rainer
RVBRJ	raviraj
RVBR	ribar
RVBRTA	roberta
RVBRT	robert
RVBRTSVN	robertson
RVBRTV	roberto
RVBVZ	roboz
RVBYN	robyn
RVBYNSVN	robinson
RVBYNZ	robyn
RVBY	roby
RVBY	roby
RVC	eric
RVC	eric
RVDA	ravindran
RVDH	raidah
RVDLV	redlus
RVDNBRG	roodenburg
RVD	rivard
RVD	rivard
RVDRYGV	rodrigo
RVDRYGZ	rodriguez
RVDVLFAS	rodolfos
RVDVLF	rudolf
RVDVLFVS	rodolfos
RVGALSKY	rogalsky
RVGVZA	rogoza
RVHAN	rehan
RVHL	riehle
RVHM	rohm
RVHN	rohn
RVHRR	rohrer
RVHR	ruhr
RVJAS	rojas
RVKAN	rukan
RVKA	erika
RVKN	rukan
RVKRY	rookery
RVKSAN	arkansan
RVKSAN	arkansan
RVKV	rickover
RVKYKY	rokicki
RVKZ	roku
RVLAND	roland
RVLDAN	roldan
RVLFH	rolfe
RVLF	rolfe
RVLF	rolfe
RVLND	roland
RVLS	orvals
RVLV	revelo
RVLY	riley
RVMFVRT	roumfort
RVMRV	romero
RVMYG	romig
RVMYV	remy
RVNALD	ronald
RVNDA	ravindran
RVNDH	randhol
RVNDL	rundle
RVNDYN	ravindran
RVNGV	irving
RVNTRY	rountree
RVNY	rony
RVNY	rony
RVNYT	ronit
RVPKH	roepke
RVPRT	rupert
RVP	rep
RVRKH	rourke
RV	rev
RV	rev
RVR	river
RV	rev
RVRY	raverdy
RVRYS	rorys
RVSALYN	rosalyn
RVSAM	rosham
RVSAM	rosham
RVSANA	rosana
RVSA	rosa
RVSKV	rusk
RVSL	risel
RVSLYN	roslyn
RVSLYN	roslyn
RVSNAL	rosendale
RVSNBLAT	rosenblatt
RVSNDAL	rosendale
RVSNDL	rosendale
RVSNFLD	rosenfeld
RVSN	orvarsson
RVSNR	reisner
RVS	revas
RVS	revas
RVS	revas
RVSR	reaser
RVSTAD	rostad
RVSTND	rostand
RVSVLT	roosevelt
RVSVN	orvarsson
RVSV	rostov
RVSV	rostov
RVSYALA	rosalinda
RVSYTR	rossiter
RVTABAGA	rutabaga
RVTGR	rutgers
RVTGRT	rutgert
RVTJ	resyntje
RVTJY	resyntje
RVTRFRD	rutherford
RVT	rivest
RVT	rivest
RVT	rivest
RVT	rivest
RVT	rivest
RVT	rivest
RVT	rivest
RVTS	ritas
RVTZ	ritz
RVVLVRY	revuluri
RVVTH	routh
RVVT	rivest
RVVT	rivest
RVYAH	riyadh
RVYAL	royal
RVYAPA	royappa
RVYBL	rybolt
RVYDN	reyden
RVYH	riyadh
RVYL	royal
RVYLY	royle
RVYMATA	roimata
RVYN	reyna
RVYN	reyna
RVYPK	riopka
RVY	ravey
RVYS	roys
RVYS	roys
RVYS	roys
RVYTNBRG	roytenberg
RVYYZ	ryzman
RVYZ	ryzman
RVZMARY	rosemary
RVZMARY	rosemary
RVZNDAL	rosendale
RVZNFLDR	rosenfelder
RVZNJK	rosenjack
RVZN	razdan
RVZ	erez
RVZ	erez
RVZ	erez
RVZVLT	brazelton
RVZY	irizarry
RVZYR	retzer
RVZYR	retzer
RVZYTA	rita
RYAD	riyad
RYBAK	reback
RYBAR	ribar
RYBK	rybicki
RYB	rybolt
RYBRN	rayburn
RYCARD	ricardo
RYCARDSN	richardson
RYCARDSVN	richardson
RYCAR	richar
RYCAV	richau
RYCMN	richmann
RYCMYR	richmeyer
RYC	royce
RYCR	raicer
RYCY	royce
RYCY	royce
RYDA	rydland
RYDA	rydland
RYDA	rydland
RYDH	riyadh
RYDH	riyadh
RYDJ	radjen
RYDKVYST	rydquist
RYDL	rydland
RYDNBRC	radenburch
RYDNBRGYRBRAK	radenburgerabroek
RYDN	ryden
RYD	riyad
RYDR	ryder
RYDYG	rydberg
RYDY	rudy
RYFKAYND	rifkind
RYGAN	oregan
RYGARD	regard
RYGLR	rigler
RYG	rydberg
RYGV	rydberg
RYGYNZ	gorgonzola
RYHANA	rihana
RYHANH	rehan
RYHL	riehle
RYJKARD	rijkaard
RYJ	resyntje
RYJSVYJK	rijswijk
RYJSVYK	rijswijk
RYJYNZ	renze
RYKARD	rickard
RYKARD	rickard
RYKR	ricker
RYKRT	rickert
RYKSVN	eriksen
RYKTZ	reetz
RYKVLSVN	reynoldson
RYKY	ryukyu
RYLND	rydland
RYL	rayle
RYLSBK	railsback
RYLY	rayle
RYMANT	rembrandt
RYMND	raymond
RYMNZ	rymon
RYM	rymon
RYMRS	riemers
RYMVND	raymond
RYMVND	raymond
RYMVND	raymond
RYMVN	rymon
RYMYL	rymill
RYMY	remy
RYNAH	rennebarth
RYNALDA	reenalda
RYNALD	reynaldo
RYNALDS	reynaldos
RYNALDZ	reynaldo
RYNDNR	rindner
RYNDRT	reindert
RYNDRZ	rynders
RYNG	rysling
RYNGST	ringuest
RYNGVVD	ringwood
RYNH	rhenish
RYNKR	rinker
RYNLDA	reenalda
RYN	ryan
RYN	ryan
RYNR	rayner
RYNR	rayner
RYNRT	reinert
RYNTVL	rintoul
RYNVD	reynolds
RYNVLDA	reinolda
RYNVLD	reynolds
RYNVLD	reynolds
RYNVLDS	reynolds
RYNVLDSVN	reynoldson
RYNVLDZ	reynaldo
RYNVVD	reynolds
RYPL	ripley
RY	ray
RYRDAN	oriordan
RYRDAN	oriordan
RYRDN	reardon
RY	ray
RYRSVN	reierson
RYRZ	ramirez
RYSAH	rishah
RYSALVYRT	resolveert
RYSAR	rischar
RYSAVY	rysavy
RYSJY	resyntje
RYSKAR	research
RYSLVRT	resolveert
RYSLYNG	rysling
RYSLY	risley
RYSNR	reisner
RYSNR	reisner
RYSNYK	resnick
RYSRC	research
RYS	roys
RYS	roys
RYS	roys
RYS	roys
RYS	roys
RYSR	rukeyser
RYSR	rukeyser
RYSTV	rostov
RYSTYNTJY	kristijntje
RYSTY	rusty
RYSVLVRT	resolveert
RYSVLVVRT	resolveert
RYSVR	rukeyser
RYSVYK	rijswijk
RYSY	rysavy
RYTAKV	tripitaka
RYTA	rita
RYTCY	ritchie
RYT	rybolt
RYTSGRT	ritsgert
RYTVGR	rittweger
RYTYSGRT	ritsgert
RYTZGRT	rutgert
RYTZ	ritz
RYTZR	retzer
RYVARD	rivard
RYVBR	rayburn
RYVDT	rydquist
RYVMLR	ruemmler
RYVNSVN	reynoldson
RYVNVLD	reynolds
RYVPKA	riopka
RYVR	rayer
RYV	rysavy
RYVRZ	ramirez
RYVV	rysavy
RYVYRH	roworth
RYVYS	ryukyus
RYYAD	riyad
RYYD	riyad
RYYNKS	rienks
RYYR	rayer
RYZ	ryzman
RYZR	retzer
RYZVLVRT	resolveert
RYZV	rizvi
RYZVY	rizvi
RZBRY	roseberry
RZNBAVM	rosenbaum
RZNFLD	rosenfeld
RZNKRANS	rosencrans
RZNLF	rosenlof
RZNMN	rosenman
RZNTJY	resyntje
RZVLVRT	resolveert
RZYNT	reymont
SAARTJ	saartje
SABGLASYAL	subglacial
SABHANY	subhani
SABLT	establishment
SABRAMANYAM	subramaniam
SABRAMANYAN	subramanian
SAB	saab
SABTNS	sabinas
SABT	sabot
SABVRYN	sabourin
SABVS	sabiks
SABYN	sabin
SABYNY	sabine
SACAT	shachat
SACK	sacks
SACR	starcher
SADGRV	sadgrove
SADHA	shadha
SADLR	sadler
SADRBLAM	soderblom
SADYAH	shadiyah
SADYH	shadiyah
SADYK	sandvik
SADYKV	sandvik
SADYKVYH	shadiyah
SADYKYV	sandvik
SADYVP	sandy
SAFR	sanford
SAF	salfi
SAFT	safoutin
SAFTVR	sauter
SAFTYN	safoutin
SAGARS	sagittarius
SAGA	sagan
SAGAYY	sagady
SAGN	sagan
SAGRV	sadgrove
SAGRV	sadgrove
SAHASY	sahasi
SAH	sahr
SAHVLM	sahel
SAJN	stajano
SAJRV	sharov
SAKAMVTV	sakamoto
SAKARY	sakari
SAKAYV	sakharov
SAKLAD	saklad
SAKLA	saklad
SAKSNA	sakinah
SAKSNM	isakson
SAKS	saks
SAKS	saks
SAKSVN	isakson
SAKSYM	saks
SAKTN	sackton
SAKT	sackett
SAKYA	shakya
SAKY	shakya
SALGA	shaligram
SALGVRV	salgueiro
SALKRAS	sankaras
SALK	salk
SALMVND	salmond
SALMY	salmi
SALTZMN	saltzman
SALTZ	saltzman
SALVMN	salmond
SALVM	salem
SALVMVN	salmond
SALYAN	salian
SALYGRAM	shaligram
SALYN	salian
SALY	saley
SALYT	salyut
SALYVAN	salvadoran
SALZBRG	salzberg
SALZNBRG	salzenberg
SAMADAR	samaddar
SAMAH	samah
SAMAKR	samar
SAMAN	samman
SAMANTA	samantha
SAMANTA	samantha
SAMAR	samar
SAMAS	samars
SAMBAT	shambat
SAMBVLYK	sambolec
SAMGYN	saigon
SAMH	samah
SAMK	samosky
SAML	samel
SAMN	samman
SAMRAL	sumrall
SAMR	samar
SAMR	samar
SAMRZ	samar
SAM	sam
SAMS	sams
SAMTYNG	samsung
SAMVLS	samuels
SAMVN	samoan
SAMVSKY	samosky
SAMVYL	samuel
SAMYR	samir
SAMYT	samoset
SAMYT	samoset
SAMZ	salmi
SANAHAN	shanahan
SANANDV	sunando
SANA	sana
SANBRN	sansburn
SANCTY	sancheti
SANDAR	sundar
SANDHV	sandhu
SANDLYN	sandlin
SANDMAN	sandman
SANDRAM	sandra
SANDRM	sandra
SANDRNZ	sanderson
SANDRS	sanders
SANDRSVN	sanderson
SANDRZ	sandra
SANDRZ	sandra
SAND	sand
SANDYP	sandy
SANDY	sandy
SANGLD	slangsvold
SANG	sang
SANG	sang
SANGV	slangsvold
SANJAY	sanjay
SANJH	santje
SANJSTR	sangster
SANKAR	sankara
SANKN	sunken
SANKR	sankara
SANKR	sankara
SANK	sanka
SANK	sanka
SANLA	scanlan
SANLY	stanley
SANNAR	sanner
SANRANG	semarang
SANRAYZ	sandra
SANRJH	sannertje
SANRTH	sannertje
SANRTJY	sannertje
SANRT	sanskrit
SANSAYN	santayana
SANSBRN	sansburn
SAN	san
SAN	san
SANSS	spanishs
SANST	sangster
SANSVN	sansing
SANTANA	santana
SANTA	santa
SANTH	sumanth
SANTJ	santje
SANTJY	santje
SANTRTJ	sannertje
SANT	saint
SANTSBRN	sansburn
SANTV	santo
SANTVS	santos
SANTVSY	santos
SANTYK	santayana
SANTY	santayana
SANVNDV	sandvik
SANVN	sandlin
SANV	sanov
SANYL	estanol
SANY	sandy
SANY	sandy
SANYT	saint
SANZBVRN	sansburn
SANZ	sanz
SAPRV	sapporo
SAP	saiph
SARANN	saranen
SARA	sara
SARATY	sarathy
SARDGNA	sardegna
SARDLV	shardlow
SARDV	sardo
SARJH	sarah
SARKNAS	sharknas
SARLVT	scarlatti
SARLY	searle
SARMA	sarma
SARNA	sarna
SAR	sadr
SAR	sadr
SARTAKSV	sarawaks
SARTH	sarathy
SARTJ	saartje
SARTJY	saartje
SART	sarto
SART	sarto
SARTZR	shartzer
SARVATH	sarathy
SARVK	sarawak
SARY	sarathy
SARYVL	sauriol
SASAKY	stanislavsky
SASAN	sawsan
SASKA	saskatoon
SASLAV	saslav
SASMN	salsman
SASNHYM	sassenheim
SASN	samson
SASTK	salste
SASTYK	sustik
SASZH	sasze
SASZ	sasze
SASZY	sasze
SATFN	salton
SATFYN	santayana
SATJ	santje
SATKAS	osakas
SATN	satan
SATR	satur
SATR	satur
SAT	sat
SAT	sat
SATVN	salton
SATVN	salton
SATVR	satur
SATV	saratov
SAVAN	shavian
SAVARAM	savaram
SAVARS	savarese
SAVCVK	sawchuk
SAVDY	sawdey
SAVFRD	sawford
SAVL	savel
SAVL	savel
SAVL	savel
SAVLZ	salazar
SAVNDRZ	saundra
SAVSAN	sawsan
SAV	slav
SAVTR	salvatore
SAVTR	salvatore
SAVTZ	savetz
SAVVY	savoy
SAVYN	saroyan
SAVYR	savoyard
SAYBRMYJ	sprayberry
SAYBRT	sprayberry
SAYDA	suwayda
SAYKS	sabiks
SAYKV	sakharov
SAYLR	sadler
SAYMKV	samosky
SAYM	salem
SAYMVN	samoan
SAYMVNS	samoans
SAYP	saiph
SAYRY	sprayberry
SAYTJ	santje
SAYT	salyut
SAYTV	salyut
SAYTZ	savetz
SAYVRYNGLNT	siuuirdingelant
SAYVYRDYNGLANT	siuuirdingelant
SAYVYR	savoyard
SAZH	shijiazhuang
SBASTYN	sebastian
SBASTYN	sebastian
SBAYN	sobhan
SBHAN	sobhan
SBRA	sabra
SBRT	osbert
SBRYANY	sebrianne
SBRY	sprayberry
SBS	sbs
SBYRAH	sabirah
SBYRA	soubyran
SBYRH	sabirah
SBYSTN	sabiston
SBYT	osbert
SDAH	sadah
SDAH	sadah
SDA	seda
SDAY	sunday
SDGRV	sadgrove
SDHA	shadha
SDH	sadah
SDLR	sidler
SDRHLM	westerholm
SDRVV	sadgrove
SD	sed
SDS	seds
SDVAL	sedvall
SDVR	seder
SDV	sedvall
SDYA	shadiyah
SDYH	shadiyah
SDYK	sudoku
SDYRA	sadira
SFARD	seward
SFRD	sanford
SF	shef
SFYLD	seinfeld
SGAL	segal
SGVRA	segura
SHA	shan
SHRAB	sohrab
SHR	sehr
SH	seh
SHYB	shub
SKANL	skean
SKARP	skari
SKAR	sekar
SKLANY	saklani
SKMAN	sheckman
SKRNTN	scranton
SKSNM	sikhism
SKSPYR	shakespeare
SKSTN	sistine
SKSTVN	sistine
SKT	eskite
SKVYRA	sekora
SKYVRYTY	skartsis
SLAMKY	slumkey
SLAMN	sulaymaniyah
SLAR	solar
SLARYR	slattery
SLAT	slate
SLAY	slaney
SLAYZ	salazar
SLBRG	selberg
SLBRG	selberg
SLDN	sheldon
SLDVN	sheldon
SLF	shelf
SLFY	salfi
SLJ	seljuk
SLJ	seljuk
SLK	silk
SLMA	selma
SLMA	selma
SLMYDY	shelmidi
SLMY	slumkey
SLNY	slaney
SLR	esler
SL	sly
SL	sly
SLT	slut
SLTH	slothouber
SLTJH	slothouber
SLTVN	salton
SLVA	silva
SLVD	salvador
SLVDVF	solodov
SLVN	slavin
SLVN	slavin
SLVVD	silverwood
SLYJ	seljuk
SLYMANYH	sulaymaniyah
SLYMA	sloma
SLYMH	sulaymaniyah
SLYM	slim
SLYM	slim
SLYNA	selena
SLYPRY	slippery
SLY	sly
SLYTR	slater
SLYV	sly
SMAH	samah
SMAL	small
SMALYAH	shamaliyah
SMALYH	shamaliyah
'SMAN	isman
SMAR	smart
SMAR	smart
SMA	soma
SMA	soma
SMAT	smart
SMBHV	shambhu
SMBLNKS	smolensk
SMH	smith
SMKVVN	smakovane
SMLY	smyley
SMMA	samma
SMMR	simmer
SMPL	sample
SMPT	sampath
SMRN	smargon
SMR	semir
SMR	semir
SM	sm
SMSC	samsel
SMSL	samsel
SMVTYVK	semotiuk
SMYAH	samiyah
SMYH	smythe
SMYLH	samblanx
SMYM	simoom
SMYRAH	samirah
SMYRA	samira
SMYRA	samira
SMYRH	samirah
SMYR	semir
SMYR	semir
SMYR	semir
SMYS	sammys
SMYTLY	smitley
SMYZ	semiz
SNAN	sinan
SNA	sena
SNA	sena
SNA	sena
SNDBRG	sandberg
SNDFVRD	sandford
SNDHYL	sendhil
SNDLYN	sandlin
SNDMN	sandman
SNDRS	sniders
SNDRZ	sindre
SND	sand
SNDS	sands
SNDVYK	sandvik
SNDY	sandy
SNDZ	shevardnadze
SNFNG	shenfeng
SNFTLYBN	senftleben
SNGAL	sangal
SNGLVGLV	cengeloglu
SNG	seng
SNG	seng
SNG	seng
SNGVPTA	sengupta
SNGVTA	sengupta
SNHAL	snehal
SNJH	rosenjack
SNKYAT	shenkiat
SNNRTJ	sannertje
SNNY	sonny
SNQAN	sinan
SNR	eisner
SNSBRN	sansburn
SN	sn
SNTJ	santje
SNT	saint
SNTYAGV	santiago
SNVRY	snorri
SNVTV	snotoa
SNYRJH	sannertje
SPARD	shepard
SPARNDAM	spaarndam
SPASTYN	sebastian
SPHR	sphar
SPRD	shepard
SPRYNGR	springer
SP	sup
SPYNVAL	sepinwall
SPY	sepoy
SRAB	sorab
SRAFYN	serafin
SRASVL	slangsvold
SRATVZA	serratosa
SRAYNH	sulaymaniyah
SRCAK	sarawak
SRDAR	sardar
SRHYR	serhir
SRJH	screech
SRKAMB	straub
SRKAN	struckman
SRK	shrek
SRKS	shreks
SRKYAH	sharqiyah
SRKYH	astrakhan
SRLD	esmeralda
SRL	serel
SRLYNG	serling
SRLY	shirley
SRMAN	sherman
SRMN	sherman
SRPNT	serpent
SRQYH	sharqiyah
SRR	serra
SRR	serra
SR	sr
SR	sr
SR	sr
SRSTA	shrestha
'SRT	israt
SRTRYD	shortreed
SRVADY	servadei
SRVARY	secretary
SRVMBC	sircombe
SRVVD	servideo
SRVYC	screech
SRVYDYV	servideo
SRVYS	srivijayas
SRVY	survey
SRYA	surya
SRYF	sharif
SRYF	sharif
SRYNGTVN	sherrington
SRY	story
SRY	story
SRY	story
SRYT	sprint
SRYVR	strayer
SSADRY	seshadri
SSANY	susan
SSDRY	seshadri
SSYL	sushil
STARLVZN	sturluson
STFANVS	stefanies
STHVRAJAN	sethurajan
STLAYN	scotland
STLND	scotland
STLR	stoler
STL	stael
STMF	stampf
STNT	stanton
STRATVN	straton
STRYTR	streater
ST	st
STVFL	stoffel
STVRAMAN	sethuraman
STV	steve
STYVNSVN	stevenson
SVAFVRD	swafford
SVAGATV	swagato
SVAMY	swamy
SVAMY	swamy
SVANK	sevanick
SVAN	sivan
SVAN	sivan
SVANYK	sevanick
SVANY	swany
SVARMN	swearman
SVART	swart
SVARYNGYN	swearingin
SVAS	sivas
SVA	siva
SVAYDA	suwayda
SVBHANDV	subhendu
SVBVTKA	sobotka
SVCAN	sercan
SVDAN	sudan
SVDAN	sudan
SVDARMV	sudarmo
SVDARSAN	sudarshan
SVDR	salvador
SVDYP	sudip
SVDYPTV	sudipto
SVDYR	salvador
SVDZ	shevardnadze
SVFN	stefan
SVFR	suffer
SVFYH	starfish
SVFYLD	seinfeld
SVFY	safeway
SVGN	sogen
SVGRLF	sugarloaf
SVG	savage
SVHA	soha
SVHAS	suhas
SVHA	soha
SVHM	sohm
SVKK	sikkim
SVKLA	shukla
SVKVL	sokol
SVKVMAR	sukumar
SVLAR	svalbard
SVLAYMNYAH	sulaymaniyah
SVLDR	shoulder
SVLD	osvaldo
SVLFVR	silver
SVLK	silk
SVL	savel
SVL	savel
SVLTAN	sultan
SVLT	iselt
SVLTZ	shultz
SVLVMVN	silverman
SVLV	silva
SVLVVY	silvey
SVLVYR	silver
SVLVY	silvey
SVLY	snively
SVLYS	shelbys
SVLYTAS	salyuts
SVMA	silverman
SVMASYKAR	somashekar
SVMJY	somjee
SVMN	silverman
SVMR	semir
SVMRVYL	somerville
SVMVY	somvay
SVMYKR	shumaker
SVNAR	savonarola
SVNA	slovenia
SVNDARAM	sundaram
SVNDRZ	sindre
SVNGKRN	songkran
SVNGR	singer
SVNGRVALA	songerwala
SVNG	svengali
SVNJA	sonja
SVN	sven
SVN	sven
SVN	sven
SVNSN	stevenson
SVN	sven
SVNY	sony
SVNY	sony
SVPN	sopan
SVPRATYK	supratic
SVPRYV	supriyo
SVP	sup
SVRAB	sorab
SVRAB	sorab
SVRAJ	suraj
SVRANA	surana
SVRK	selkirk
SVRL	serel
SVRNSN	sorensen
SVRN	severn
SVR	severn
SVR	severn
SVRS	severus
SVRSVN	severson
SVRTL	shortell
SVRTN	shorten
SVRVALY	sorvali
SVRYNDR	surinder
SVRYN	shryne
SVSAL	susalis
SVSA	sosa
SV	siva
SVSH	swash
SV	siva
SVSN	severson
SV	siva
SV	siva
SV	siva
SVSYA	sisyphean
SVSYL	sevastopol
SVTAN	stan
SVTFN	stefan
SVTN	seton
SVTR	silvester
SVTR	silvester
SVTS	shevats
SVTV	steve
SVYAK	soyack
SVYDA	suwayda
SVYDH	swedish
SVYFT	seyfert
SVYLR	shuyler
SVYLR	shuyler
SVYNGLR	swingler
SVYNRTVN	swinnerton
SVYN	sheyn
SVYN	sheyn
SVYR	savoyard
SVYTNKY	switenky
SVYTV	seytie
SVYYNK	soyinka
SVZALYS	sallys
SVZANA	savannah
SVZANH	savannah
SVZA	souza
SVZ	savetz
SVZV	savetz
SVZY	suzy
SYANDRA	sandra
SYANG	shenyang
SYANG	shenyang
SYANV	sylvan
SYBACR	seebacher
SYBL	sybil
SYBL	sybil
SYBLT	sebolt
SYBLY	sibley
SYBRT	shebert
SYDA	suwayda
S'YDH	sadah
SYDLR	sidler
SYDLR	sidler
SYDMN	seedman
SYDNY	sydney
SYDR	snyder
S'YD	samoyed
SYD	snyder
SYD	snyder
SYDVR	snyder
S'YDY	sydney
SYFARD	savoyard
SYGL	segal
SYGL	segal
SYGLTVN	singleton
SYGMN	sigman
SYGMN	sigman
SYGMN	sigman
SYGMVND	sigmund
SYG	synge
SYGS	shenyangs
SYHAN	scythian
SYHN	scythian
SYHSVBHVN	sihsobhon
SYHY	sheehy
SYJH	shijiazhuang
SYJKV	siejko
SYJMN	sijmen
SYKAGV	sinkiang
SYKAR	shiyekar
SYKARV	shiyekar
SYKR	shiyekar
SYK	slyke
SYKVLV	schuylkill
SYKVRA	sekora
SYKY	sky
SYLA	scylla
SYLBRMAN	silberman
SYLBRMN	silberman
SYLDN	sheldon
SYLDZ	isolde
SYLK	shylock
SYL	sibyl
SYLVAN	sylvan
SYLVA	sylvan
SYLVD	salvador
SYLVNN	silvonen
SYLVRBRG	silverberg
SYLVRMN	silverman
SYLVR	sylvester
SYLVRTVRN	silverthorne
SYLVRVD	silverwood
SYLV	sylvan
SYLVVD	silverwood
SYLVYA	sylvia
SYLVYA	sylvia
SYLVY	smyley
SYLVYV	smyley
SYLYG	seelig
SYLYMAN	sulaymaniyah
SYLYMN	sulaymaniyah
SYLY	smyley
SYLY	smyley
SYLYT	salyut
SYLZMN	saltzman
SYLZ	schulz
SYLZ	schulz
SYMAL	somali
SYMARD	simard
SYMAYH	sulaymaniyah
SYMBAB	siembab
SYMLR	simler
SYMNDS	simonds
SYMN	symington
SYMN	symington
SYMN	symington
SYMN	symington
SYMN	symington
SYMNZ	symington
SYMPLYSYTY	simplicity
SYMR	seymour
SYMR	seymour
SYMS	systems
SYMS	systems
SYMSYK	somashekar
SYMVDYNZ	simodynes
SYMVNA	simona
SYMVNDS	simonds
SYMVNH	sulaymaniyah
SYMVNH	sulaymaniyah
SYMVN	symington
SYMVN	symington
SYMVNSN	simonson
SYMVNS	simons
SYMVNZ	symington
SYMVNZ	symington
SYMYNG	symington
SYMYNGTVN	symington
SYMYN	simodynes
SYMYN	simodynes
SYMZ	semiz
SYMZ	semiz
SYNA	soyinka
SYNAN	sinan
SYNA	soyinka
SYNAYN	santayana
SYNDLMN	sindelman
SYNDRH	sindre
SYNGLTVN	singleton
SYNG	synge
SYNK	soyinka
SYNKLARY	sinclair
SYNKLAYR	sinclair
SYNKLR	sunker
SYNK	soyinka
SYNR	senior
SYN	sync
SYN	sync
SYN	sync
SYN	sync
SYN	sync
SYN	sync
SYN	sync
SYNTYA	santayana
SYNV	synge
SYNVY	sydney
SYNYBALDY	sinibaldi
SYNYG	synge
SYNY	sydney
SYPL	seipel
SYPLVAYDN	salvadoran
SYPLVYDN	schipluiden
SYPLZ	sipples
SYPMN	shipman
SYPN	stolypin
SYPRYANV	sipriano
SYP	skype
SYRAFYN	serafin
SYRAN	syrian
SYRANT	sierant
SYRA	syria
SYRAY	sporay
SYRCNT	searchnet
SYR	syria
SYRKVYS	starkeys
SYRL	serel
SYRLY	shirley
SYRR	sprayberry
SYR	syria
SYR	syria
SYR	syria
SYRS	syrias
SYRS	syrias
SYRVKA	sirucka
SYRVN	styron
SYRVS	syrias
SYRVYZ	suarez
SYRYF	styrofoam
SYRYL	sheryl
SYRYLV	sheryl
SYRYNG	serling
SYSABA	susana
SY	sky
SY	sky
SY	sky
SY	sky
SYSK	sisk
SYSLVNZ	mussolini
SYSLV	saslav
SYS	sonys
SYSTMZ	systems
SYSZ	sasze
SYTARAM	sitaram
SYTA	scythia
SYTAY	stacy
SYTH	smythe
SYTH	smythe
SYTJ	sytje
SYTJY	sytje
SYTLAYV	stolichnaya
SYTLR	shetler
SYTRAH	sitrah
SYTRA	sinatra
SYTRH	sitrah
SYT	sytje
SYT	sytje
SYTS	systems
SYTV	sytje
SYTYA	scythia
SYTYH	styx
SYTY	sytje
SYTYZN	stutzman
SYTZ	seitz
SYTZ	seitz
SYVALD	osvaldo
SYVALV	sunnyvale
SYVA	sylvan
SYVAYRDYNGLNT	siuuirdingelant
SYVLA	scylla
SYVL	sunnyvale
SYVMN	silverman
SYVNG	synge
SYVNKA	soyinka
SYVN	sylvan
SYVNYS	sydneys
SYVRDYNGLNT	siuuirdingelant
SYVR	sylvester
SYV	sylvan
SYV	sylvan
SYVSMNZ	sigismund
SYVVD	samoyed
SYVYRDYNGLANT	siuuirdingelant
SYVY	smyley
SYVY	smyley
SYYVAYRDYNGLNT	siuuirdingelant
SYYVNYL	sunnyvale
SYZNHYM	sondheim
SZARV	szilard
TABVK	tabuk
TABYT	talbot
TAC	taco
TADR	tandiary
TAD	tad
TAFT	taft
TAFTZ	taft
TAFVN	taffone
TAGLV	tagle
TAHARA	tahara
TAHRYHA	tahara
TAHVN	tahoun
TAJH	taejon
TAKA	taka
TAKMN	taklamakan
TAKR	tasker
TAKSBRY	strasbourg
TAKV	taki
TAKY	takiyah
TALAN	tallan
TALBRG	thalberg
TALBVYZ	talboys
TALKVT	talbot
TALMAYR	thallmayer
TALMN	talman
TALMY	talmy
TALN	tallan
TALNV	tallan
TALS	italys
TALVANN	tolvanen
TALYBAH	talibah
TALYS	italys
TAMANA	tammana
TAMARA	tamara
TAMAS	tamas
TAMATYVS	tammanys
TAMAY	tammany
TAMBRVS	tombros
TAMB	tamburri
TAMPAS	tampas
TAMPKYNZ	tompkins
TAMSN	tamas
TAMSVN	thomsen
TAM	tam
TAM	tam
TAM	tam
TAMYNZ	tammuz
TAMY	talmy
TAMZ	tammuz
TANAK	tanak
TANA	tanak
TANG	tang
TANG	tang
TANJS	tianjins
TANKN	tanneken
TANN	tanner
TANTVN	tanton
TANYS	tanyas
TAPA	tampa
TAPLYN	taplin
TAPR	stamper
TAPSYN	transylvania
TAPTANY	taitano
TAPYK	tanganyika
TAPYN	taplin
TAPYV	tapio
TARA	tara
TARDL	tardell
TARKL	terkel
TARK	tarkenton
TARML	tamil
TARN	tarzan
TARQ	tariq
TARS	taras
TARSVN	taraldsen
TAR	tara
TARVB	tarub
TARYK	tarkenton
TASDYLR	tasdeler
TASKR	tasker
TATAM	tattam
TATARY	tartary
TATBAY	tatby
TATH	tabatha
TATJ	taatje
TATL	tantalus
TATL	tantalus
TATRVY	taterway
TATSVRV	tatsuro
TAT	tat
TAT	tat
TAT	tat
TATYH	tabatha
TATYH	tabatha
TATYL	tantalus
TATZ	startz
TAVARS	tavares
TAVRNYNY	tavernini
TAVR	tavares
TAV	travis
TAYBVT	talbot
TAYJMN	taejon
TAYLBRY	talbert
TAYLMANS	taklamakans
TAYLMNZ	talman
TAYLR	taylor
TAYLV	taylor
TAYMN	talman
TAYNVR	traynor
TAYRAY	tartary
TAYR	taylor
TAYRVN	talleyrand
TAYRY	tandiary
TAYSN	tahsin
TAYSVN	tahsin
TAY	tay
TAYT	tat
TAY	tay
TAYTY	tatby
TAYV	tay
TBT	tibet
TBVK	tabuk
TBYB	tribble
TBYT	tibet
TDL	trudel
TFYLAH	tafilah
TFYLA	tafilah
T'FYLH	tafilah
TGLBRG	tegelberg
TGL	tagle
THSYN	tahsin
TH	th
THYRAH	tahirah
THYRA	teheran
THYRH	tahirah
TJAJH	tjaatje
TJATJ	tjaatje
TKS	turks
TK	tak
TK	tak
TK	tak
TKYAH	takiyah
TKYH	takiyah
TLANDR	thelander
TLBRT	talbert
TLBVYS	talboys
TLBVYZ	talboys
TLFR	telfer
TLKVM	telecom
TLLV	tolliver
TLNT	tallent
TLR	tyler
TL	tl
TLYBAH	talibah
TLYBA	taliban
TLYBH	talibah
TLYB	talib
TMBRY	tombros
TMPLMN	tempelman
TMPLR	templar
TMPLTVN	templeton
TMPST	tempest
TM	tm
TMYR	thallmayer
TNANT	tennant
TNAYA	tenaya
TNBRVK	tenbrook
TNBV	tennebo
TNDYRY	tandiary
TNKN	tanneken
TNPV	tenpo
TNTS	tants
TNT	tent
TNVR	tener
TNVRYV	tandiary
TNYKN	tanneken
TNYSAN	tunisian
TNY	tiny
TPV	tupi
TQYH	takiyah
TRADA	terrada
TRAFTVN	trafton
TRAFVRD	trafford
TRAH	torah
TRAJKTNSYS	traiectensis
TRAKV	tripitaka
TRAN	tran
TRANYTSA	turnitsa
TRAP	trapp
TRAPYN	terrapin
TRASH	trash
TRASTR	traster
TRA	tra
TRAVAJLYA	travaglia
TRAVN	tran
TRAVZY	trauzzi
TRAYKTNSYS	traiectensis
TRAYNTH	trainham
TRAYNTZ	tarantino
TRAYNVR	traynor
TRAYSTNSYS	traiectensis
TRAYSTNYS	traiectensis
TRAYSY	tracys
TRAZ	taraz
TRBRY	thurber
TRD	torda
TRFVRD	trafford
TRLD	thurlede
TRLDY	thurlede
TRL	trull
TRLV	thurlo
TRMVYL	thermopylae
TRMYNAL	terminal
TRNR	turner
TRNSH	transcaucasia
TRNS	trans
TRN	tern
TRNTN	trenton
TRNT	trent
TRNYK	ternyck
TRSA	teresa
TRS	taras
TRSTVN	threston
TRTJY	truitje
TRTJY	truitje
TRTNH	trinh
TRTVAN	trethowan
TRTVN	triton
TRVB	tarub
TRVBY	trubey
TRVDL	trudel
TRVDSVN	troedson
TRVF	turoff
TRVGTVN	troughton
TRVHYKV	tereshkova
TRVKS	turks
TRVL	torvalds
TRVL	torvalds
TRVLYNGR	trollinger
TRVMBV	trumbo
TRVMYTR	trometer
TRVN	trevino
TRVP	trump
TRVRAYS	terras
TRVR	trevor
TRVRYK	ternyck
TRVRYS	tertiarys
TRV	travis
TRVTR	trotter
TRV	travis
TRVT	travolta
TRVYLYGR	terwilliger
TRVYRYK	ternyck
TRVYSDYL	truesdale
TRVYTH	truth
TRVYTJ	tryntje
TRVYT	tryntje
TRVYYJH	tryntje
TRYBL	tribble
TRYBL	tribble
TRYDVY	trudy
TRYGS	triggs
TRYJV	tryntje
TRYK	ternyck
TRYKTNSYS	traiectensis
TRYKT	trickett
TRYMSTAR	triemstra
TRYM	trim
TRYNDAD	trindade
TRYND	treindl
TRYNHAM	trainham
TRYNJH	tryntje
TRYNKL	trinkle
TRYNTH	tryntje
TRYNTJ	tryntje
TRYNT	tryntje
TRYNVR	traynor
TRYPS	tripps
TRYQ	tariq
TRYS	torys
TRYSTNSYS	traiectensis
TRYSTRM	tristram
TRYSY	torys
TRYSY	torys
TRY	tory
TRY	tory
TRY	tory
TRY	tory
TRYTL	tritle
TRYTL	tritle
TRYTVRY	territory
TRYVLV	transylvania
TRYVRAYS	terras
TRYVR	traynor
TRYVYTZ	startz
TRZH	trinh
TSKR	tasker
TSLA	tesla
TSLR	tesler
TSNR	tysinger
TSTA	testa
TS	ts
TSTR	tester
TSYMA	teshima
TSYNK	tesink
TTJY	taatje
TTRAD	tetrad
TTR	otter
TTRV	tetervin
TTRVYN	tetervin
TVAMA	tuama
TVARY	tandiary
TVAYCL	taylor
TVB	tb
TVBVTYS	tubutis
TVBYAS	tobias
TVBYN	tobin
TVDAR	tandiary
TVD	ted
TVFRY	tofferi
TVFTH	teeth
TVHLA	tuohela
TVKR	tucker
TVK	teck
TVKYV	tokyo
TVLANY	tolani
TVLA	travolta
TVLAY	trailways
TVLDV	torvalds
TVLMN	tolman
TVL	tuvalu
TVLYN	trevelyan
TVLY	trevelyan
TVLY	trevelyan
TVLY	trevelyan
TVLYVR	tolliver
TVLYV	trevelyan
TVMANY	tomany
TVMAS	tomas
TVMAS	tomas
TVMATYVS	tomatius
TVMBLY	twombly
TVMS	tims
TVM	tim
TVMY	timmy
TVMY	timmy
TVMY	timmy
TVMYTYVS	tomatius
TVMZ	tammuz
TVNAR	tonar
TVNGA	tonga
TVNG	ting
TVNG	ting
TVNG	ting
TVNJS	tonjes
TVNR	tener
TVNS	trevinos
TVN	trevino
TVNYS	tonyas
TVNYS	tonyas
TVNYS	tonyas
TVNY	tiny
TVRAD	tetrad
TVRAMBR	turambar
TVRAYA	thurayya
TVRBR	thurber
TVRDA	torda
TVRKAT	turkestan
TVRKV	tereshkova
TVRLDH	thurlede
TVRMALA	tormala
TVRMN	thurman
TVRNBRG	tornberg
TVRNLY	thornley
TVRNR	turner
TVRN	tavernini
TVRN	tavernini
TVRNTVN	thornton
TVRP	thorpe
TVRTL	turtle
TVRTN	turton
TVRTVN	turton
TVRVF	turoff
TVRVP	thorup
TVRYA	thurayya
TVRYN	traynor
TVRYSN	thoresen
TVRY	tory
TVRZ	tirza
TVSAR	tushar
TVSKANV	toscano
TVS	tevets
TVSV	tevets
TVSYNG	tusing
TVSYNK	tesink
TV	tevet
TV	tevet
TVTY	totty
TVVYS	torys
TVYDA	toyoda
TVYDY	teddy
TVYH	takiyah
TVYN	trevelyan
TVYT	tuyet
TVYT	tuyet
TVYYDYL	tyndale
TVYYG	tyng
TVYYN	trevelyan
TYBAT	tabatha
TYBL	timbol
TYBVT	tibet
TYCAVR	tichauer
TYD	toyoda
TYF	toft
TYFVRD	tifford
TYGV	tyng
TYHAN	tehan
'TYH	atish
TYJATH	tjaatje
TYJMN	tijmen
TYLBRY	tilbury
TYLDN	tilden
TYLGNR	tilgner
TYLMANS	tillmans
TYLMNS	tillmans
TYLMNZ	tolman
TYLN	tylenol
TYLR	tyler
TYLR	tyler
TYLV	tyler
TYLVTSAN	tillotson
TYLYNG	teeling
TYMBVL	timbol
TYMKV	timko
TYMN	tymen
TYMN	tymen
TYM	tymen
TYMVNYN	timonin
TYMVR	timor
TYMYAN	tysmans
TYMYNZ	tymen
TYMZ	tammuz
TYNANT	tennant
TYNA	tyndale
TYNDAL	tyndale
TYNDAL	tyndale
TYNGLY	tingley
TYNG	tyng
TYNG	tyng
TYNSL	tinsel
TYNSLY	tinsley
TYN	tyng
TYN	tyng
TYN	tyng
TYNY	tiny
TYPAL	westphal
TYPV	tupi
TYRNY	tyrone
TYRVKS	turks
TYRYH	torah
TYRY	tory
TYRZA	tirza
TYSMNZ	tysmans
TYS	tys
TYSYNJR	tysinger
TYSZA	tisza
TY	ty
TYTAY	tertiary
TYTH	teeth
TYTMAS	ticketmaster
TYTS	toyotas
TYT	tuyet
TYT	tuyet
TYTY	totty
TYVGA	tioga
TYVMYNN	tuominen
TYVNA	transylvania
TYVNYS	tonyas
TYVNYS	tonyas
TYV	tye
TYYVLN	tylenol
TYZ	titz
VADAPARTY	vadaparty
VADH	vandenhoff
VADRY	vandry
VADZN	vanduzen
VAFA	wafa
VAFYAH	wafiyyah
VAFYA	wafiyyah
VAGL	vangelder
VAGNR	vagner
VAGNR	vagner
VAGN	vaggen
VAH	vaughn
VAJDYK	vandyck
VAKFYLD	wakefield
VAKRDAYN	vardan
VAKVRN	vankeuren
VALANS	valerians
VALAS	valaries
VALDMANYVNA	waldmanneuenna
VALDMNNA	waldmanneuenna
VALDMNNYVYNA	waldmanneuenna
VALDMNYVNA	waldmanneuenna
VALDRAM	waldram
VALDV	valdez
VALDZ	valdez
VALH	valhalla
VALKA	valkila
VALKNAR	valkenaar
VALMN	walkman
VALNTYJN	valentijn
VALNTYN	valentin
VALN	valance
VALRYN	valerian
VALTMN	waltman
VALTN	valentin
VALTR	walter
VALTRZ	alcatraz
VALTVN	valentin
VALT	valenti
VAL	val
VAL	val
VALVM	valium
VALVRT	vaillancourt
VALVR	valur
VALV	vale
VALVYN	valvoline
VAL	val
VALYHVR	valihora
VALYNGTN	wallington
VALYNGTVN	wallington
VALYN	valenti
VALYS	valkyries
VALYS	valkyries
VALY	valley
VALY	valley
VALY	valley
VALY	valley
VALYY	valley
VALZ	valdez
VAMBVL	campbell
VANANTVRP	vanantwerp
VANANVRP	vanantwerp
VANATVRP	vanantwerp
VANBRN	vanburen
VANBVRN	vanburen
VANDNBRQ	vandenburgh
VANDN	vanden
VANDRVYR	vanderveer
VANDRVYYR	vanderveer
VANDVSN	vandousen
VANDVZN	vanduzen
VANDYK	vandyck
VANDZN	vanduzen
VANDZVN	vanduzen
VANG	vang
VANK	vancko
VANKVRN	vankeuren
VANKVRN	vankeuren
VANSCVNHVN	vanschoonhoven
VANSK	ulyanovsk
VANSKVNHVN	vanschoonhoven
VANSY	evans
VAN	van
VANVLK	vanvleck
VANVRANKN	vanvranken
VANVRNKN	vanvranken
VAN	van
VANZANT	vanzandt
VANZNDT	vanzandt
VARBRG	warborough
VARBRTVN	warburton
VARBRVG	warborough
VARBRVQ	warborough
VARBVRVG	warborough
VARBVRV	warburton
VARDY	vardi
VARGAS	vargas
VARGV	vargo
VARMA	varma
VARNR	warner
VARNR	warner
VARNS	varnes
VARN	vardan
VARN	vardan
VARNY	varney
VARTVN	wharton
VARTY	varty
VARVL	varvel
VARYANS	variants
VARYANTS	variants
VARYANTZ	variants
VARYVR	vanderveer
VASALV	vasallo
VASKY	waskey
VASLV	vasallo
VASM	waseem
VASNGTN	washington
VASNGTVN	washington
VAST	east
VAST	east
VASVN	vaseline
VAS	evas
VAS	evas
VASYK	wasik
VASYM	waseem
VASYNGTVN	washington
VASYT	wasit
VATANAB	watanabe
VATANYB	watanabe
VATKYNZ	watkins
VATRHAVS	patricas
VATRMN	waterman
VATRSVN	watterson
VATRZ	beatriz
VATS	vaitkus
VATV	vato
VAT	vato
VAVDRAY	waldram
VAVDRY	vawdry
VAYA	vaya
VAYB	vauban
VAYBY	vauban
VAYDMN	vandeman
VAYD	vijayawada
VAYGL	vangelder
VAYLDR	vangelder
VAYL	vail
VAYMN	vandeman
VAYNGRV	vijayanagar
VAYNTH	xanthippe
VAYN	visayans
VAYPKJ	wiepkje
VAYSMN	eastman
VAYS	visayans
VAYTHAVS	elizabethans
VAYTHRN	cathryn
VAYTHVRN	catherine
VAYTHVS	earths
VAYTVRS	waters
VAYTYKR	patkar
VAYTYKR	patkar
VAYZAK	ganzak
VAYZ	vaduz
VBR	vanburen
VBSTR	webster
VB	vibe
VCNR	wechner
VDAD	vadlamudi
VDBRG	edberg
VDLMVDY	vadlamudi
VDLYN	wedelin
VDMYR	vladimir
VD	ved
VFA	ufa
VFYAH	wafiyyah
VFYH	wafiyyah
VFYYH	wafiyyah
VGL	vogl
VGL	vogl
VGNR	vagner
VGNR	vagner
VHRA	vohra
VJDAN	wijdan
VJYHA	wajihah
VJYHH	wajihah
VJYH	upjohn
VKKYA	ilkka
VKRFAS	ukraines
VKRV	valkyrie
VK	vik
VLADAK	vladack
VLADAN	vladan
VLADV	vlado
VLAM	vladimir
VLAN	vladan
VLA	vela
VLA	vela
VLDMN	veldman
VLDMNVNA	waldmanneuenna
VLDMN	veldman
VLDN	velden
VLD	veld
VLFSVN	olafson
VLKMAN	volkman
VLK	volk
VLK	volk
VLMJH	elijah
VLMN	veldman
VLMTH	goldsmith
VLMTJ	wellemtje
VLMT	voldemort
VLNTA	walenta
VLNTYJN	valentijn
VLNTYN	valentin
VLR	valur
VLSKY	wolski
VLS	vals
VLSY	wolsey
VLTMR	voltmer
VLTR	voltmer
VLTRYNG	woltering
VLTRY	velletri
VLTY	welty
VLVDYN	volodin
VLVSV	volvos
VLYDH	walidah
VLYNGTVN	elkington
VLYNK	ulyanovsk
VLYS	vilyuis
VLYS	vilyuis
VLZL	valenzuela
VLZ	volz
VLZ	volz
VNABLS	venables
VNANTVRP	vanantwerp
VNASCVNVN	vanschoonhoven
VNBRN	vanburen
VNBVRN	vanburen
VNCVNHVVN	vanschoonhoven
VNC	vance
VNDAZN	vanduzen
VNDLND	wendland
VNDL	vandal
VNDL	vandal
VNDMN	vandeman
VNDRFVRD	vanderford
VNDRVR	vanderveer
VNDRVYR	vanderveer
VNDRY	vandry
VNDVSN	vandousen
VNDVVSN	vandousen
VNDVZN	vanduzen
VNDVZN	vanduzen
VND	vinod
VNDYK	vandyck
VNDZL	wendzel
VNG	vang
VNHF	vanhoff
VNKATA	venkata
VNKAT	venkat
VNKRN	vankeuren
VNKRN	vankeuren
VNKVRN	vankeuren
VNKVRN	vankeuren
VNKV	vinko
VNKYVRN	vankeuren
VNKYVRN	vankeuren
VNLK	vanvleck
VNNTVRP	vanantwerp
VNRNKN	vanvranken
VNR	vagner
VNRYPR	vanriper
VNSKVNHVVN	vanschoonhoven
VNSL	evansville
VNS	evans
VNSVNHAVN	vanschoonhoven
VNSVNHVVN	vanschoonhoven
VNTRLY	ventureli
VNTZ	weintz
VN	van
VNVLK	vanvleck
VN	van
VNVRANKN	vanvranken
VN	van
VN	van
VN	van
VNYK	vandyck
VNYLK	vanvleck
VNYNGR	enzinger
VNYRNKN	vanvranken
VNZANDT	vanzandt
VNZANT	vanzandt
VNZND	vanzandt
VNZNT	vanzandt
VRBK	verbeck
VRBVRVF	eversberg
VRCYK	verbeck
VRDAN	vardan
VRHVST	verhulst
VRKMN	workman
VRLV	varlow
VRLYND	verlinde
VRLYNG	worling
VRMASRN	vermaseren
VRMAS	vermaas
VRMA	varma
VRMVLN	vermeulen
VRMVNT	vermont
VRMYLYYVN	vermillion
VRMYVLN	vermeulen
VRMZ	hormuz
VRNGRYN	wernegreen
VRNN	vernon
VRNR	virendra
VRSVVN	iverson
VRVBL	wrobel
VRVJH	brejcha
VRVTH	irth
VRVVD	vardi
VRVVTJ	vrouwtje
VRVYJ	verweij
VRYLAV	verlaine
VRYLV	exercycle
VRYTY	verity
VRY	every
VSAL	vestal
VSLYAN	wesleyan
VSLY	wesley
VSLZ	schulz
VSM	isom
VSTAL	vestal
VSTFAL	westfall
VSTLY	westley
VSTLY	westley
VSTMVRLND	westmoreland
VSTN	istian
VSTRHLM	westerholm
VSTRN	ostrin
VSTRVLDT	westerveldt
VSTRVLT	westerveldt
VSTR	vorster
VST	vest
VSTVN	istian
VSTVR	vorster
VST	vest
VST	vest
VS	vs
VSYM	isom
VSYT	vest
VSY	veasey
VSY	veasey
VTMVR	voltmer
VTR	vitor
VTR	vitor
VTS	vitos
VT	vato
VVDARD	woodard
VVDBRN	woodburn
VVDD	widad
VVDGYT	edginton
VVDHAVS	idahoans
VVDN	velden
VVDRV	vanderveer
VVDVARD	edvard
VVD	vivaldi
VVGLR	vogler
VVGL	vogl
VVG	vega
VVJAK	vojak
VVK	vivek
VVLARD	villard
VVLARD	villard
VVLMN	veldman
VVLTRNYNG	woltering
VVLY	evelyn
VVLZ	volz
VVN	vivian
VVN	vivian
VVRDN	verdun
VVRYLAV	verlaine
VVRYLV	exercycle
VVS	volvos
VVTR	vitor
VYANN	vianen
VYBH	vandenburgh
VYBKH	rebekah
VYBRND	wijbrand
VYBVVV	vibe
VYB	vibe
VYBY	oxby
VYCARD	witchard
VYCVRA	victoria
VYDAD	widad
VYDAL	vidal
VYDAL	vidal
VYDA	vijayawada
VYDD	widad
VYDFANG	wildfong
VYDMAN	veldman
VYDMN	veldman
VYDMR	voldemort
VYDRY	vawdry
VYDVN	weyden
VYD	ved
VYDYR	vader
VYDY	vawdry
VYDYV	vawdry
VYFAL	wifall
VYGAND	weigand
VYGAND	weigand
VYGJYN	dongjin
VYGLY	wigley
VYGMVR	wigmore
VYGN	vigen
VYGRT	wegert
VYGSTVN	wigston
VYGTVN	wigton
VYG	voyager
VYGYNZ	gorgonzola
VYJBRAND	wijbrand
VYJBRND	wijbrand
VYJDAN	wijdan
VYJNAND	wijnand
VYJND	wijnand
VYJNND	wijnand
VYJN	valentijn
VYKAMP	weikamp
VYKAS	vikas
VYKAVN	volkman
VYKFYLD	wakefield
VYKHAM	wickham
VYKLVND	wiklund
VYKNZ	niknaz
VYKRAM	vikram
VYKRS	vickers
VYKRZ	vikram
VYKS	eycks
VYKS	eycks
VYKTVR	viktor
VYKTVR	viktor
VYKTYM	visakhapatnam
VYK	vandyck
VYK	vandyck
VYK	vandyck
VYK	vandyck
VYLADVT	viladot
VYLARD	villard
VYLARD	villard
VYLASKV	vladivostok
VYLAS	vilas
VYLATZ	blatz
VYLA	vela
VYLA	vela
VYLBR	welber
VYLDKAT	wildcat
VYLDRMN	wilderman
VYLDYNG	wilding
VYLFRD	wilford
VYLFRD	wilford
VYLHAYT	engelhardt
VYLHLMAS	wilhelminas
VYLHLMVS	wilhelmus
VYLHLM	wilhelm
VYLJV	viljo
VYLKAKS	volkswagens
VYLKANS	volkswagens
VYLKAS	volkswagens
VYLKNS	volkswagens
VYLKN	volkman
VYLKRSVN	wilkerson
VYLKYNSN	wilkinson
VYLKYNSVN	wilkinson
VYLKYN	volkman
VYLKYNZ	volkman
VYLLMVS	wilhelmus
VYLMNTJY	willemintje
VYLMR	voltmer
VYLMTJY	wellemtje
VYLMT	voldemort
VYLMVR	voltmer
VYLMVT	voldemort
VYLMYNTH	almintaqah
VYLMYNTJH	willemintje
VYLMYNTJ	willemintje
VYLMYNT	wilmington
VYLMYNYTH	almintaqah
VYLND	verlinde
VYLND	verlinde
VYLNR	valkenaar
VYLR	velcro
VYLR	velcro
VYLSVN	volkswagen
VYLS	eyles
VYL	eyles
VYL	eyles
VYL	eyles
VYLYAM	vladimir
VYLYAMYNA	williamina
VYLYANY	wesleyan
VYLYNGHAM	willingham
VYLYNGZ	vlaardingen
VYLYR	valkyrie
VYLY	evelyn
VYLY	evelyn
VYLY	evelyn
VYLZ	volz
VYLZ	volz
VYMAL	vimal
VYMAN	eyman
VYMAN	eyman
VYMBRLY	wimberley
VYMN	eyman
VYMPH	olympic
VYMPJH	wimpje
VYMPJ	wimpje
VYMPJY	wimpje
VYMP	olympia
VYMPYJ	wimpje
VYMR	vermeer
VYNATA	vinata
VYNBRG	vandenburgh
VYNCSTR	winchester
VYNDN	vanden
VYNDRZ	gonderzik
VYNDVM	vandeman
VYND	vinod
VYNKLMAN	winkelmann
VYNKL	winkle
VYNKLZ	winkle
VYNKV	vinko
VYNLT	vanderbilt
VYNND	vanzandt
VYNN	wynn
VYNRT	vandivort
VYNR	vijayanagar
VYNSNT	wisconsinite
VYNSN	vinson
VYNSR	winsor
VYNSTD	wainstead
VYNSTRVM	winstrom
VYNSTVK	weinstock
VYNSTVN	winston
VYNSVN	vinson
VYNTH	elnath
VYNTJH	eyntje
VYNTJ	eyntje
VYNTJY	eyntje
VYNTRFYLD	winterfeld
VYNTRMYVT	wintermute
VYNTRR	winterer
VYNTR	ventureli
VYNTRZ	ventureli
VYNTVN	oxycontin
VYNT	eyntje
VYNTZ	weintz
VYN	evelyn
VYNVKR	winokur
VYN	evelyn
VYNYBL	venable
VYNYKY	vandyke
VYNYNGR	weninger
VYNYNGSTD	winningstad
VYNYZ	voronezh
VYNZ	voronezh
VYPKJH	wiepkje
VYPKJ	wiepkje
VYPKJY	wiepkje
VYPK	overpeck
VYPYN	vipin
VYRAF	viraf
VYRCVAL	orval
VYRJYL	carbajal
VYRJYNYA	arjuna
VYRNDRA	virendra
VYRN	vern
VYRSMA	wiersma
VYRTANN	virtanen
VYRT	enyart
VYR	voyager
VYR	voyager
VYR	voyager
VYRYANA	wiryana
VYRZ	verizon
VYSAL	vestal
VYSKA	osaka
VYSL	vestli
VYSPY	vispi
VYSR	eyster
VYSR	eyster
VYSTFAL	westfall
VYSTVN	weston
VYST	eyster
VYS	ivorys
VYSVN	elysian
VYSVN	elysian
VYSY	odyssey
VYSYVS	odysseys
VYTAKA	mintaka
VYTAKR	whitaker
VYTAL	vestal
VYTFYLD	whitfield
VYTKAMB	tutankhamen
VYTKVS	vaitkus
VYTMR	voltmer
VYTMVR	voltmer
VYTNBRG	whittenburg
VYTN	egyptian
VYTN	egyptian
VYTSH	irtish
VYTSVN	whitson
VYT	egypt
VYTVL	virtual
VYTVR	eyster
VYTVRYA	victoria
VYTV	eyntje
VYT	egypt
VYT	egypt
VYT	egypt
VYTYKR	whiteaker
VYTYK	vitek
VYTYNGTVN	whittington
VYTZ	oltz
VYVA	vaya
VY	ivy
VYVKS	eycks
VYVK	vivek
VYVLA	viola
VYVR	voyager
VYVVR	voyager
VYVYANH	ivanhoe
VYVYAN	vivian
VYVYK	vivek
VY	ivy
VY	ivy
VY	ivy
VYYRS	voyagers
VYZBRAND	wijbrand
VYZNAND	vivekananda
VYZNRY	inzhenery
VYZN	vizen
VYZRNR	virendra
VYZVN	vizen
VZDA	izroda
VZYNA	vezina
XALDAH	walidah
XALYDH	walidah
XAN	ian
XAY	way
XLYDA	wilda
XLYDH	walidah
XLYLH	ellsworth
XRDL	overdal
YAGLA	yagla
YAGR	yager
YAKVB	cakebread
YAKVLTY	bakelite
YAKVTAH	yakootah
YAKVTA	yakootah
YAMAHA	yamaha
YAMAHA	yamaha
YAMHA	yamha
YAMN	yarman
YAMYNAH	yaminah
YAMYNA	yaminah
YANGR	waingrow
YANG	yang
YANGY	yangi
YANSVN	yanson
YANVVYTZ	yanowitz
YAN	yan
YANYV	yaniv
YANZK	yanzek
YAP	yap
YARGR	carragher
YARLA	yaroslavl
YARMAN	yarman
YARVN	yaron
YARVS	yaros
YARYAN	yaryan
YASAR	yasar
YASR	yaser
YASYN	yasin
YASYRAH	yasirah
YASYRH	yasirah
YASY	yaser
YATS	yates
YAV	yaniv
YAYN	yaryan
YKVTAH	yakootah
YLND	yelland
YLYC	yelich
YLYF	wycliffe
YMHA	yamha
YMN	yumn
YMYNH	yaminah
'YN	ayn
YRBRY	yerbury
YRMYS	yermish
YSRA	yasirah
YSRYH	yasirah
YSYRAH	yasirah
YSYRA	yasirah
YSYRH	yasirah
YTR	eyster
YVBYRA	iberia
YVFYNGTVN	uffington
YVHANS	ethans
YVKYLV	ukelo
YVK	yok
YVLYN	evelyn
YVMANS	youmans
YVMN	yumn
YVMVRA	uemura
YVNAL	uenal
YVNAS	yonas
YVNGSAP	yongsup
YVN	yvonne
YVNSVN	yanson
YVN	yvonne
YVNYZA	espinoza
YVRANYM	uranium
YVRBANYK	urbanik
YVRK	york
YVRMV	yermo
YVRYNA	wiryana
YVSF	yosef
YVSTN	yousten
YVS	yves
YVSYV	yossy
YVSY	yossy
YVSY	yossy
YVZF	yosef
YVZR	ezor
YYKA	yeka
YYK	yok
YYTZ	yanowitz
YYTZ	yanowitz
YZAK	yzaak
YZK	yzaak
YZYD	yazid
ZABL	zabel
ZABZ	zambezi
ZACARY	zachary
ZAFYNA	zafina
ZAGAR	zagar
ZAHD	zahid
ZAHYD	zahid
ZAKVB	zaki
ZAKVB	zaki
ZAKVMYNTAY	almintaqah
ZAKYVS	izaaks
ZAK	zaki
ZAKY	zakiyyah
ZALAN	zalan
ZAMVR	zamora
ZAMYT	zammit
ZANGRL	zangerl
ZAN	zand
ZANKH	zanneke
ZANKY	zanneke
ZANK	zanuck
ZANS	zanes
ZANT	zapantis
ZAPARA	zapara
ZARA	zara
ZARRYTN	zjarritjen
ZARVS	zaires
ZARYA	zaria
ZARYH	zachariah
ZARYTN	zjarritjen
ZARYTZN	zjarritjen
ZATRVVD	waterford
ZAYNAH	zaynah
ZAYNA	zaynah
ZAYRA	zaira
ZAYR	zaira
ZAZA	zaza
ZFRY	zafirah
ZFYNA	zafina
ZFYNH	zaynah
ZHRA	zahra
ZHRA	zahra
ZHRA	zahra
ZHYD	zahid
ZHYRAH	zahirah
ZHYRA	zahra
ZHYRH	zahirah
ZJARYTJN	zjarritjen
ZJARYTN	zjarritjen
ZKH	zakiyyah
ZKYAH	zakiyyah
ZKYH	zakiyyah
ZKY	zakiyyah
ZK	zaki
ZK	zaki
ZLA	zola
ZLR	zeller
ZLTJ	eeltje
ZLYKAH	zedekiah
ZLYXA	zola
ZMANK	zemanek
ZMAN	zeman
ZMYRAN	zimmerman
ZMYT	zammit
ZNG	zang
ZNK	zanuck
ZNTNR	zentner
ZNYKH	zanneke
ZN	zn
ZPKA	zepka
ZRA	ezra
ZRYA	zaria
ZRYFA	zarifa
ZRYF	zarifa
ZRYH	zachariah
ZRYNK	zurink
ZRY	zachary
ZVHANS	szechuans
ZVHANSN	johansen
ZVKA	zepka
ZVLD	zold
ZVL	zola
ZVLMR	zolmer
ZVLY	zulu
ZVLYKA	zuleika
ZVNTK	zontek
ZVRYNK	zurink
ZVRYSYKA	szymborska
ZVTRVD	zoeterwoude
ZVTRVVD	zoeterwoude
ZVVAYTA	zapata
ZVVYTA	zuvieta
ZVYTA	zuvieta
ZVYTRVVD	zoeterwoude
ZVZF	izzo
ZYGMVNT	zygmunt
ZYLT	zoloft
ZYL	zyl
ZYMRAN	zimraan
ZYNAH	zaynah
ZYNA	zaynah
ZYNB	zainab
ZYNH	zaynah
ZYNSR	zinser
ZYRA	zaira
ZYRYLY	zirilli
ZYR	zeyer
ZYTV	zyrtec
ZYVRYNK	zoerink
ZYVTRVD	zoeterwoude
ZYZY	zaporozhye
ZZA	zaza
ZZ	izzo
