BAVKAM	bawcom
BASYL	basil
ASBRYNK	asbrink
MADYGAN	madigan
ASPVSYTV	esposito
RYGAN	ragan
HRLAYNDYZ	herlindis
JVANG	juang
DAVT	dout
ABRAHYM	ibrahim
FLVYD	floyd
'BDAL'ZYR	abdulaziz
GRAV	graw
AGATY	agate
MS'VD	masud
GAVYN	gavin
AYSTMAS	isthmus
YAN	yan
AMBRVSYVS	ambrosius
VALDV	waldo
TAMAS	tamas
ALYLYVNAS	alelyunas
KYVZVN	quezon
DANHAM	dunham
RAYSTLYN	raistlin
BVSTVN	boston
DYRKS	dirks
DASYVK	doseok
BRYVN	bryon
TRAVN	trown
AVSTRANDR	ostrander
ALYN	elin
SVANK	swank
DAKV	daco
ASTYNTJH	steentje
KARTYS	curtis
SAKAYV	sakaue
KVRL	corl
KRYSTYAN	kristian
BLVM	blum
FVTYNVS	fotinos
AVL	owl
KASANVVA	casanova
RVLFH	rolfe
ASTNFVRT	stenfort
KANAKAKVRN	kanakakorn
RAD	rad
RAKYKVT	racicot
ANPYNGKV	unpingco
VYMPJH	wimpje
DVY	doi
GAN	gan
SALMY	salmi
SYLK	silk
AKYL	akil
LATALA	latala
ARGAR	orgar
ALVA	alva
SVZV	sozo
DVRAN	doron
VADAPARTY	vadaparty
PADYAL	padial
SLAT	slut
MVNKAR	moncur
ALSVN	olson
FVN	van
RAFYKYV	rafique
LAK	loc
HVDSVN	hodson
DAMYANV	damiano
AVYVA	aviva
AYMAN	ayman
HAPSVN	hopson
TYMBVL	timbol
GALY	gali
PYVRYNTN	purinton
GYZAV	gizaw
ASMA	asma
FYGVRA	figura
FRNASYSKAZ	frnaciscus
AMAL	amal
AYSLYK	icelic
VYLYANY	villani
AVMAKY	ohmaki
MARTYJNTJY	martijntje
GYBSVN	gibson
KRYST	crest
PRVMVNTVRY	promontory
LAZARD	lazard
AVRM	orem
BARKASFYLD	barksfield
VYNATA	vinata
SVNJA	sonja
PRYSTVN	preston
HALY	hale
KALPANA	kalpana
BVNYN	bonin
MARAT	marat
GAT	gat
ABY	ebe
ASPVRY	sporay
LYNKVYS	linkous
KVBSA	kobsa
PVLYS	polis
TRAVN	trown
MVN	mun
YARYAN	yaryan
BALYT	balit
LYNDRVTS	lindroth
KYNSVN	kinson
BAZBY	buzby
ARYKSVN	ericson
PVRTNVY	portnoy
ASTAD	stude
BYK	bik
SAVYN	savin
ABYNA	ebina
FRYTS	frits
BYVKRAFT	biocroft
MAYZ	mize
DANALD	danald
SANDHV	sandhu
AMYHAY	amihai
LVBYN	lubin
HVRVAT	horvat
DADGYVN	dudgeon
RYSLYNG	rysling
ASTVRR	storer
YANGY	yangi
BVNAR	bonar
FRANSYSYVS	frnaciscus
BVST	bost
SYRVS	cyrus
AYNA	inna
MYLVS	milos
LASKALA	lascala
KRH	kre
'LYA	alya
AFRA	afra
BRAYS	bryce
AMY	ami
ALDYN	eldin
MAHAVLT	mahault
RAMVLVS	romulus
PYNG	ping
KVASYM	quasim
SANYL	sunil
DABYNZ	dobyns
KANAK	kanak
BALYN	balin
LYSTVN	liston
GASKVYYN	gascoyne
KVNV	kono
AGATY	agate
BRAVV	bravo
MANK	monk
KRVB	krob
DVSKV	dusko
AND	and
LANG	long
DVRYS	doris
FRASTY	frosti
SYMS	sims
HYNZ	hinz
LVN	lon
ADGYNGTVN	edgington
BALTAKS	baltaxe
DYKSVN	dixson
DYLAN	dilan
SAP	sup
KYVZVN	quezon
VYLYNGZ	willing
AVSTRANDR	ostrander
PRATVL	pratul
PRAYM	prime
HLAVYN	hlavin
SANTSBRN	sansburn
TYVGA	tioga
YARLA	iarla
JARBVT	jarbot
JANK	junk
GRAHAM	graham
AVRN	orne
MANY	mani
VYNZ	winz
SAMVYL	samuel
MAYR	mire
LAS	las
LAVSTAD	lovstad
RANA	rana
VYLJV	viljo
VYLKANS	vilcans
YVNAL	uenal
BYRK	birk
PLATFVRM	platform
ASTRYD	astrid
ALVA	alva
LYNGAS	lingus
ASVALD	oswald
BRYJ	brij
HAYVL	houle
ADRYS	idris
MVBAY	mawby
FLVDYN	flodin
MYNTVN	minton
FLVRA	flora
AMYVT	amyot
AYRAY	airay
ASPATSVVD	spotswood
KALAFATAS	kalafatas
BYVAN	bevan
SYTARAM	sitaram
BAND	bond
KALB	kalb
GVRASPY	gorospe
DAHVD	dahuk
SVRAJ	suraj
ARPYN	arpin
KAMAL	kamal
ASTNSRAD	stensrud
MYKVLYK	mikolic
SVNDARAM	sundaram
LYNDGARD	lindgard
DAVSVN	dawson
ASTYVNSVN	stevenson
VYK	vik
PAPLY	popli
AYTJY	oetje
VALDRAM	waldram
ASKADZ	scudds
FYGARD	figard
HARBVD	harbud
KVJYAS	kogias
LYVAYN	levine
AARVN	aaron
LVYYSALY	loiselle
ASTRND	strand
TVMANY	tomany
TYSZA	tisza
GRYGVR	gregor
PADYAL	padial
ARNVLD	arnold
JHANG	jhang
HVLM	holm
DAVNYNG	downing
LYNDAN	lyndon
PRAPYS	prupis
VYJNAND	wijnand
JANK	junk
AYS	ace
NYVKVYST	newquist
VAL	wal
MATAKV	matako
ASTYL	steel
ARYKA	erika
FRANSYSYVS	frnaciscus
DAKV	daco
AYNGLD	ingold
GRAG	grog
MARTY	marty
JVZY	josi
HADYL	hadil
KVBLA	kubla
RYYNKS	rienks
KAMB	kamb
SAYDA	saida
GAMBYNV	gambino
RAFYKYV	rafique
DYAB	diab
LARVKVYH	larocque
MYNARYK	minarik
KAPRAL	kapral
LAMARK	lamark
ATRY	atri
LASTRY	lustri
ASTVART	stewart
KYAT	kiat
GAYDA	gayda
ASPYRZ	spiers
MARANY	marani
KLAYSVN	clayson
ASTAYNMN	stineman
KAM	kam
PYNKVVYTZ	pinkowitz
VALVR	valur
VYLKYNZ	wilkins
HARPVLD	harpold
ALTANYN	eltanin
GVPALAN	gopalan
ANGVLV	angulo
KATRYN	katrin
LAVANDH	lawande
SYNYBALDY	sinibaldi
ARVYNG	irving
AMARAL	amaral
HYVM	hume
NADYG	nadig
SYLVYV	silvio
KARHART	carhart
AYSAK	isaac
SYMYN	simin
ARDYS	ardis
JVAN	juan
AYSVN	asson
LADASKY	ladasky
LYNK	link
LARA	lara
TVMY	tomi
AYMAN	aiman
PAL	pal
PYLAZV	peloso
ARVYVLA	arviola
PYZYALY	piziali
ASKALY	scally
VYNDVM	windom
AMBRVSYVS	ambrosius
MVRAD	murad
AYRP	earp
DYDA	rida
MAV	mau
FRAYTGRSA	fritgersa
KALAFVT	kalafut
ASTRND	strand
DAVKNYZ	dawkins
MVK	mok
GVANYAV	guanyao
RYSLYNG	rysling
GASPAR	gaspar
SYMVNH	simone
ANTVNYV	antonio
NYYVTN	newton
ZYZY	zeke
BABAR	babar
ALVYN	alwyn
GALYZYA	galizia
SLYM	slim
VYRJYL	virgil
ANRYKV	enrico
GAYNVR	gaynor
SYMPLYSYTY	simplicity
AVGYNH	eugene
'LY	ali
CYBANSKY	cybanski
ALVF	elof
ADVARD	edward
TAPTANY	toptani
SANRAYZ	sunrise
HARMAN	harman
SAYKV	psyko
ABH	abe
LVBV	lobo
LYNDAL	lindal
KRAK	kruk
SYTJY	sytje
KAPANGA	kapanga
KVSTA	costa
BASYN	basin
ALMYNTAKVA	almintaqah
MAYLN	milne
AVT	ott
ALMYNTAGAH	almintaqah
HYTZ	hitz
BYKSLR	bixler
ADRYANA	adriana
SAYVYR	sawyer
SAVAN	sawan
ABYL	abel
HYKARV	hikaru
HABVRA	habura
BANYTV	bonito
FVTYNVS	fotinos
ANDRYA	andrea
ASTNSRAD	stensrud
FRANKV	franco
AGYLA	aqila
PYVRYNTN	purinton
MVNYZ	muniz
TYMBVL	timbol
PANDYT	pandit
LVMBARDV	lombardo
LAV	law
ANVVY	envoy
DYVAR	dewar
GRAYYNGR	grainger
LAFGRYN	lofgren
ASLYNY	slaney
ASTYNSN	stinson
NAGASAKY	nagasaki
DVARTH	duarte
MANGLANY	manglani
AGVYV	agoyo
GRYLK	grilk
DVBYNYN	dubinin
HAVTYN	hawtin
AMBRVSYVS	ambrosius
TVM	tom
VAYN	vine
HAMYLTVN	hamilton
VYKTVR	victor
RABKYN	rabkin
VALTVN	walton
MYRTY	mirti
FAVST	faust
HAYZ	hise
ANTYLA	antila
ANYSH	anisa
PAGLYA	paglia
BABAH	babah
AKL	akl
ADMYRALZ	admirals
BABVRAV	baburao
BYNVY	binoy
GANG	gung
MKKARTY	mccarty
KALAHAN	calahan
HAKSL	haxel
SYNKLAYR	sinclair
BARKVS	barcus
AVRKNY	orkney
YANVVYTZ	yanowitz
PARTVS	partos
AGVYV	agoyo
TRAYNVR	traynor
LYNKVYS	linkous
VYKTVR	viktor
ATYYA	atiya
FAYRBANK	fairbank
KVNV	kono
LVND	lund
LVKV	loco
DYKV	dico
PATYL	patil
MAGVAYR	maguire
SVSYA	sucia
SAKAMVTV	sakamoto
BAVM	baum
AMYLY	emily
BARLAS	barlas
DRAGAN	dragan
SARMA	sarma
ASPYR	speer
BAYDA	bayda
HAYNS	hines
KASTANV	castano
MVHAN	mohan
MVRYN	morin
BRVANHAT	braunhut
AGYL	aqil
ADYH	adie
JHANG	jhang
MARSY	marcy
AMNA	amna
ABRAM	abram
DAMVN	damon
HASAKAH	hasakah
ADVARD	edvard
NYN	nin
ALYMA	ulima
KATALANV	catalano
MASAHYRV	masahiro
RASTY	rusty
YARVN	yaron
DVRA	dora
FAYK	fike
KARTYS	curtis
JVZY	josi
PVLYNG	poling
LYTVYN	litvin
AYK	aik
KATVALA	katwala
DYB	dib
LYBLYT	liblit
LYSTVN	liston
GRABNAR	grabnar
FRANKLYN	franklin
DYSAY	desai
SYSK	sisk
HYYN	hean
LVDVVYKA	ludovica
VYLKANS	vilcans
HYGARTY	hegarty
BRYGVY	bryguy
KVHN	cohn
ASTRND	strand
FRANKV	franco
AMYR	amir
KATRYN	katrin
ALAPATY	alapati
AVRYVLY	aureole
PRAPYS	prupis
ASTYNSN	stinson
SANTVS	santos
BRAYS	bryce
AYRP	earp
LAVYGNH	lavigne
AFTAB	aftab
LVNZ	lunz
SAVAN	sawan
TAMBRVS	tombros
SAKAYV	sakaue
