RAST	rust
NYKALAS	nicolas
GRAHAM	graham
GAN	gan
TVNG	tung
HAVARD	havard
RAFAL	rafal
TRVYYJH	truitje
PALFVRD	pulford
BALYGA	baliga
BARNAM	barnum
KAVYTA	kavita
LANDYN	landin
KATLYR	cutler
MARVAHA	marwaha
'LYA	alya
BABYTZ	babitz
ASTNSRAD	stensrud
JAYARAM	jayaram
SVPRATYK	supratic
DVNATV	donato
KYVNG	cuong
PVGVSYAN	pogosyan
HAFS	hafs
MARTYJN	martijn
KRVG	krug
PLYSKYN	pliskin
SKARP	scarp
BRAVN	brawn
MARV	marv
GADBVRY	gadbury
BALV	balu
SYMS	sims
RVAY	ruey
MVNTANV	montano
AVLD	auld
SAVSAN	sawsan
LYRYKAL	lyrical
ALBAHAH	albahah
ALANGKV	elangco
BVLTAN	bolton
ASKLTVN	skelton
MVTVR	motor
ALFVRD	elford
LYRYKAL	lyrical
ASLVN	sloan
KAYT	kyte
LVSTY	lusty
SYKY	siqi
KYSLV	kislo
BASKY	bosky
RVNDA	ronda
RVHN	rohn
GAYNVR	gaynor
SVNA	suna
KARY	kari
LVMBARDV	lombardo
DVRA	dora
MARVYN	marwin
RYDA	rida
GADBVRY	gadbury
ALMYNTAGAH	almintaqah
BYSAYV	bissau
VYVLA	viola
RYYD	reed
AYLYS	eyles
ASTANVL	estanol
DYSANTV	desanto
ALRVY	elroy
PYRYZ	perez
ARSKAYN	erskine
MYNA	mina
DANG	dung
PRAKTYKVM	praktikum
GVADA	gouda
TANG	tong
KYBV	kibo
RVNGV	rongo
MATSVDA	matsuda
DYVNYDA	dionida
ALKSY	alexy
KRANSVYYK	cranswick
MVNTAGV	montagu
GAVYND	govind
BRYND	brind
NVRA	nuri
GRAF	graf
ASLVN	sloan
PAKS	paks
GAYDA	gayda
HVRST	horst
KARPLAS	karplus
KARHART	carhart
DRYDJY	dridge
KYVMR	kumar
MAYTAG	maytag
DAYK	dike
DADGYVN	dudgeon
KARLYN	carlin
ZYTV	zito
KYNGSFVRD	kingsford
HYRAY	hirai
HAMPTVN	hampton
JANSKY	jansky
RVGVZA	rogoza
HYVM	hume
DVSTY	dusty
ADGYNGTVN	edgington
FAYRVZ	fairuz
GRANDASTRVM	grundstroem
PASYFYK	pacific
VYSAL	wisal
DAL	dal
ALDZ	olds
SAYRY	sayre
LASK	lusk
HAYZ	hise
DAV	dov
HVRVVYTZ	horowitz
ZYL	zyl
ASTRYNJR	stringer
KRVM	crom
ASPATSVVD	spotswood
KLVTH	klute
SASKA	suska
DVHA	duha
ABRAMSVN	abramson
ZVLD	zold
AYSAKS	isaacs
ASFAR	sphar
KRVM	crom
ZALAN	zalan
PYNDAR	pindar
DARYL	daryl
MATA	mata
BAYRN	byrne
TVMYTYVS	tomatius
ASKP	skep
DRAM	drum
ALSAP	alsop
LYVYNGSTVN	livingston
HARPVLD	harpold
DADGYVN	dudgeon
DVARTH	duarte
LAPASV	lapaso
BLKSVM	bloxom
AMBAR	embar
FAVST	foust
TRYSY	tracy
MYLVS	milos
DYVAR	dewar
LAYND	linde
NYVARK	newark
DRAMATYS	dramatis
MVTYSV	mutiso
MARYKANDV	maricondo
FAVZY	fawzi
SLYM	slim
GRVYN	gruen
ALFVRD	alford
KASTY	casti
ARAN	eran
AVRCARD	orchard
ASKRYBLYNG	scribbling
VYGJYN	wiggin
LVSANTVS	losantos
VYLMVT	wilmot
ASMYLY	smyley
GARMZ	garms
NADYG	nadig
GAPTA	gupta
VYVKS	vieux
DAV	dow
ADKYNZ	adkins
TALBVYZ	talboys
SYRYL	cyril
BAJVA	bajwa
AVT	ott
SVSA	susa
ASPVTYS	seputis
LAV	lau
BVLVS	bulus
SYRAFYN	serafin
KYMVRA	kimura
ASKLTVN	skelton
PYVTR	piotr
RYHANA	rihana
HARRYG	harrig
GRYT	grit
YANSVN	yanson
KYD	kid
HAV	hau
GRVHVL	grohol
GRYSVALD	griswald
FLARDYNGA	flardinga
SANTJY	santje
RAVT	rout
RAVT	rout
BRAVV	bravo
AYNANA	inanna
NAV	nau
MARY	mury
VVJAK	vojak
MVNAZ	munoz
MARAT	marat
DYVAN	dewan
DYK	dik
DVAN	duan
BAP	bop
MYLVARD	milward
LAHYJ	lahij
PARKZ	parks
BRATYNA	bratina
ASLAVK	slawek
BRAVN	brawn
DYMA	dima
BRYTV	brito
PAVV	pouw
KVLYHA	koliha
VAYGL	wigle
ADRY	adri
BRAYSLAV	berislav
ANATVLY	anatoly
SYTYA	cetia
MYLKY	milky
AZANA	ozuna
ALVYN	alwin
RADHA	radha
ASYF	asif
TAMAY	tamai
LYANG	liang
AYRARDY	ierardi
AMARA	amara
ANV	anu
ANPYNGKV	unpingco
SAVLZ	sauls
DRAM	drum
ABAD	abad
ASTYNBRG	stenberg
ATYYA	atiya
ALSVP	alsop
KVSTYS	kostis
RALF	ralf
HVDAYDAH	hudaydah
JAYARAM	jayaram
AFA	afa
HAYN	hain
MVRAS	moras
SYPRYANV	sipriano
PVYSL	poisl
BANKRVFT	bancroft
PYYK	peak
MVNKS	monks
KAMALA	kamala
MAV	maw
MYLT	milt
MARYANA	mariano
HYVNGAN	hiongun
RAN	ron
BAYDA	bayda
KYAT	kiat
HALPYN	halpin
MYNGV	mingo
SANTSBRN	sansburn
TVNAR	tonar
BAJYK	bajic
BYNVD	binod
DYK	dik
SANANDV	sunando
SAYKS	sikes
PRAPYS	prupis
KRYST	crest
SVART	swart
MATLV	mutlu
KARLYN	carlin
MVRYTA	morita
KVYALSKY	kowalski
PAL	pal
ALSVP	alsop
ARMAND	ormond
BVNYN	bonin
ANTRVSYV	antrosio
PYRYZ	perez
KVRP	korp
PARTVN	parton
HYNSVN	hinson
KVBLA	kubla
BABV	babu
SANYL	sunil
KYPLYNG	kipling
MABANAG	mabanag
BAVKVS	baukus
AVSYZ	oseas
FVNYVK	foniok
MVNAKV	monaco
DYVYDSVN	davidson
DVNG	dong
TAFTZ	tufts
GVDYVYN	godewyn
MVYNYHAN	moynihan
KYTAMVRA	kitamura
MKDVNALD	mcdonald
ASLVN	sloan
ANDRYAS	andreas
BLKSVM	bloxom
MAY	mai
KVANG	kwang
HASAKAH	hasakah
ALKSY	alexy
SYN	sin
BAVM	baum
LAVYGNH	lavigne
BARD	bard
AVAN	awan
BYG	big
FRAYDMAN	friedman
ABYL	abel
D'A	dua
BALV	balu
VARDY	vardi
TVVYS	twiss
DYNY	dini
SVHA	suha
DVRAN	doron
ASTARBAK	starbuck
PVHAN	puhan
ARNVLD	arnold
AYVNS	evens
JYVRDANV	giordano
BRYYTVN	britton
KVRP	korp
MARYANA	mariano
AYLYS	eyles
AYVA	iowa
DYL	dil
PYNYAN	pinyan
DVBYNYN	dubinin
BLANSDAN	blunsdon
JVAY	juay
APSTVN	upston
HARDYSVN	hardison
MYRTY	mirti
ANRYKV	enrico
SVHM	sohm
MANV	muno
DAHAK	dahuk
LYDAL	lidal
RVSANA	rosana
MKMAHVN	mcmahon
MAY	mai
RAMY	rami
TVRKV	turco
BARKVS	barcus
PVGA	puga
BYSYN	basin
AJAY	ajay
BAT	bat
HVRVAT	horvat
ASTRYNJR	stringer
GVRYS	goris
GVANG	guang
SVDYPTV	sudipto
GVRVSAMY	gurusamy
LVM	lum
MYNARYK	minarik
BYTZ	bitz
RVBVZ	roboz
DANSY	dancy
ARPYN	arpin
BRYTVN	breton
LAMYKYN	lamykin
JYMZ	gems
HANSVN	hanson
LAYKZ	likes
BAJVA	bajwa
BARTVLYNY	bartolini
ANYJMA	enigma
VYNTJY	wyntje
HALVB	holub
ASPANGLR	spangler
MARGVLYN	margolin
GVYDV	guido
KVN	kon
BVSA	busa
JVAY	juay
ASLYNY	slaney
LYA	lea
ASTYVZ	steves
VYLKYNSVN	wilkinson
AVADYA	awadia
RVSTAD	rostad
YARLA	iarla
RYDKVYST	rydquist
ALSVN	olson
HAJ	haj
AYVGNH	eugene
VAYA	vaya
APVNTH	aponte
BVDA	buda
ASKP	skep
LAS	las
ABHAY	abhay
AFAF	afaf
AMYT	amit
FYN	fin
DAHAK	dahuk
GRAV	grov
PRAHL	prahl
MYLYND	milind
KALYLA	kalila
PYRARD	pirard
ZYGMVNT	zygmunt
DANHAM	dunham
HAJYR	hagir
BAVA	bawa
NAKAGAKY	nakagaki
SAYP	sipe
AVMGA	omega
GATLYN	gatlin
DYSMVND	desmond
ALAHDVD	alhudud
LANG	long
MAYZ	mize
VANG	vang
KANYTZ	cunitz
AYNGMAR	ingemar
SYMYN	simin
KVYNT	quint
TYPAL	tipul
'LYA	alya
MARGARYTA	margretha
SYNKLAYR	sinclair
SAKARY	sakari
DVALYBAY	dowaliby
AVLD	auld
KALYARV	caliaro
VANSY	vance
GRYST	grist
HAGA	haga
ASKVLY	scully
MARV	marv
HYND	hind
'LY	ali
LAMBRVS	lambros
HARTAH	hurtah
BAYDA	bayda
BAJVA	bajwa
PVZYVS	posius
MARVYN	marvin
KAMALA	kamala
MARTYNZ	martins
HVDSVN	hodson
BRANT	brunt
TAM	tom
DYVAYN	divine
JVLY	joly
HANKH	hanke
ABRYNY	ibrini
KVSTANZA	costanza
PVMA	puma
NYHALANY	nihalani
ANDR	andr
TVRKV	turco
DYRKS	dirks
MYTRVVYK	mitrovic
TVNAR	tonar
MYNAMV	minamo
BYKVN	bacon
RADV	radu
KAPRAL	kapral
KARMVDY	carmody
DARVN	doron
DVMYNYK	dominic
PARTVN	parton
RVTABAGA	rutabaga
ALFVRD	alford
KLARK	clark
KNVFYNKH	knufinke
MYTV	mito
JASTYN	gustin
TYNA	tina
PANYKV	panico
KLBAY	kilby
NAYMAH	naimah
SKARP	scarp
AVRAM	avram
ASTAR	starr
ASPLYNTR	splinter
KALHYNH	culhane
MAYK	mike
AVZBRN	osburn
NYGRA	nigra
BRAM	bram
TVMATYVS	tomatius
DAS	das
SAP	sup
MARKVYZA	marqueza
GVYL	goel
MVRAS	moras
MARYTJY	maritje
