TRAFTVN	trafton
FAYRBANK	fairbank
KASTRV	castro
ZAKY	zaki
LVRTVN	lorton
ALMVDYVAR	almudevar
DVRYS	doris
BARY	bari
ASTYRNZ	stearns
FVRLANG	furlong
TAKA	taka
MVRTAN	morton
DAYVVN	dauwen
JYRMASKA	germuska
FVY	fui
DAKV	daco
SYSK	sisk
MAY	may
VYVYANH	viviane
DRAP	drop
SANTSBRN	sansburn
VANSY	vance
SYRYL	cyril
AYRYK	eirik
LVRY	lori
KARL	carl
GAMAL	gamal
AYVSV	ayuso
PASYFYK	pacific
DYL	dil
TVMANY	tomany
KVYYNLN	quinlan
VAST	vost
MARTZ	martz
KVDY	cody
JASTAS	justus
GNVSYS	gnosis
AYSKANDR	iskander
BARTVN	barton
MARKVS	marcus
KAY	kai
ASTYSY	stacey
YANSVN	yanson
VYDY	vidi
HART	hurt
GRAYYV	grieve
SANVNDV	sunondo
DAK	duk
GVYN	gwin
LYKYVRY	liquori
ASPYR	speer
DYNA	dina
ASTFANV	stefano
MAYR	myer
AVSYVN	oseven
BABA	baba
ZVRYSYKA	jurisica
HARBVR	harbor
ANTRYKYN	entrikin
GRYST	grist
ASPRVT	sproat
VAYGL	wigle
MARYV	mario
NARV	naro
AYVJNH	eugene
AVRVM	avrum
PALFVRD	pulford
LYVNVRA	leonora
FLYMYNG	fleming
DYMYTRY	dimitri
JVNYN	jonin
ANSKAMB	anscomb
TRAVN	trown
DYMYTRYS	dimitris
LAYVLY	lively
VYLKYNSVN	wilkinson
LYDVR	lidor
ADYH	adie
MANGLANY	manglani
TRVYYJH	truitje
KAPRAL	kapral
ANTRAPY	entropy
ANTVNYS	antonis
GADFRVYD	godfroid
MVNAGAN	monagan
SAMVSKY	samosky
ASTANGYR	stangier
NAHAM	nahum
AKLVF	eklof
FADL	fadl
KVYYMAN	coeyman
MARLYN	marlin
RVSV	rosu
KASANVVA	casanova
AYTJY	oetje
ASKVLYNG	scowling
ASVALAP	aswalap
JVHANSVN	johansen
LASNYK	lasnik
GVYYLYM	gwillim
DRAYNH	draine
MARTYNZ	martens
GVRASPY	gorospe
DANKAN	duncan
JANSJH	jansje
VYJNAND	wijnand
HARMANVS	harmanus
ATVL	atul
AVYNG	ewing
AYS	ace
AMYR	amir
FVRSAYT	forsyth
DYANA	diana
HARRYG	harrig
HASYK	husik
BRANDY	brandi
VYKTVR	victor
ANVS	enos
LANKTVN	lankton
AMADVR	amador
LAMARK	lamark
FRYTZYVS	fritzius
DAVSAN	dawson
HALVB	holub
YVNAL	uenal
ARLYNDH	arlidge
KYNGSTVN	kingston
JAVYKA	jovica
ALVYN	alwyn
NAN	nan
JVNYVR	junior
HVLRVYD	holroyd
AVFYNGTVN	uffington
NAKASVRA	nakasora
MARTYJNTJH	martijntje
ASTRYNJR	stringer
AVRFYVS	orpheus
KARAN	karan
ASLVMN	sloman
NYKALAS	nicolas
AYRD	aird
BARBVRAK	barborak
ASMYTZ	smiths
TVNGA	tunga
ASPYRZ	spears
AVYAN	avian
MANDAL	mandal
BYLHAR	bilhar
BAYARD	bayard
LANDYN	landin
BVNVMV	bonomo
KRANSVYYK	cranswick
DADH	dade
KYLBY	kilby
SYR	cyr
HALPYN	halpin
BRVANHAT	braunhut
DVRHAM	durham
FAGAN	fagan
ALTAYR	altair
AKLAND	eklund
FRYTS	frits
BVZVVA	bozuwa
AVLSVN	olsson
ARYKA	erica
KADRYBYSYK	kadribasic
KVDAMAH	qudamah
KVDVGNV	codogno
TYMKV	timko
GVSTAV	gustav
FRAMSVN	framson
KAYT	kyte
GRANDASTRVM	grundstroem
PRAHL	prahl
LANY	lani
LASNYK	lasnik
ZARA	zara
AVVLYV	avolio
RYVNVLD	reinoud
ASTAKS	stocks
BRVZ	broz
HALTVN	holton
TVSYNG	tusing
ABYNA	ebina
'ALY	aali
ZALAN	zalan
LVK	luk
BAVDYN	baudin
LAYN	lynn
SANTYK	santic
AVYNZ	ewins
SAMANTA	sumanta
HAVDVN	hawdon
RVTABAGA	rutabaga
NAVAS	navas
VAYN	vine
LAND	lund
JASTYN	gustin
RVSANA	rosana
SYR	cyr
GVAN	guan
DABAS	dubuc
ASKVYVYL	esquivel
KAMPYVTR	computer
BAN	bon
'LYA	alia
VASYT	wasit
NYDH	nida
TALMY	talmy
GASTAVVS	gustavus
DYMYTRYV	demetrio
SVZY	suzy
MVZYNA	mozina
ARSKAYN	erskine
KRAYDR	crider
AVZMN	ozmen
ASTYL	still
ALKSY	alexy
SYKY	siqi
DAVSVN	dawson
GRAV	grov
ADAB	adab
KAPYLA	kapila
ARBYL	arbil
GAS	gus
MYTRVVYK	mitrovic
KLVB	club
ASMYTSVN	smithson
KLAG	klug
ARFANAKYS	orfanakis
GYL	gil
PVPAT	popat
ASKVLYNG	scowling
RVBYN	rubin
SANRANG	sunrong
PYRAMYD	pyramid
BVDLA	bodla
LYNKVLN	lincoln
ASYF	asif
AVN	aun
KAYN	kain
LARA	lara
HYTSVN	hitson
TAYMN	tymen
LYNKVYS	linkous
GVRASPY	gorospe
JVHANSVN	johansen
AZANA	ozuna
MANTVR	mantor
ASTV	stew
HAMPTVN	hampton
TVSYNG	tusing
JVNYN	jonin
TAPYK	topic
ZARVS	xaros
HVRYV	horio
KRVB	krob
LVMBARDV	lombardo
DAMYNYKAS	dominicus
LVYD	loyd
MADYS	madis
VAYL	vail
GRAYYV	grieve
AYZAK	isacq
YARVS	yaros
BRAYR	brier
ATKYNZ	atkins
MALVNY	malone
HARMAN	harman
DVSKV	dusko
MARKVYZA	marqueza
LVRTVN	lorton
PYSTVN	pistun
FYGVRA	figura
FRYNK	frink
TAYTY	tytie
GRAYSLDYZ	griseldis
SANTSBRN	sansburn
ABRAMSVN	abramson
GABARA	gabara
'QYLA	aqila
GYZAV	gizaw
RAM	ram
AYR	air
SYTRAH	sitrah
VVLTRNYNG	woltering
MVRYTA	morita
RVYMATA	roimata
ANTRAPY	entropy
BYFRAST	bifrost
DYMYTRYS	dimitris
FYNK	fink
DVALYBAY	dowaliby
ATRAM	atram
KVRL	corl
AKYL	akil
BYLYNGASLAY	billingsley
KVDY	cody
SYRYL	cyril
RVHM	rohm
RASV	raso
HAV	hao
AMARA	amara
LAZARD	lazard
SVRANA	surana
ANTANAYTYS	antanaitis
KRYST	crest
AKY	aki
FAVST	foust
KVA	kwa
GVPALAN	gopalan
AHLAND	ohlund
DVRFMAN	dorfman
MKMAHAN	mcmahan
KATVPYS	katopis
LABKYN	lubkin
RABKYN	rabkin
KARMVDY	carmody
PABLV	pablo
GRYKV	greco
LADVVYKVS	ludovicus
GVANG	guang
SVLAR	solar
BRVKAV	brokaw
RASV	rasu
MVRTAN	morton
TALBVYZ	talboys
GVRVYTZ	gorwitz
BYFRAST	bifrost
AKYHYKV	akihiko
KVYL	coil
PVNA	puna
RADRAMVNY	rudramuni
MYZYRA	mizera
ANZALVNY	anzalone
DVRAND	durand
RADV	radu
MARKVPVLY	marcopoli
ZALAN	zalan
ASMA	asma
GAT	gat
FRANKVYS	francoys
RVBVZ	roboz
BASYLYSK	basilisk
ANBV	anbu
KYN	kin
MAYRZ	myers
DAMYNYKAS	dominicus
BAV	bao
SAKARY	sakari
ADRYS	idris
MARK	marc
GARYTV	garito
LASNYK	lasnik
VYNDVM	windom
MADYSVN	madison
DRVDYS	drudis
DVRFMAN	dorfman
AMARDYV	amardeo
SYLVAN	sylvan
HAV	hau
LVYYSALY	loiselle
GANZAK	ganzak
BAKSKA	bocska
MADYS	madis
PAM	pam
MANTVR	mantor
JAST	jost
SYRVS	cyrus
PYVRYNTN	purinton
ADNAMZ	adnams
RAST	rust
FYRMA	firma
VYRYANA	wiryana
GVADA	gouda
GRAV	grov
HALVB	holub
VYLDKAT	wildcat
PARSVNZ	parsons
GANYSAN	ganesan
BVLDVYJN	boldwijn
YAMYNAH	yaminah
HAMYLTVN	hamilton
TANTVN	tanton
KASVN	kasun
LYTVYN	litvin
JANG	jong
BAGDAN	bogdon
ASTYVNSVN	stevenson
TVSKANV	toscano
BRYTV	brito
ANV	eno
PARMAR	parmar
SVKVMAR	sukumar
MYNYARD	minyard
VYLHAYT	wilhite
VANG	vang
PLATFVRM	platform
MYNTVN	minton
KALHYNH	culhane
KRAYJ	craig
KVYL	quel
AYMAN	aiman
HVLM	holm
BAKVS	bakos
BRAY	brie
JYZAN	jizan
MYLVT	milut
JVNYVR	junior
ASKVLY	scully
AYSPVRT	iceport
VYNTJY	wyntje
FLARDYNGA	flardinga
PVSV	poso
BABYTZ	babitz
GRAV	grov
LADYK	ladic
FVNDV	fondo
JVNYVR	junior
KYLBY	kilby
KAPSVN	kapson
ASPYRZ	spears
ASTYRNZ	stearns
SAND	sand
SAYRY	sayre
DVRYS	doris
MAY	may
MVD	mod
LVYYNG	luinge
JYA	jia
VANSY	vance
LAYHV	laiho
GVANYAV	guanyao
KVSTA	kosta
AMPSVN	empson
PARHAM	parham
'QYLA	aqila
SAHASY	sahasi
BVDV	bodo
MVNTAGV	montagu
MANDA	manda
DYTVTALA	ditutala
NAVAS	navas
KYALASA	kailasa
MANVLY	manoli
LVPATKYN	lupatkin
BVYRKVYL	boerkoel
ASPYRZ	spiers
ANAND	anand
PARKYN	parkin
MAYK	mike
KARL	carl
ARMSTRANG	armstrong
AMNA	amna
RABKYN	rabkin
ASPVTYS	seputis
BVSTRVM	bostrom
HARVARD	harvard
PYNKY	pinky
KVTRVNYV	cotroneo
ALVYS	alwis
TYRZA	tirza
RYYAD	riyad
'ADL	adel
AYZMN	isman
HVGARTY	hogarty
RADV	radu
RAST	rust
GAY	guy
DVALYBAY	dowaliby
FRANSYSYVS	frnaciscus
MADYSVN	madison
ALYN	olin
LYVNVRA	leonora
ARFANAKYS	orfanakis
ANANDA	ananda
RASV	raso
ANVPAM	anupam
DATRY	datri
KAVS	kaos
HYDAJAT	hidajat
TVKYV	tokyo
PADVLA	padula
TAMAY	tamai
MYLVT	milut
ZVVAYTA	zuvieta
MARKVS	marcos
JANG	jong
ALTMAN	altman
SYANV	siano
MANGAN	mangan
DYVYS	divis
ASTAD	stude
ASPYRZ	spiers
SVNG	sung
GABVR	gabor
KYTAMVRA	kitamura
KVSTA	costa
RVSTAD	rostad
LYSVN	lison
