KRYSTYJNTJH	kristijntje
JYZAN	jizan
AMYRA	amira
BLAL	blal
DRVDYS	drudis
KAVDLYNG	quodling
HVGARTY	hogarty
SVHAS	suhas
JARVYS	jarvis
KLAYTVN	clayton
TAFTZ	tufts
ALYZA	alisa
ATA	ota
GVRALP	guralp
LAYNG	laing
AYNGLS	ingles
HARMZ	harms
PYZYALY	piziali
ALMV	elmo
AYNGLD	ingold
HYTSVN	hitson
PYLVYV	pilvio
SVAMY	swamy
MYMY	mime
KVLYN	colin
ABYAD	abiad
KYVNG	cuong
ADAB	adab
KVTLA	kotla
KRYYK	creek
ALSAP	alsop
LVNAV	lunau
YVFYNGTVN	uffington
NYLS	nils
GARBH	garbe
VARGAS	vargas
VYLKAS	wilcox
KYRK	kirk
KVYYT	quitt
PRAYVYT	private
JVZYH	josie
BANKRAFT	bancroft
TVBYAS	tobias
PVRVS	proos
AYGV	igoe
LABYN	lubin
MANJYT	manjit
BVLTAN	bolton
GVRDYN	gordin
ALYMA	ulima
BARTHVLVMYVS	bartholomeus
RAN	ron
NAHAM	nahum
AKVNA	acuna
KRASBY	crosby
BVSTRVM	bostrom
TVYT	toit
BAGDAN	bogdon
DVHH	duha
BARKRAFT	barcroft
ASTARTLD	startled
ASKYN	skene
GRYGVR	gregor
NAYLZ	niles
JANA	jana
BVDAR	budur
ARNVT	arnot
AYNGLF	ingolf
BALTAYS	baltais
AKLVF	eklof
NVDYNG	nuding
DAMYANV	damiano
JVLY	joly
BARNARD	barnard
ANAYLYN	anilane
LYND	lind
NABYL	nabil
LYVYS	lewis
AYLVT	eliot
LASKALA	lascala
NAVAR	nawar
DANSY	dancy
DAK	duc
RAKYKVT	racicot
SYMS	sims
PRAYM	prime
BARBVRAK	barborak
DART	dart
ALVYN	alvin
PAYNTVN	paynton
AKVNA	acuna
ASTYP	steep
ZAFYNA	zafina
LYNDRVTS	lindroth
GRYSVALD	griswald
GYRARD	girard
JARBVT	jarbot
SAMANTA	sumanth
LYNDVN	lyndon
AYSPVRT	iceport
MARKVPVLY	marcopoli
DYAB	diab
GRYTZ	gritz
LYZARDZ	lizards
KARASV	karasu
ALFANSV	alfonso
ZYTV	zito
HYVKYNZ	hawkins
SAFT	soft
KATRYN	katrin
KVRKAM	corkum
MARTY	marti
TVBYAS	tobias
KARMVNA	carmona
DVRAPT	durupt
GVNNA	gonna
AKYLAH	akilah
AMYVT	amyot
KYNT	kint
VYLKAS	wilcox
MARKV	marco
PRADV	prado
MASATV	masato
AGVYV	agoyo
NVTZ	notz
PAYNH	payne
SYHSVBHVN	sihsobhon
ARAYZ	aries
AMPSVN	empson
BAVDVYYN	baudouin
KYNA	kina
LANDYS	landis
MYNKY	minqi
BARLAS	barlas
ANTAL	antal
ADNAMS	adnams
PAL	pal
MATAKV	matako
ALYA	alya
GADBVRY	gadbury
VYKRAM	vikram
AYNGRYSVL	ingresole
ASTYPLZ	staples
AYRL	earl
FANGVS	fungus
AVRAYZ	averis
TVRKV	turco
SVLYTAS	sotilas
VYVLA	viola
MARKSN	marxen
ALVAN	alwan
TAMY	tomi
KYBV	kibo
BLAM	blum
MANV	manu
ALKAN	elkan
KARDAL	kardal
ASLYV	slave
LAPVTA	laputa
VYJBRAND	wijbrand
MAYR	myer
KYVNG	keong
MATANA	matana
KRVK	krok
NAYA	nina
MVNTANARV	montanaro
LAHYJ	lahij
LABKYN	lubkin
BRAYS	brice
TVYYG	twigg
MVRNYNG	morning
LVYYZV	loizzo
PRYSTVN	preston
GYLYTA	geleta
BAP	bop
AKYL	akil
SAVYR	sauer
BAPTYST	baptist
PARTVS	partos
KAMDAR	kamdar
AYSPVRT	iceport
HASAKAH	hasakah
DYVYLDH	dewilde
DAG	dug
KVRAM	coram
FLYMYNG	fleming
VASYT	wasit
ANDRYVZ	andrews
LABKYN	lubkin
ALMAS	almas
SYTRAH	sitrah
JVHANSVN	johansen
LABRYVLA	labriola
MASATV	masato
AMLAK	amlak
YVBYRA	ubiera
AARVN	aaron
DYMYTRYS	dimitris
ASTANGYR	stangier
LVSYTV	losito
GVDATA	gudata
HARMAN	harman
DVRVYN	dorwin
DJAMYLA	djamila
TAYLBRY	tilbury
AMYR	emyr
BYRNH	byrne
KASTANV	castano
AMVS	amos
TRVMBV	trumbo
MVTVRZ	motors
RAMA	rama
MYNA	mina
BAT	bat
'RBYL	arbil
SABHANY	subhani
MVK	mok
KALYSYAK	kalisiak
KVNV	kono
TYMVNYN	timonin
RABVYL	raboel
KRYSJH	krisje
ABVDHABY	abudhabi
MATSVDA	matsuda
GYLRVY	gilroy
HAMARKVYYST	hammarquist
AVSYZ	oseas
TANTVN	tanton
LAVD	loud
HAYVL	houle
LADVYG	ladwig
AMBRVSYVS	ambrosius
GYL	gil
DALYNAR	dolinar
HADVBA	hudoba
DAKV	daco
ALYASVN	eliason
LVSYH	lucie
PANDZ	ponds
FVRJY	forgy
SALVMVN	solomon
ASTYSY	stacey
GVRGANZ	gorgons
HAVN	hawn
PRATVL	pratul
HVYTYNK	hoitink
PVALMA	puelma
KVNVPKA	konopka
HRABY	hrabi
TAMAY	tamai
ADVVART	eduwart
AYRAY	airay
MATAKV	matako
TRYVYTZ	truitje
PRAKTYKVM	praktikum
HALAT	halat
BALMA	balma
PANYKV	panico
MAVPYN	maupin
ANJLYSYA	anglesea
VADAPARTY	vadaparty
MASKYAS	mascias
NYKALAS	nicolas
HAYBZ	hibbs
KANBVY	conboy
KANG	kong
MVSY	musa
AVRAHAM	avraham
TYTMAS	titmus
PADVA	padua
VYJNAND	wijnand
SYNA	cena
ADVARD	edward
DYVAYN	divine
LYAM	liam
GAJNH	gagne
MKGAVYN	mcgavin
KVRVYN	corwin
KAMBYY	combee
LVRY	lory
ASTAG	stagg
LAYNG	laing
HYLSVN	hilson
BADZYAK	budziak
LYNKVLN	lincoln
ALFVRD	alford
SRAYNH	shryne
MARTYN	martyn
GVRVYTZ	gorwitz
LYNDAL	lindal
ADARA	edara
MYRTY	mirti
ASTAG	stagg
MYLV	milo
PAM	pam
PYNYAN	pinyan
DATSVN	dotson
VYVKS	vieux
AVGYNH	eugene
FRANSYSKAS	frnaciscus
ARKTYKY	arktiki
LAMBDA	lambda
BVDA	buda
KAMPVS	campos
SAVSAN	sawsan
FATYS	fotis
TAYTY	tytie
HVGARTY	hogarty
PARHAM	parham
AVRVM	avrum
ARYA	arya
FRANKV	franko
SYNKLARY	sinclair
ASLAN	slone
GVLAND	goland
ARMATV	armato
AKYL	aqil
NAHAM	nahum
AYRLAYNZ	airlines
TVSV	tuso
LVM	lum
BRYVNY	bryony
AYNGRYSVL	ingresole
SASKA	suska
LAL	lal
ASRAT	israt
AYNTLSAT	intelsat
ASTNKAMB	stancomb
ASTAG	stagg
ARFVRD	orford
BYRA	byra
SAKS	saxe
SANG	sang
LVYYSALY	loiselle
GRAYYNGR	grainger
SVZY	suzy
NYDH	nida
NVDA	noda
SYDVR	sidor
NAYMAH	naimah
BYK	bik
SAVLZ	sauls
MYLAM	milam
RASV	raso
AKYN	akin
HABA	haba
VYDAL	vidal
SANJAY	sanjay
FALTAK	foltak
NANDVANY	nandwani
PVTZ	putz
RADRAMVNY	rudramuni
SVRYN	sorin
MAVBY	mawby
VAYL	vail
TAYLV	thilo
DAK	duc
VALVR	valur
GRAV	graw
KADRYBYSYK	kadribasic
AVDVN	audun
BARK	bark
DVNALD	donald
ALVKAL	alukal
KVYL	quel
FVJYTA	fujita
PAKALA	pakala
TYMYAN	timian
FLAT	flat
YAYN	iain
ASTRVSTRAP	stroustrup
DVBYNSVN	dobinson
FALTVN	fulton
JANG	jang
MATLV	mutlu
ANAZ	anas
TVNY	tony
BYVDVYN	bauduyn
RAVDA	radwa
LVM	lum
PVRANYK	puranik
AVBRTAS	obertas
HARMAN	harman
KVARTZYTH	quartzite
TAYLBRY	tilbury
AYRD	aird
VYLMVT	wilmot
PVH	poh
RABKYN	rabkin
YAMHA	yamha
YVFYNGTVN	uffington
LAYL	lyle
MANKA	manca
MARYA	maria
VYNZ	winz
ANATVLY	anatoly
MVNAGAN	monagan
MVHAN	mohan
MVRTAN	morton
YANSVN	yanson
AKLAND	eklund
KVLASA	kolasa
KARASV	karasu
KVRDYK	kordic
SAND	sand
HADVBA	hudoba
KVAAYNTN	quainton
PVRYNTVN	purinton
GVRYK	gorik
LYVNARDV	leonardo
'AYMN	ayman
DAMYANV	damiano
LYDVR	lidor
SYKARV	sekora
GRYLK	grilk
TRAYNTH	tryntje
RABYN	rubin
RYVPKA	riopka
ZARYH	zaria
LYVNZ	lions
LASTRY	lustri
AVLY	olli
LASKA	laska
RADHYKA	radhika
LAZARA	lazara
PAL	pal
AYRARDY	ierardi
PAYPR	piper
TAPYK	topic
FRYNK	frink
GALY	gali
FRANSYSKAS	frnaciscus
'FYF	afif
NAPTVN	napton
ASTANVL	estanol
TYN	tin
BRABANT	brabant
AYRARDY	ierardi
GYVVN	givon
ATKYNZ	etkins
AYRYZARY	irizarry
GADYL	gadil
ASTYGBRG	stigberg
LYZARD	lizard
MKRAYH	macrae
BRVZ	broz
RAKVN	rukan
AYRVN	aaron
KARN	karn
RAMY	rami
FVLKANYS	fulconis
BARBAS	barbas
DYMA	dema
KLAGSTVN	clugston
DRYNKS	drinks
TRVYYJH	truitje
MAYRYK	myrick
GASTAVVS	gustavus
DVDAMANY	dodamani
MAYR	myer
SYTARAM	sitaram
LABKYN	lubkin
MAY	may
ANDRA	andra
PAVLYK	pavlik
PVRTNVY	portnoy
JAGV	jago
GYLPYN	gilpin
BYSAYV	bissau
ASTANVL	estanol
ZYL	zyl
KAPYLA	kapila
HASAKAH	hasakah
DANYDYN	dunedin
KARBALA	karbala
LANGDVN	langdon
HANKH	hanke
NYKVLYK	nikolic
MARAT	marat
TARYK	tariq
AYRVN	aaron
SVDAN	sudan
RYBAR	ribar
MYKVLYK	mikolic
SABRAMANYAM	subramaniam
BARVN	baron
SANTV	santo
ASKVLYNG	scowling
ALYVA	oliva
KAM	kam
AYNGRM	ingram
ARVNAH	arunah
ALANGKV	elangco
MATAKV	matako
ANZALVNY	anzalone
AYSAN	eason
ASPR	spur
SYKARV	sekora
PALYDV	pulido
AFAF	afaf
