ARDYS	ardis
ANVJYT	anujit
AMBRVSYVS	ambrosius
RVSTAD	rostad
MARGVLYVKS	margulieux
ARAYZ	aries
DYVYLDH	dewilde
PAKALA	pakala
HASYK	husik
PVLK	polk
KVHN	cohn
MANDAL	mandal
AYNTLSAT	intelsat
ALYSVN	elison
TYSZA	tisza
ZAKY	zaki
KYNSVN	kinson
BVDV	bodo
ASTVN	stoun
HYTSVN	hitson
DVZYYR	dozier
HAYZ	hise
PRYTZ	pritz
KVANLAN	quinlan
ZVRYSYKA	jurisica
AYNANA	inanna
DRAM	drum
TAHRYHA	tahirah
AYVJNH	eugene
AYRAY	airay
MAVPYN	maupin
GRAYYV	grieve
YAMHA	yamha
AVRV	orue
LANA	lana
KVMVRV	kumoro
FRNASYSKAZ	frnaciscus
TAT	tat
BRVKAV	brokaw
BLASYVS	blasius
MVN	mun
KARASV	karasu
KARL	karl
ADMYSTVN	edmiston
SKSTVN	sexton
DVAN	duan
NYDH	nida
LYMN	lymn
HAVK	howk
ALVYN	alvin
BLAHA	blaha
LAY	lye
TYPAL	tipul
DYL	dil
ALVYS	alwis
MVBAY	mawby
MAV	mao
ASTYT	stith
AYNA	inna
RANA	rana
RAVYRAJ	raviraj
ASLAN	sloan
BLVZVM	bloxom
VVLTRNYNG	woltering
KRAVFVRD	crawford
AYVTYK	ivetic
FRAMSVN	framson
RVHAN	rohan
KALB	kalb
MANV	muno
LVRA	lora
VYLJV	viljo
TVSV	tuso
AMYRA	amira
TAKA	taka
FLYMYNG	fleming
BANKRVFT	bancroft
LAMBARD	lombard
LAMBDA	lambda
DAS	das
MARYNV	marino
SANRANG	sunrong
MAVN	maun
PVKVRNY	pokorny
ZARYH	zaria
MASKARY	mascari
BRAM	bram
AYNGL	ingle
RATKS	rutks
GVYN	gwin
ANTRAPY	entropy
MVNTANARV	montanaro
JAGARD	jagard
DYLAN	dilan
ALMAR	elmar
ASKLVYR	sklower
RYSLYNG	rysling
RAHVL	rahul
JAYAN	jayan
ANSKAMB	anscomb
BRAHYM	brahim
MVRALT	muralt
YAMYNAH	yaminah
AMAL	amal
ASKAL	scull
LYANG	liang
LYNDAN	lyndon
AYVTYK	ivetic
KVNYNG	koning
FLYNT	flint
NABYL	nabil
BAYRTYH	baertie
KRASYK	krasic
LYNK	link
BYATLYNG	beutling
RVNY	roni
ASPVSYTV	esposito
PYLVYV	pilvio
RYGAN	ragan
NYMRAD	nimrod
JAYN	jain
BVLDT	boldt
ARKTYKY	arktiki
ALVA	alva
BVLVS	bulus
MKMANYS	mcmanis
LADVVYKVS	ludovicus
PVTYT	petit
KAZY	kazi
SAMAH	samah
ATYNZVN	etinzon
BARBVRAK	barborak
ALFVRD	alford
JASTYN	gustin
GARAFALV	garofalo
PANYKV	panico
RYBAR	ribar
BVDAPATY	bodapati
AYNGLF	ingolf
AKYLA	aqila
YARMAN	yarman
VYRT	wirt
ASKVLYN	scullin
KASTANV	castano
ALMVDYVAR	almudevar
KVSTYS	kostis
LAST	last
JYZAN	jizan
NYTYN	nitin
LAYNG	laing
LYVYV	liviu
GVRYS	goris
HARARY	harari
GRAV	grau
ALYNGTVN	alington
AZANA	ozuna
HAJYR	hagir
KVRTH	korte
ASTV	stew
GASLYNG	gosling
ASTANVL	estanol
LARSVN	larson
MAHA	maha
MVRANDV	morando
KRYSVJYN	krisoijn
AFRA	afra
DANZ	danz
ZALAN	zalan
BVRGA	borge
BABYTZ	babitz
BAYLA	bayla
YAGLA	yagla
TAKSBRY	tuxbury
DAV	dov
LANKART	lonkart
BYNVD	binod
JAMVNA	jamuna
KAMBS	combs
HVRVAT	horvat
HAKABAY	huckaby
KAMB	kamb
AMY	amy
ARBYL	arbil
KLAYSVN	clayson
LYSTVN	liston
SVLY	soli
MANGLANY	manglani
KAYAK	kayak
JAMVNA	jamuna
MADVRAY	madurai
HARDYN	hardin
AYVLYN	evelyn
ANGLASMA	engelsma
KVNVPKA	konopka
S'YDH	saida
GAYNVR	gaynor
SVRYN	sorin
BRYTVN	breton
VANSY	vance
BAYLZ	byles
KARTYK	kartik
TVSYNG	tusing
LYBYD	lebed
ARASMVS	erasmus
AVRV	orue
VYLKYNZ	wilkins
MAK	mak
AYNTJH	eyntje
MARYSH	maryse
BANYTV	bonito
NYKVLYK	nikolic
DVHA	duha
AVTV	otto
ASTRND	strand
ABRAMSVN	abramson
ASMYRNV	smirnov
JAKVMYNTAY	jacomyntie
PRANGS	prongs
VYTAKA	vitaca
MADABA	madaba
RAFALSKY	rafalski
SVSA	susa
KYVNG	cuong
ASTALKH	stolcke
KVASYM	quasim
MYRVT	mirut
JYRMASKA	germuska
GYL	gil
'QYLA	aqila
HVRSFVRD	horsford
ABY	ebe
GRYST	grist
MYTRVVYK	mitrovic
SANTSBRN	sansburn
PVHAR	pohar
GYTLYN	gitlin
AVNAYZ	unaiza
HYKARV	hikaru
BRYVNY	bryony
GVRGANZ	gorgons
KARLKVYST	karlquist
HYTZ	hitz
KYV	kao
ADRYANA	adriana
GVRAV	gorav
SYTJY	sytje
AKYL	akil
BVYRKVYL	boerkoel
HAVDVN	hawdon
DRVR	dror
ALVF	elof
AMARYT	amarit
DAYAN	dione
PYL	pil
MVNK	monk
LYDYA	lydia
MARANY	marani
DAYS	dais
FRANSYSKA	francisca
ALSVP	alsop
BYRNH	byrne
SYMAL	cemal
KVYALSKY	kowalski
AYLVARD	aylward
FADVR	fodor
KRYSJH	krisje
CAYLDZ	childs
YAKVB	yacob
KVASYM	quasim
BALV	balu
HAGA	haga
VYRJYNYA	virginia
VYLKAS	wilcox
ANV	eno
SASTYK	sustik
MARKSN	marxen
BRVKAV	brokaw
TVSV	tuso
LYNDZ	lynds
DVNATV	donato
LAYN	lynn
MYN	min
VYN	vin
LYLA	lila
PATRVKLVS	patroclus
DVNA	dona
ASKRYV	screve
TYV	tio
LYNDZ	lynds
JAYNVR	gainor
HVDSVN	hodson
BYNG	bing
JVHANY	juhani
DYMYTRY	dimitri
LYRYK	lyric
ZVRYSYKA	jurisica
TVMANY	tomany
FVTYNVS	fotinos
KAMBYY	combee
'FAF	afaf
GVRALP	guralp
ZARA	zara
YANG	yang
GRYT	grit
VYLA	vila
RVKAN	rukan
KAVLYNG	cowling
PVHAR	pohar
ASLVN	olson
MAY	may
ASTVRY	storey
ASTYK	astik
DVRYS	doris
GALAHAD	galahad
GLASYYR	glacier
TRAYNTH	tryntje
AYSTMAS	isthmus
MAHA	maha
AYDMN	eidam
SYVA	siva
KVTZ	kutz
RADHYKA	radhika
KVRZAYN	corzine
ADVARD	edvard
GALYLA	galila
DVARTH	duarte
RAMA	rama
RABYV	rubio
TVYDA	toida
VYNTJH	wyntje
ASTNFVRT	stenfort
SANYL	sunil
ASKYN	skean
GADYL	gadil
ATVL	atul
ASTANGYR	stangier
HYDAJAT	hidajat
GARYTV	garito
RAVYRAJ	raviraj
DYTVTALA	ditutala
ANAY	anay
AVVLYV	avolio
BYSAYV	bissau
SYMPLYSYTY	simplicity
AYNANA	inanna
SANZ	sanz
BASTYK	bostic
JANARDHAN	janardhan
GAYA	gaya
DYAMANTARAS	diamantaras
LAN	lan
SANTYK	santic
BYR	bir
LAGVMVRVF	lagomorph
DANLVP	dunlap
NYPTVN	napton
AYNDAYRSN	indiresan
SVKVMAR	sukumar
ZYGMVNT	zygmunt
DYVYD	david
ASKADZ	scudds
BASKY	bosky
ALTMAN	altman
ASTRLYNG	stirling
HYTSVN	hitson
GVYL	goel
PYLVYV	pilvio
'DYL	adil
MVNTYJV	montijo
AVBAJA	obadja
ASTAKS	stocks
SYMVN	simon
RANKYN	ronkin
GVSTAV	gustav
ABAD	abad
HAVK	hawk
JYNG	jing
LANSYNG	lancing
AYNGLD	ingold
BRYVNY	bryony
ASKVLY	scully
BYGV	bigo
DAV	dov
HAFSAH	hafsah
ASKYLS	skiles
KAMAR	kumar
JVHANY	juhani
KAMB	kamb
AMY	ami
VYMAN	wyman
KALAHAN	calahan
TRYVYTZ	truitje
DJAMYLA	djamila
PALVMBV	palumbo
DANY	dani
AYNGLD	ingold
ANTVNY	antony
ARKTYKY	arktiki
KLAVDY	claude
GARYTV	garito
HYVNGAN	hiongun
KRAVN	crown
HARPVLD	harpold
PATRVKLVS	patroclus
MYNGV	mingo
GYVVN	givon
LVK	luk
KVMAR	kumar
KATY	kati
KVRKAM	corkum
KRVPYK	kropik
FLYNT	flint
LYVYS	lewis
TAMAY	tamai
GVAN	guan
BALHAM	balham
RYDKVYST	rydquist
HAYN	hain
SYMVNZ	simons
AVMGA	omega
KAVDLYNG	quodling
GASLYNG	gosling
KASTY	casti
JYRARDYN	gerardin
PARK	park
JALA	jala
KYNYVN	kinyon
BRYND	brind
TVLYV	tulio
MAYRS	myers
AMNVN	amnon
MABAY	mawby
ASTRYTY	steriti
KVAN	kwan
MAY	mai
PRYSTVN	preston
SVMA	soma
ASTANGYR	stangier
DYMYTRYVS	dimitrios
DYYALA	diyala
DAYBALA	dyballa
AMNVN	amnon
PANJABY	punjabi
MATANA	matana
GVRDYN	gordin
RASTYN	rastin
DAYLVN	dillon
MYLNVR	milnor
LANG	long
PRABST	probst
AJAY	ajay
KAVS	kaos
KYTAMVRA	kitamura
ASTVN	stoun
DRYDJY	dridge
BRAVN	brawn
DANYS	danis
AYRAY	airay
BARLAS	barlas
HARALD	harald
AMAL	amal
VALKA	walka
BASMA	basma
MVNS	muns
ASTAFVRD	stafford
ASTAKY	stucki
SYRYLV	cirilo
LALY	laly
ASLYP	sleep
HARKYN	harkin
RYSAVY	rysavy
FYRMA	firma
BRAYS	bryce
LVYYZV	loizzo
HASK	husk
AYDYD	aidid
KVAST	kwast
BALBYR	balbir
DATSVN	dotson
RAFALSKY	rafalski
VYJNAND	wijnand
GABARA	gabara
LYDVYNA	lidwina
LYBYD	lebed
BANKS	banks
HARKYN	harkin
KASTVRY	kasturi
RVYAL	royal
JASTYN	justin
ANPYNGKV	unpingco
HARDYSVN	hardison
'FYF	afif
BVSA	busa
VYLDYNG	wilding
DYN	din
TYRZA	tirza
HVLKAMB	holcomb
SVRANA	surana
ASNYL	snail
DATSVN	dotson
