KASTANV	castano
BLAHA	blaha
ASPVLARYC	spolarich
SALVMVN	solomon
MATSVDA	matsuda
PVHAN	puhan
KVJYAS	kogias
KYLG	kilg
BVYKV	boyko
HARTYGAN	hartigan
ANYJMA	enigma
KVRL	corl
FYNK	fink
KRYSVJYN	krisoijn
MADAKS	maddux
VYDAL	vidal
KVJYAS	kogias
AKSFRD	axford
NYVAN	neuen
ARKTYKY	arktiki
ARYKA	erika
VYND	wind
ANANT	anant
ASVALAP	aswalap
AVHALVRAN	ohalloran
KLATZ	klotz
DYNA	dina
AVAD	oued
MVRAVAN	moravan
ALSAP	alsop
FARYHA	fariha
SVZV	sozo
TAKY	taki
GAVYN	gavin
MARLYN	marlin
GADBVRY	gadbury
AYVSV	ayuso
RAKVN	rukan
HADSVN	hodson
PANYKV	panico
ASPARZA	esparza
MARTYN	martyn
ALGYNGTVN	elkington
HANSVN	hanson
BVRM	borm
ASKARS	scarce
JYM	jim
DANKV	danco
BVZVVA	bozuwa
VYJNAND	wijnand
VAFA	wafa
KARTYS	curtis
HVRYNG	hornig
KALYAN	kalyan
KANT	kant
PVKVRNY	pokorny
ALVYN	elwyn
ALDYN	eldin
LABDVN	labdon
TVAMA	tuama
TVMY	tomi
DARBY	darby
BVM	bum
AVCZ	ochs
GADBVRY	gadbury
VYND	wind
AYN	ain
SVYFT	swift
BRAYNKLR	brinkler
MVGANTY	moganti
YYKA	yeka
ASCVYLAR	schuyler
FAGAN	fagan
SYVA	siva
GYPJH	gepje
AZAD	azad
DYMYTRY	dimitri
ALKSANDRVZ	alexandros
LVPATKYN	lupatkin
DAMVN	damon
TYNG	tyng
FRAYDMAN	friedman
DVBRYKYN	dobrikin
LABDVN	labdon
MANAMA	manama
HAN	han
DADA	dada
JVBAL	jubal
KARASV	karasu
JYSVZ	jesus
YASYRAH	yasirah
BARFVRD	barford
ASTVRR	storer
RVY	roy
NARAD	narad
DAVT	dout
AVRYVLY	aureole
MARSY	marcy
DANGYV	dongyu
AYRVN	aaron
SVAGATV	swagato
NYNVYS	ninoys
BAB	bob
DYRKS	dirks
BANTVN	banton
DALYNAR	dolinar
ADGYNGTVN	edgington
GAJNH	gagne
AYVLYN	evelyn
GALYZYA	galizia
GANTY	ganti
MANSYL	munsil
DVRMA	dorma
MYLKS	milks
KYBV	kibo
AYZAK	isacq
VYLDYNG	wilding
ADRYS	idris
HVA	hua
ALKSY	alexy
MYLMAN	melman
AMYRA	amira
KRYSPYJN	crispijn
DANAVAN	donovan
LYNDAL	lindal
MAK	mak
MANGLANY	manglani
BARG	burg
ANTYLA	antila
BVM	bum
JASTAS	justus
AFA	afa
KASTRYKAM	castricum
HANG	hung
KANAKAKVRN	kanakakorn
KALKAN	kalkan
DAG	dog
TAPLYN	taplin
FYDVR	fedor
PVHL	pohl
ASYF	asif
AYNC	inch
BADZYAK	budziak
SVLYS	solis
VYLKYN	wilkin
KATY	kati
MAYV	mayo
AGALY	agali
BAYARD	bayard
TRYSY	tracy
ANTRVSYV	antrosio
KRYVVNVZ	kriwonos
MVNTYJV	montijo
AMLAK	amlak
FARAGV	farago
ATYYA	atiya
HAPKYNZ	hopkins
FLYMYNG	fleming
BVLDVYJN	boldwijn
NVKV	noko
BLANZDVN	blunsdon
TVSKANV	toscano
'ALY	aali
DAYS	dais
ALRVY	elroy
SYRKVYS	cirques
TANG	tong
BYSAYV	bissau
KRYSTYNA	kristina
YARYAN	yaryan
ASTRAK	strock
BYVDVYN	bauduyn
LVK	luk
VAYA	vaya
DYVNYDA	dionida
KRASBY	crosby
TVKYV	tokyo
HASK	husk
BARKVS	barcus
KRANSVYYK	cranswick
LAYRD	laird
MARLA	marla
ANYSH	anisa
DVRAN	doron
VAYA	vaya
TVBYN	tobin
FVRTS	forts
AYSYZAKY	ishizaki
DVRA	dora
PVLGAR	pulgar
NVRDBVRG	nordborg
RYYNKS	rienks
HAYVL	houle
ASTN	stan
AGVSTYNY	agostini
RVSLYN	roslyn
KAY	kai
YVRK	york
AVRN	orne
SVR	sor
JALA	jala
BRYJ	brij
DAYR	dayr
NYD	nid
BALDVR	baldur
DVSKV	dusko
TVM	tom
PVLYYAM	pulliam
YAMYNAH	yaminah
ATRAM	atram
MAV	mao
SASZH	sasze
HAYVL	houle
AYN	ain
ATRY	atri
AMVRVSV	amoroso
LABRYVLA	labriola
BRYTV	brito
SYLVYV	silvio
GABARA	gabara
VAST	wust
FYDVR	fedor
ASPVLARYC	spolarich
SANYL	sunil
KATRYN	katrin
KLYFT	clift
PVALMA	puelma
LYNDZ	lynds
KLANTVN	clanton
BARNAS	barnas
YVRMV	yermo
AVSYZ	oseas
LVRD	lord
PADVA	padua
ASVALAP	aswalap
MVRNYNG	morning
ASTVVAL	stovall
BVHL	buhl
GRYLK	grilk
AYK	aik
ASTAD	stude
FYN	fin
PARTVS	partos
PAKALA	pakala
MVNRV	munro
GRYNHAM	grinham
JYRMASKA	germuska
JYGANG	jigang
LYANG	liang
ALAYS	elyse
BALSVN	balson
NVRDBVRG	nordborg
GVYKARYS	geocaris
SYMAL	cemal
LAVSTAD	lovstad
DVGAN	dugan
RABKYN	rabkin
AKVNA	acuna
AMARYT	amarit
GARMZ	garms
ATKYNZ	atkins
ARMSTRANG	armstrong
MYRMAK	mirmak
LASKARY	lascari
VAN	van
ZAGAR	zagar
DVGAN	dugan
BARTZ	bartz
BANKRAFT	bancroft
GANATRA	ganatra
AYZMN	isman
MAGVAYR	maguire
VYMPYJ	wimpje
MVNTANV	montano
MARLYN	marlin
VAL	wal
BARKAY	barkai
RYVDT	ruudt
ALYSVN	elison
FYDALGV	fidalgo
ANATVLY	anatoly
BANYTA	bonita
LARVKVYH	larocque
RYVARD	rivard
HYSAN	hisan
LYVNVRA	leonora
DYSAY	desai
SAMGYN	sumgin
KVJYAS	kogias
BAGZ	bugs
DVSKV	dusko
NABYL	nabil
VYKTVR	victor
HRLAYNDYZ	herlindis
RAFALKV	rafalko
AKYHYKV	akihiko
KARL	carl
RAVDAH	rawdah
NVRDBVRG	nordborg
'LAALDYN	alaaldin
DAVD	daud
AZAD	azad
JAVYD	javed
MAYRS	myers
AYLYNG	ayling
SANTV	santo
KRVK	krok
MYSTRY	mistry
DRYV	drew
BYANGTAY	byungtae
KVSTA	costa
KALPANA	kalpana
MARKVS	marcos
ASCVYLAR	schuyler
JYN	jin
HALAN	hulan
GLDASTYYN	goldsteen
AVL	owl
LKS	lax
TKS	tex
HVAR	hoar
JANKYNSVN	jenkinson
AMYVT	amiot
DYAMVND	diamond
RYSTV	risto
HYKARV	hikaru
PRAYM	prime
SAGA	suga
MVNKS	monks
VYRYANA	wiryana
NYDH	nida
BYAN	bian
TVLYV	tulio
ARM	arm
FVNYVK	foniok
KALYLA	kalila
PATRYSYA	patricia
LYYVVH	lieuwe
GVYN	gwin
PYNKVVYTZ	pinkowitz
ASTYL	steel
FVRTS	forts
YYKA	yeka
AMA	ama
ANFANT	enfant
KYNA	kina
ASTAD	stude
YANG	yang
YVZR	user
AGVSTYNY	agostini
VYMPJY	wimpje
JALA	jala
BARNAM	barnum
AYLVT	eliot
ASKVLYNG	scowling
RVGALSKY	rogalsky
JVAN	joan
MVRNYNG	morning
ASTRYD	astrid
PRATVL	pratul
MANYKS	mannix
BADZYAK	budziak
KAMAR	kumar
FRAYTGRSA	fritgersa
DYRKS	dirks
AMYKVS	amicus
BYLYNGASLAY	billingsley
GVRKY	gorki
HAYBZ	hibbs
FRYTS	frits
MAYSAL	missal
DANSYNG	dancing
LADVVYKA	ludovica
MVRAS	moras
DRAMATYS	dramatis
JASTJH	justje
DAL	dal
AVLSVN	olsson
HAMY	hami
ABVDHABY	abudhabi
PADVLA	padula
AMBAR	embar
TAMAY	tamai
LANGV	lungu
VATKYNZ	watkins
TVRYN	turin
AYS	ace
BYAN	bian
LVKV	loco
RAFALKV	rafalko
DANKAN	duncan
MYLAM	milam
BAPTYST	baptist
LATKYNZ	lutkins
HARATZ	haratz
KASTRYKAM	castricum
BYLHAR	bilhar
LVZANV	lozano
FAVST	foust
AVALD	ewald
KYV	kao
ASPVRY	sporay
SVRANA	surana
HYKARV	hikaru
ANATVLY	anatoly
AKSLY	oxley
LAPASV	lapaso
SYTV	seto
BYRNH	byrne
BLVM	blum
LASK	lusk
JVDAS	judas
LAV	lau
LYZ	liz
TAMY	tomi
SANTVS	santos
AYNANA	inanna
MYLKS	milks
FABYANV	fabiano
ABAD	abad
MARLA	marla
ASPVSTA	spousta
SYRYL	cyril
FRAYTGRSA	fritgersa
TAY	tye
AVVRDAL	overdal
DATRY	datri
LAYNG	laing
AVBRTAS	obertas
TRAFTVN	trafton
RYGAN	ragan
MVNTA	monta
KANYS	canis
FAYNK	finke
ASKP	skep
BRVHL	brohl
PYNDAR	pindar
SARMA	sarma
TVLY	tuli
ALYMA	ulima
LYVNZ	lions
BLVHM	blohm
VAYS	wise
VYKTYM	victim
SYMS	sims
MYNA	mina
HAKABAY	huckaby
KRYSTYN	kristin
AMBAR	embar
LYNDL	lendl
ADMVNDZ	edmonds
BVSTRAM	bostrom
ATKYNZ	atkins
ANAND	anand
DANALD	danald
AYSTMAS	isthmus
KRYSTA	krista
LAST	last
ASTVRY	storey
KARLVS	carlos
ABVBA	aboba
ASTNSRAD	stensrud
A'LY	aali
LANDRY	landry
MYNA	mina
LAMARK	lamark
MARTYNZ	martens
TAYLBRY	tilbury
AMANY	amani
RAMVLVS	romulus
ABY	ebe
KATALANV	catalano
MVNDFRANS	mondfrans
SYVN	sune
ALYASVN	eliason
SYMSYK	simcik
KANBVY	conboy
HYJDAN	higdon
LAYND	linde
KARNYA	carina
AYNGLS	ingles
RYGAN	ragan
'FAF	afaf
LVND	lund
BARTZ	bartz
AVVLYV	avolio
FRANSYSYVS	frnaciscus
PRYTZ	pritz
PRAYB	pribe
KVYSMAN	coisman
GRYYNVALD	greenwald
KVNYNG	koning
VYLHAYT	wilhite
MAYR	myer
AVCZ	ochs
VYBVVV	wibowo
KARLTVN	carlton
ASPVLARYC	spolarich
ALAYN	alain
VYRAF	viraf
