KYNA	kina
AYLKA	ilkka
ANTVNY	antony
GNAGY	gnagy
FVRTS	forts
KRYSTA	krista
ADH	ade
ALANA	alana
GVLAND	goland
LYSTVN	liston
ZAYRA	zaira
ALKSY	alexy
KRYSP	crisp
LAP	lap
HRLAYNDYZ	herlindis
HARBVR	harbor
VATKYNZ	watkins
SAKAYV	sakaue
VAYBY	wiebe
SAVYN	savin
ALGYNGTVN	elkington
SYLK	silk
LYMYNG	liming
DVLMAN	dolman
KVMPTVN	compton
ZARYA	zaria
GYVVN	givon
AYNANA	inanna
FRANKVYZ	francoys
VVN	wun
SYNAN	sinan
KAY	kai
PATYL	patil
HADYL	hadil
GARSYA	garcia
MARTYNV	martino
PYNDAR	pindar
AZALYA	azalea
KLAVDY	claude
HAHTAHA	huhtala
RANY	rony
RVYMATA	roimata
ALY	ely
RAMVS	ramos
ASKVLYNG	scowling
MYNTZ	mintz
ASLYMAN	slimane
ABRAHAM	abraham
LYRYKAL	lyrical
VASYT	wasit
BLVNSDVM	blunsdon
KVRL	corl
DYVNYDA	dionida
DVVAYKYNK	duickinck
MVRYTA	morita
DAPAY	dupuy
DYN	din
FADL	fadl
RADHA	radha
ANDRYAS	andreas
ASKYN	skene
MVLYNARY	molinari
BLAHA	blaha
AYNC	inch
FLVRA	flora
BRYGVY	bryguy
BALMA	balma
HARVHYSA	haruhisa
DAL	dal
SASTYK	sustik
JVZY	josi
DARYL	daryl
ASTYLZ	stiles
KVBLA	kubla
KAMB	kamb
SYPRYANV	sipriano
LANDGRYN	lundgren
MADVRAY	madurai
RVNGV	rongo
AVLY	olli
ALYMA	ulima
LVMBARDV	lombardo
RAV	rau
TYTAY	tytie
RYYD	reed
RAV	rao
ABYAD	abiad
BVDRA	budur
AYNGALZ	ingalls
MAYRYK	myrick
PLASTYNV	plastino
SYNK	sync
ALFVRD	alford
MANV	muno
MVHAN	mohan
TALYBAH	talibah
MARYV	mario
PYNA	pina
MKGAVYN	mcgavin
RAKVN	rukan
BARTZ	bartz
MYLGRAM	milgram
KVBV	kubo
FAYYZ	fayiz
AVSTYN	austin
RAMVS	ramos
HARRYG	harrig
MANKVS	mancus
PRVMVNTVRY	promontory
SVPRATYK	supratic
BVDVR	budur
JYNTVN	ginton
ZAYNAH	zaynah
GRAYYNGR	grainger
KALPAK	kalpak
SVBVTKA	sobotka
LAYN	lynn
AYS	ice
VANSY	vance
RYYAD	riyad
AYLSA	ailsa
HANG	hung
SVDYPTV	sudipto
DYRKS	dirks
ASKYLS	skiles
KALYA	kalia
BALSARA	bulsara
ARLYNDH	arlidge
ASKLVYR	sklower
NAVAS	navas
ADANA	adana
HASK	husk
PVLVVYN	polowin
AVZBRN	osburn
PVGA	puga
ANTRVSYV	antrosio
JVANA	juana
ADVNYS	adonis
BARNAS	barnas
LAYKZ	likes
ASLNGZVALD	slangsvold
JVAV	joao
HRLAYNDYZ	herlindis
DAMYANV	damiano
RAN	ron
AVLY	olli
PVYSL	poisl
JASTYN	gustin
VYLMVT	wilmot
AMANV	amano
BAYARD	bayard
ARAYZ	aries
MVRANV	morano
DVRAZYV	dorazio
JVSLYN	joslin
DANAVAN	donovan
AVRN	orne
DYAZ	diaz
PASKV	pasko
SYR	cyr
VADH	wade
AYNVN	eynon
ASKAVN	skaven
JVAN	juan
KARL	karl
KVSTYS	kostis
KASTANV	castano
AYVLYN	evelyn
LAPASV	lapaso
RVGVZA	rogoza
SYTYA	cetia
VAH	wah
MALTYN	maltin
SVART	swart
PYYK	peak
BYSAYV	bissau
ASTYK	astik
BYZVAS	biswas
JANK	junk
RVNYT	ronit
NVDYNG	nuding
MYNTVN	minton
NYMTZ	nimtz
KALTVN	colton
TAMAY	tamai
SADYVP	sudupe
JANSJH	jansje
KAYAK	kayak
KYVNG	cuong
MAVBY	mawby
PRAYL	prael
HAYNZ	hynes
BRAN	bran
LVN	lon
BVKSY	buxey
LASKA	laska
ASPVSYTV	esposito
S'YD	said
FYN	fin
VYKRAM	vikram
AZAD	azad
ALYAS	alias
BADYN	baden
BVM	bum
PANDYT	pandit
MANRV	munro
RAMVS	ramos
AVBR	ober
RVJAS	rojas
NYMTZ	nimtz
ASTAPLYC	stuplich
DARBY	darby
RAMVLVS	romulus
DYDA	rida
RVHN	rohn
VYVYK	vivek
MKGVYRK	mcguirk
SALMY	salmi
MAYRZ	myers
DVRAZYV	dorazio
DVRAND	durand
AVRLYNZ	orleans
DVMYNGV	domingo
ALGAYN	olguin
SVZY	suzy
HAVARD	havard
ATKYNZ	etkins
ANZALVNY	anzalone
ALMV	elmo
BRVYN	bruyn
LYN	lyn
TRAFTVN	trafton
LVNAV	lunau
RVTZ	rotz
SYNA	cena
MAY	mai
DVRAPT	durupt
PYATJY	pietje
ABY	ebe
DAYLVN	dillon
DAYLVN	dillon
LVM	lum
KANYS	canis
AKVSTA	acosta
DYMYTRYV	demetrio
ANAGRAM	anagram
DRAGAN	dragan
BRAN	bron
SVRAB	sorab
DANKY	dunki
KANRVY	conroy
BARLAS	barlas
SAP	sup
KALA	cala
AVLSN	olson
VARGAS	vargas
HYRVTA	hirota
VYVYK	vivek
JAMVNA	jamuna
RVGALSKY	rogalsky
AVNSTY	onesty
BVS	bos
AKA	aka
SAVARAM	savaram
KYVNG	cuong
ANV	eno
ALZ	elz
AYNT	aint
SYANV	siano
JAD	jud
LYPKYN	lipkin
KVNG	kong
AVRYGA	auriga
RASTYN	rastin
DYLYP	dilip
GYVZ	guse
'DYL	adil
BALBYR	balbir
RAMY	rami
SANVNDV	sunondo
KVLYHA	koliha
HVA	hua
KNVFYNKH	knufinke
BVDA	buda
HRABY	hrabi
GYRARD	girard
FRYTZYVS	fritzius
TRVYYJH	truitje
VVN	wun
YAMHA	yamha
ZAFYNA	zafina
BARTVNYKV	bartonico
HVRSFVRD	horsford
DAYAN	dione
ASLVP	slope
VYLADVT	viladot
BAYRN	byrne
DAKV	daco
VLADV	vlado
AMYH	amie
AMBRVSYV	ambrosio
SYLVYA	silvia
LYVAYN	levine
AYSTMVS	isthmus
MVNTANARV	montanaro
LVYYNG	luinge
ASTYL	steel
PYNKVVYTZ	pinkowitz
MANTVR	mantor
HAVARD	havard
SVR	sor
BAND	bond
JAYARAM	jayaram
VYK	vik
LAVD	loud
MASARA	masaru
LAYN	lynn
GAYNVR	gainor
KYRYL	cyril
ADVARD	edvard
ALBAHAH	albahah
LVTZ	lutz
PVHAR	pohar
MARALY	murali
AKVSTA	acosta
MASARA	masaru
GYFT	gift
LVS	los
KRAYG	craig
JYN	jin
VATKYNZ	watkins
AYT	ait
AYSKANDR	iskander
GRYTZ	gritz
KATLYR	cutler
JVDY	judi
TALMY	talmy
VYJDAN	wijdan
HARRYG	harrig
KVAYNTVN	quainton
ASTYD	stead
PAPLY	popli
KRYST	crest
NYKVLYK	nikolic
LYNKVLN	lincoln
MVD	mod
BASKAR	baskar
BVNAR	bonar
FAYF	fife
KVDY	cody
'ALY	aali
HYDAJAT	hidajat
HVRST	horst
HYND	hind
HADRAMAVT	hadramawt
LAPASV	lapaso
KVJYAS	kogias
VYKRAM	vikram
MYLKY	milky
AYSLT	iselt
ALMYNTAKVA	almintaqah
DANGYV	dongyu
LVMAS	lomas
JANA	jana
ASTYD	stead
PATYL	patil
AYCYRV	ichiro
AVBAJA	obadja
SYRKVYS	cirques
DANGYV	dongyu
AYVSV	ayuso
LANGSTVN	langston
ANDRYAS	andreas
LAMBRVS	lambros
MYTV	mitu
KVMPTVN	compton
ASTAMPR	stamper
HAV	hao
LYKYVRY	liquori
PYPGRAS	pipgras
LAFGRYN	lofgren
LASKARY	lascari
AKYLA	aqila
JHANG	jhang
JASTJH	justje
NAYKVLAS	nicolaes
RVSTAD	rostad
LAHYJ	lahij
KVNYNG	koning
GALV	galo
MARTYNZ	martins
ASTAG	stagg
SAYDA	saida
HARYNKAR	harincar
DVYNYNG	duening
KADMVS	cadmus
JAN	jan
AVYRSA	aversa
AYNA	inna
BYN	bin
KRYSTA	krista
SYMVNZ	simons
LYZARDZ	lizards
HVLM	holm
GALYLH	galila
LANKA	lanka
DYVNYDA	dionida
AYNA	inna
ABYAB	abiab
PANGBVRN	pangborn
ANTVNYVS	antonius
LVN	lon
SANG	sung
FRANSYSKAS	frnaciscus
ZAGAR	zagar
ALSVP	alsop
GAYA	gaya
YVMVRA	uemura
ASKRYV	screve
KAMSKAYA	kamskaya
FVRK	fork
HARMZ	harms
ASTYL	still
ANDRYVZ	andrews
DYVYSVN	davison
SAVYR	sauer
JVLY	joly
MYNYARD	minyard
KLAVDY	claude
GVSTAV	gustav
MABANAG	mabanag
HAYM	hime
DAMYAN	damian
HAYNGH	hainge
RVBYNSVN	robinson
AYNTJH	eyntje
ALVYS	alwis
AVGVR	augor
ASLVN	olson
PALSKY	polsky
ALKAN	elkan
BASKY	bosky
AMY	ami
AYSTMVS	isthmus
RYYAD	riyad
BABV	babu
ATKYNSVN	atkinson
NYMRAD	nimrod
AVRLYNZ	orleans
KAMBYY	combee
AVYRSA	aversa
MVRAVAN	moravan
GLATZ	glatz
RAFAYL	rafael
LYBYD	lebed
BAYRTYH	baertie
BRAHAM	braham
ANDRA	andra
FALKV	falco
PARK	park
KASYNSKY	kosinski
AMYH	amie
BANYTA	bonita
RVBYN	rubin
FATYS	fotis
SVHAS	suhas
GAYDV	guido
SYPRYANV	sipriano
PANYKV	panico
JVRAH	jurah
PLYSKYN	pliskin
SASTYK	sustik
VYNSVN	vinson
DRYDJY	dridge
DRAYNH	draine
AVYVA	aviva
ASLAN	sloan
TYNG	tyng
MARYSH	maryse
KLAYTVN	clayton
KAVYTA	kavita
ABRAM	abram
TYVNYS	teunis
DVRFMAN	dorfman
NYVAN	neuen
PADVA	padua
JVZA	juza
HAVDVN	hawdon
BAT	bat
AKDAG	akdag
LYRYKAL	lyrical
SYMYN	simin
ASPYTZR	spitzer
MYSTRY	mistry
RVMYG	romig
PARDYNGTVN	pardington
GRANVYN	granvin
FRYNK	frink
SVSYA	sucia
RYMVN	rymon
