VYSAL	wisal
ASLYMAN	slimane
PYLVYV	pilvio
RVSANA	rosana
'LYMA	alima
HAYBZ	hibbs
BARNABY	barnaby
BRAYN	brien
KANRVY	conroy
KALYA	kalia
SYNK	cinq
ABVBA	aboba
RASTY	rusty
PYVTR	piotr
AVLY	olli
LAYBZ	libes
ATVSY	atusi
LASTRA	lastra
BASYN	basin
NAGASAKY	nagasaki
ASPYDN	speden
NAM	nam
VAVDRY	vawdry
SVBVTKA	sobotka
KALPYN	culpin
SASLAV	saslav
BVDV	bodo
ZAYRA	zaira
LVYD	loyd
AYRARDY	ierardi
LAL	lal
HASK	husk
RAFALKV	rafalko
KANSTABARYS	constabaris
RYYAD	riyad
LYND	lind
NVYA	noya
MALAN	malan
KAMPYVTR	computer
BAJYK	bajic
LABKYN	lubkin
VYGTVN	wigton
MANYSKAS	maniskas
PRASANA	prasana
SVRAB	sorab
GVRGANZ	gorgons
HABA	haba
ZAFYNA	zafina
MARTYZN	martijn
AYNZ	inez
BABAR	babar
DANG	dung
KLAZVRA	klazura
PRAHL	prahl
LAHYJ	lahij
VYTVR	vitor
MVNYZ	muniz
KAZVNVZY	kazunori
BAKVS	bakos
AYMRY	emery
HAYRVNYMVS	hieronimus
PANDYT	pandit
GVRYS	goris
ALMVDYVAR	almudevar
VYSAL	wisal
GAT	gat
RYVDT	ruudt
BARNAS	barnas
KART	kurt
ADH	ade
AYK	aik
AKYL	aqil
MANDAL	mandal
ALYLYVNAS	alelyunas
ADMYRALZ	admirals
AVALD	ewald
MARTYNZ	martins
ASTARGS	sturges
HYSLAP	hyslop
SVDYP	sudip
ABRAM	abram
HASBY	husby
ALYLYVNAS	alelyunas
DYVNYDA	dionida
LAYHV	laiho
ZVLD	zold
RADRAMVNY	rudramuni
HARARY	harari
HABA	haba
SYMVNDS	simonds
BASTARD	bastard
RAN	ron
LVNAV	lunau
KASY	koci
AYMRY	emery
DJAMYLA	djamila
SYNDRH	sindre
GADFRVYD	godfroid
BAKSKA	bocska
BARTZ	bartz
DYAMANTARAS	diamantaras
MYLMAN	melman
NVTZ	notz
PAKVAT	paquet
VYDAD	widad
AMY	ami
AVLD	auld
ALBAHAH	albahah
VYRCVAL	virtual
FAVAZ	fawaz
DAHAK	dahuk
DANGTAY	dongtai
FABRH	fabre
SANDMAN	sandman
AYSYZAKY	ishizaki
HAYNLY	hinely
YARYAN	yaryan
BRYSBYN	brisbin
AZANA	ozuna
SAMBVLYK	sambolec
BLASK	blask
RYZVY	rizvi
NYDH	nida
KANA	kana
FARYHA	fariha
VASYT	wasit
TYNG	ting
BADZYAK	budziak
KANV	cano
KATZ	katz
FAYRBANK	fairbank
MVKASA	mukasa
BAND	bond
GVDAT	gudat
DVA	dua
JANA	jana
GVRGAN	gorgon
SAMANTA	sumanth
ATVSY	atusi
KVNYNG	koning
SYNDRH	sindre
BYNVY	binoy
NAYMAH	naimah
RADRAMVNY	rudramuni
ANDRYA	andrea
BALDYNGTVN	baldington
HARYHARAN	hariharan
HARVHYSA	haruhisa
BAGDAN	bogdon
PRAHL	prahl
AYMVN	eamon
JASTYN	gustin
FVN	van
KAMAR	kumar
KYVNG	keong
LVBV	lobo
FVTYNVS	fotinos
MYNARD	menard
AMPTH	ampte
BABA	baba
PANDA	panda
ANVPAM	anupam
SYMAL	cemal
MANAMA	manama
BRVTY	bruty
DYNG	ding
FAYYZ	fayiz
AVRCARD	orchard
BVZKART	bozkurt
VARGV	vargo
LYAM	liam
BALYT	balit
LANDGRYN	lundgren
TYNG	ting
VVLTRNYNG	woltering
PRVTVS	protus
ASTYK	astik
AYNTLSAT	intelsat
TATSVRV	tatsuro
VALDV	waldo
DYAMANTARAS	diamantaras
ANVPAM	anupam
DVSTALYK	dostalik
RAFAYLY	rafaeli
VAH	wah
ALFARV	alfaro
HAYRVNYMVS	hieronimus
ASPRVT	sproat
KANG	kong
DANYDYN	dunedin
HLAVYN	hlavin
FLYKS	felix
PVSV	poso
MATLV	mutlu
LAMYKYN	lamykin
ALANGKV	elangco
PVALMA	puelma
LAYRD	laird
KLAZVRA	klazura
AYLVT	eliot
GVRKY	gorki
LVSYTV	losito
PAVLYK	pavlik
LYM	lim
KYVMR	kumar
FRNASYSKAS	frnaciscus
PLYNSKYN	plinskin
PVRANYK	puranik
BVNGARD	bongard
MVMFVRD	mumford
PAGLYA	paglia
ASTNKAMB	stancomb
FADYL	fadil
LANTZ	lantz
KATRYN	katrin
ASTNFVRT	stenfort
ARLYNG	arling
SVLVMVN	solomon
TVM	tom
PVRANYK	puranik
ASVALD	oswald
JVZA	juza
LVBV	lobo
AYSMN	isman
DRYDJY	dridge
MASKARY	mascari
ASMADJ	smadja
RYYD	reed
HAMMANZ	hammans
JVAV	joao
FABRV	fabro
MAYT	myth
RYV	ryu
HYVKYNZ	hawkins
RABYDYAKS	robideaux
GASTAVVS	gustavus
GVSTAV	gustav
BAYDA	bayda
SYN	sin
LADVYG	ladwig
JVZYH	josie
BRAYN	brien
GVPTH	gupte
DVBVYS	dubois
KVYST	quist
AYN	ain
FALKV	falco
DRAVN	drown
KATZ	katz
ANASTASYA	anastacia
DANKV	danco
DVGAN	dogan
TVYN	twin
KYALASA	kailasa
VYMAN	wyman
LAMBVRN	lamborn
HYRT	hirt
DVRYNDA	dorinda
JVNYVR	junior
ABYAD	abiad
SAGA	suga
MARTYJN	martijn
GRAHAM	graham
RAKVN	rukan
HYVNGAN	hiongun
VYLYANY	villani
AVRFYVS	orpheus
KLBAY	kilby
RALF	ralf
KLAYSVN	clayson
BALYGA	baliga
LYMYNG	liming
ASTVRY	storey
APLYN	aplin
KRAVFVRD	crawford
KVRZAYN	corzine
HAYRVNYMVS	hieronimus
AVLSN	olsen
GVSTAV	gustav
MANV	mano
LAMBDA	lambda
ARHARD	erhard
HVYYSKN	huisken
ADVNYS	adonis
SARVATH	sarwate
MYKAYL	mikael
BAYRN	byrne
VYBVVV	wibowo
YVRK	york
HAVKYN	hawkin
DNVKS	denux
VAYD	wide
MVRYSVN	morison
TAMATYVS	tomatius
ADRY	adri
VYLA	vila
MAHAJAN	mahajan
TVLYV	tulio
AVAN	awan
VATKYNZ	watkins
DRYV	drew
BLAZ	blaz
TAGLV	tuglu
MYRMAK	mirmak
MANVLY	manolo
LYNK	link
HAJYR	hagir
AAMYNA	aamina
ASTYANSN	stiansen
RAYDN	ryden
NYHALANY	nihalani
AVSTYN	austin
HAVYS	howes
LYVNARDV	leonardo
LYND	lind
FADL	fadl
ASTRYDM	strydom
ABY	ebe
NARDV	nardo
VVLTRNYNG	woltering
VALVR	valur
ALF	elf
PAN	pan
KLAG	klug
SYTARAM	sitaram
KRYYK	creek
ANDRYS	andris
LYVN	leon
KALKAN	kalkan
ABYL	abel
ANDAMZ	adnams
ASTRYD	astrid
PAN	pan
RVGVZA	rogoza
BYLAL	bilal
FVTYNVS	fotinos
'BDAL'ZYR	abdulaziz
DANALD	danald
ARMSTRANG	armstrong
DAMYVN	damion
RAKYKVT	racicot
GADYL	gadil
GYNKZ	genks
YASAR	yasar
MARTYN	martyn
BYLYNSKY	bilinsky
TAPTANY	toptani
LYVYNGSTVN	livingston
BALKA	balqa
DAG	dag
KVNV	kono
PYNG	ping
DVRA	dora
JAGARD	jagard
BYNVY	binoy
AYTJY	oetje
LAMYKYN	lamykin
AVRAYZ	averis
DAMYAN	damian
GALYLH	galila
MKMAHAN	mcmahan
RASPYNY	ruspini
KART	kurt
ANVPAM	anupam
ABRAHYM	ebrahim
KANYA	kania
AKVNA	acuna
KRVPYK	kropik
MYLKS	milks
MYRVT	mirut
NARDY	nardi
AYSYZAKY	ishizaki
VYLKYNZ	wilkins
MYTV	mito
ALKS	alex
MANYJA	manija
HAGYN	hagin
ANAYZA	unaiza
AMARYT	amarit
ALVAN	alwan
BVRG	borg
FVN	van
SAVARAM	savaram
ANDRYVZ	andrews
ALANGKV	elangco
BYANGTAY	byungtae
AYRAY	airay
ATVSY	atusi
ZAZA	zaza
AVLD	auld
ASMYTZ	smiths
FADVR	fodor
LAMARK	lamark
MARYA	maria
VYZBRAND	wijbrand
BASKAR	baskar
NYHALANY	nihalani
AYSTMAS	isthmus
JYMZ	gems
BADVYYN	bauduyn
ANAS	anas
ASKAYT	eskite
KVRDYK	kordic
NAZARYTYAN	nazaretian
AKGAN	akgun
DAVKNYZ	dawkins
TAY	tye
KARHART	carhart
ASTYL	still
AYK	aik
AVLD	auld
SYMSYK	simcik
ALMVDYVAR	almudevar
DVSTALYK	dostalik
PADVLA	padula
DANZ	danz
S'YDH	saida
ARDYS	ardis
HANG	hung
ASLYV	slave
MANV	manu
JYVVYL	jewell
ANTYLA	antila
SLAT	slut
BASKAR	baskar
RAVDA	radwa
AVTVLYNY	ottolini
DANGTAY	dongtai
SYSLV	sislo
KANDV	kundu
LVSY	lucy
JVN	jun
LAYRD	laird
MAVN	maun
BVSTRAM	bostrom
ASPYDN	speden
ADVARD	edvard
AKYL	aqil
GRAFT	graft
LYAM	liam
BYANG	byung
HANG	hung
SYRKVYS	cirques
TVVYS	twiss
KRAB	krab
RVZYTA	rosita
AMYR	amir
GYRARD	girard
FATYMA	fatima
KVBV	cobo
HVRSFVRD	horsford
KVRBYN	corbin
DVBVYS	dubois
KRAY	cray
KLAG	klug
LYANG	liang
DYVAN	dewan
VYMPJH	wimpje
DYKSVN	dixson
MYNA	mina
SVDYP	sudip
AVGVST	august
FARAGV	farago
SAGARS	sugars
DVBYNYN	dubinin
HARVNY	haruni
ASTYVZ	steves
LVSYH	lucie
FARYD	farid
ZAYRA	zaira
RYBAR	ribar
HARTAG	hartog
NAYMAH	naimah
TYNG	ting
RASTYN	rastin
ARFANAKYS	orfanakis
KVNV	kono
BASTYVN	bastion
ADNAMZ	adnams
SKSTVN	sexton
TAY	tai
RAKYKVT	racicot
BAJYK	bajic
BARY	bari
BYNG	bing
ATKYNZ	etkins
FLVRA	flora
FRANSVYZ	francoys
LYNKVYS	linkous
FANGVS	fungus
MVRAD	murad
ANDAMZ	adnams
AMY	ami
LYMYNG	liming
VYSKA	visca
DYYALA	diyala
ASTRYM	stream
AVRYGA	auriga
SYRVS	cyrus
RAJV	raju
