RAGATZ	ragatz
KVNYNG	koning
DAHVD	dahuk
YAGLA	yagla
ANJLYSYA	anglesea
LVDVVYKA	ludovica
TAYJMN	tijmen
KYVNG	keong
FVJYVKA	fujioka
KASTANV	castano
ASTYVN	steven
GALAHAD	galahad
AVLYVYR	olivier
KRAMHVRN	crumhorn
FRYTS	frits
KASYNSKY	kosinski
'LYM	alim
AVTA	otha
GAYNVR	gaynor
MAKARAYG	macaraeg
VYLKANS	vilcans
BRANDY	brandi
HYTZ	hitz
NYVMAN	neuman
KANA	kana
LAY	lai
LATALA	latala
TVMATYVS	tomatius
LAPVTA	laputa
MVRA	mura
KASTY	casti
KARASA	karaca
MADYS	madis
MVYR	muir
YAKVB	yacob
FABRV	fabro
ASTYP	steep
ALKSANDRVZ	alexandros
DVBSVN	dobson
FRAYTGRSA	fritgersa
MANKS	monks
AFA	afa
ATVL	atul
KVRBYN	corbin
DAYLVN	dillon
BYRD	byrd
MAMFVRD	mumford
LYVYVS	livius
AVALD	ewald
AVVLYV	avolio
AYNKH	einke
AYVRSVN	iverson
TVLA	tula
FAGAN	fagan
FRNASYSKAZ	frnaciscus
ADYL	adil
KARDYNALY	cardinali
ASTARBAK	starbuck
MANYJA	manija
AKLAND	eklund
ANAYLYN	anilane
GANSVN	gunson
APLYN	aplin
BARFVRD	barford
ASTAPLYC	stuplich
KASTANV	castano
AVSTRANDR	ostrander
ALMYNTAKVA	almintaqah
KYNGSTVN	kingston
TYPAL	tipul
DASYVK	doseok
KRYS	kris
BAYLS	byles
ANAS	anas
KARNYA	carina
DADGYVN	dudgeon
PADVLA	padula
MARTYN	martyn
GADFRVYD	godfroid
FRYNK	frink
DVDAMANY	dodamani
BARBAS	barbas
ASTAKY	stucki
KVMVRYTA	komorita
AVADYA	awadia
JANSKY	jansky
KVANRADVS	coenradus
DANKV	danko
BAYRTYH	baertie
BARGVS	bargus
GYPJH	gepje
ASTK	stec
RAFAL	rafal
NAKAMVRA	nakamura
KRVM	crom
MALAN	malan
ALANGKV	elangco
HRNSBAY	hornsby
GRYSVALD	griswald
TATSVRV	tatsuro
LAYHV	laiho
VYNSTVN	winston
AVCZ	ochs
TYRZA	tirza
AVGVSTYN	augustyn
BVLVS	bulus
PAL	pal
RAFAYLY	rafaeli
LABKYN	lubkin
ASKP	skep
ASNV	snow
TVNAR	tonar
RAMY	rami
PAY	pai
GYLYTA	geleta
ANV	eno
NYMTZ	nimtz
FRANSVYZ	francoys
RABYNSVN	robinson
HAPKRAFT	hopcraft
FLYMYNG	fleming
NYVMAN	neuman
GALKV	galko
DYAMVND	diamond
JVNYN	jonin
NYVMAN	neuman
KYD	kid
BAVM	baum
PRAPYS	prupis
MYLT	milt
RVYMATA	roimata
AVGVSTYN	augustyn
VALVR	valur
ARMSTRANG	armstrong
ASLAVMYZ	slawomir
ANGLAND	englund
MVN	mun
KVLYHA	koliha
GYL	gil
KVTLA	kotla
RAGATZ	ragatz
MADVN	madon
KLAVDYA	claudia
AYNGRYSVL	ingresole
GANTRAM	guntram
LYNDVN	lyndon
BYRA	byra
GAGNH	gagne
MAV	mao
VYLKYNSVN	wilkinson
KVHN	cohn
DANKV	danco
RAGNAR	ragnar
HAMMANZ	hammans
MARYA	maria
SYRVS	cyrus
GVYL	goel
ALBAHAH	albahah
HAMAH	hamah
AKA	aka
LVKV	loco
ASTVN	stoun
LARJA	larga
NADVLNY	nadolny
PVSV	poso
ALVARV	alvaro
PYRAN	piran
BABV	babu
JARVYS	jarvis
KAKYVR	kakure
MVRYSVN	morison
HYDAJAT	hidajat
AVRYVLY	aureole
FALK	falk
LAYBZ	libes
RASKYN	raskin
SAN	son
VYLASKV	velasco
LYSKANV	liscano
MAYRZ	myers
AKA	aka
ASTNSRAD	stensrud
HYVNGAN	hiongun
KAMSKAYA	kamskaya
MVD	mod
'LY	ali
HYND	hind
ASKP	skep
MYNTAKAH	mintaqah
AYNA	inna
BARG	burg
VYLYANY	villani
HAVTYN	hawtin
SVZV	sozo
SANVNDV	sunondo
DYSAY	desai
LYLA	lila
BYNVY	binoy
PAYNH	payne
GVPTA	gupta
AMBAR	embar
ALVYN	elwyn
TYMYAN	timian
LAMBRVS	lambros
KVRY	kory
BABAR	babar
ARYA	arya
AMYT	amit
VADAPARTY	vadaparty
BALYT	balit
TAYJMN	tijmen
MYGVYL	miguel
HAYNLY	hinely
HYDAJAT	hidajat
MASARA	masaru
DVGAN	dogan
ASPVSTA	spousta
AMYVT	amiot
'AYMN	ayman
ZARYA	zaria
MAYSAL	missal
ASKAYT	eskite
JYNG	jing
DASYVK	doseok
AKYTVMV	akitomo
MANKVS	mancus
SYMYNGTVN	symington
MANGLANY	manglani
KARVSV	caruso
JHANG	jhang
DADGYVN	dudgeon
YASAR	yasar
GASYK	gasic
SAYM	syme
PVGA	puga
RAYDN	ryden
ALTMAN	altman
RASK	rusk
ASTARGS	sturges
DAMYVN	damion
ABYAB	abiab
LVKAS	lucas
SAKLAD	saklad
ZAFYNA	zafina
ASTARBAK	starbuck
GAYNVR	gaynor
ASTANGYR	stangier
LAMYKYN	lamykin
BRVKSL	brooks
RVLDAN	roldan
'LYA	alya
BRANSDVN	brunsdon
FRANKV	franco
BLANSTAN	blanstan
TRYVYTZ	truitje
TYNY	tiny
KALYLA	kalila
KVYYLYN	quillin
FLVYD	floyd
SASLAV	saslav
NYMRAD	nimrod
AYT	ait
MATANA	matana
RAMY	rami
DYNT	dint
ALVKAL	alukal
AVANZ	evans
NAPVLYTANV	napolitano
MYLASYS	milacic
ABYNA	ebina
MYNGV	mingo
TRYVLV	triolo
KVRAM	coram
HAGAN	hagan
ANDR	andr
LYDVYNA	lidwina
BRVHL	brohl
GVVDYNG	gooding
FRAYDY	friday
AVGVSTV	augusto
KANG	kong
DAMYNY	dominy
SYTV	seto
AVLYVYR	olivier
SVDYP	sudip
HYRD	hird
HAVN	hawn
S'YDY	saidi
AMNA	amna
DYNT	dint
ASKP	skep
BVDY	budi
AMYT	emit
GVRVSAMY	gurusamy
BALD	bald
AMARA	amara
PVHAR	pohar
LALY	laly
KASY	koci
TVBYAS	tobias
