KYD	kid
MYLYND	milind
DVRYNDA	dorinda
PANDYAN	pandian
HVRYV	horio
JAKVBJH	jacobje
BABVRAV	baburao
LAYRD	laird
KYVSMATV	kusumoto
KRYSVYJN	krisoijn
ARHARD	erhard
VYN	vin
MAVBY	mawby
KARTYS	curtis
BRVZ	broz
'LYA	alya
BYFRAST	bifrost
ABVBA	aboba
KAV	cao
SABRAMANYAN	subramanian
VASYT	wasit
SAP	sup
NYMRAD	nimrod
AYLYNG	ayling
HYSLVP	hyslop
PAKS	paks
AYNVN	eynon
KVYSMAN	coisman
BVDY	budi
CYBANSKY	cybanski
JANARDHAN	janardhan
MVRLAN	morlan
PVH	poh
RVGALSKY	rogalsky
PYYRY	pieri
VAYD	wide
PADVLA	padula
JYVVYL	jewell
HVDAYDAH	hudaydah
SAVAN	sawan
JYVRDANV	giordano
BYLHAR	bilhar
JVNYN	jonin
RAYBLT	rybolt
JAGV	jago
SYLA	sela
DVDAMANY	dodamani
LVJYK	logic
MAYSAL	missal
PANDA	panda
HAMAH	hamah
TRYVLV	triolo
MAHA	maha
BRVYNYNG	bruening
BARD	bard
DRYDJY	dridge
GRANDASTRVM	grundstroem
LYVNVRA	leonora
LYDYA	lydea
APRYL	april
ASTRYDR	strider
HAYZ	hise
KANDY	kandi
AVDRA	audra
BYAVYS	beavis
FYNSTAD	finstad
ASTABRT	stobert
BADZYAK	budziak
FRAYDMAN	friedman
FLVYD	floyd
DAYLVN	dillon
AVSYVN	oseven
DARBY	darby
ASPARZA	esparza
BALTAYS	baltais
PADVLA	padula
SVBHANDV	subhendu
PRAHL	prahl
BYG	big
AVSTRANDR	ostrander
LAZARA	lazara
ASKRYBLYNG	scribbling
HYRAY	hirai
DAS	das
TKS	tex
GAMBYNV	gambino
MANKS	monks
ALTANYN	eltanin
TAFT	toft
LVKV	loco
BVYRKVYL	boerkoel
BAD	bud
BARTZ	bartz
GVRVSAMY	gurusamy
AYLYS	eyles
KVYL	coil
'ADL	adel
ASTALKH	stolcke
MANDAR	mondor
MABAY	mawby
KYN	kin
ASTYN	stian
BAPTYST	baptist
HAVTYN	hawtin
ARDYS	ardis
BAVDYN	baudin
FRNASYSKAS	frnaciscus
MYAYNDRT	meindert
MARYV	mario
TYVNYS	teunis
RAGATZ	ragatz
DVNATV	donato
GASKYN	gaskin
HYTZ	hitz
ABH	abe
LYVYVY	levavy
AYNGLS	ingles
MANRV	munro
VYZNAND	wijnand
NYMRAD	nimrod
RVGALSKY	rogalsky
BARKASFYLD	barksfield
ASMYLY	smyley
KVRBYN	corbin
SAMZ	sams
MARAZAS	marazas
YANSVN	yanson
LANKA	lanka
FALTVN	fulton
BVSTVN	boston
VYVYK	vivek
RVNGV	rongo
AYM	aim
LVSYTV	losito
AKMAN	ekman
BAYLS	byles
PAYTR	pitre
SASZH	sasze
SASZH	sasze
TRVYYJH	truitje
BRAVV	bravo
ANAS	anas
FADL	fadl
GADBVRY	gadbury
AFYF	afif
RYV	ryu
AGYL	aqil
DVNAY	dunae
KVYYT	quitt
HARYHARAN	hariharan
DANGTAY	dongtai
SANJAY	sanjay
GVLAND	goland
SYN	sin
AYLYNG	ayling
DYAMVND	diamond
SVL	sol
DANG	dung
DYSANTV	desanto
KANG	cong
RAGNAR	ragnar
SANTYK	santic
BADYG	budig
AMBAR	embar
BYPYN	bipin
JYVRDANV	giordano
AYSVN	asson
TAYLBRY	tilbury
SVZV	sozo
SAYTJ	sytje
PYL	pil
DAVSVN	dawson
AVALD	ewald
KAPYLA	kapila
NARDY	nardi
DANGYVN	dungeon
SVRAJ	suraj
MAYT	myth
MASKYAS	mascias
DVPALM	depalm
RANA	rana
FAYNLY	finley
BRAYSLAV	berislav
AKYLA	aqila
SANDHV	sandhu
HAPKYNZ	hopkins
LVDVVYKA	ludovica
RVYAL	royal
KARASV	karasu
MARKV	marco
ASKRYV	screve
MKRAYH	macrae
BRYTVN	breton
AVRYVLY	aureole
DANYLV	danilo
DAYBALA	dyballa
SYKVRA	sikora
MAYTAG	maytag
HADSVN	hudson
SAVYR	sauer
NVRDT	nordt
SVAMY	swami
KALPAK	kalpak
SVLVMVN	solomon
AVANZ	evans
GVNZALV	gonzalo
KANBVY	conboy
SANG	sung
DAMVN	damon
TVNG	tung
JAMVNA	jamuna
PVHAN	puhan
AVRAM	avram
DYNA	dina
DANKAN	duncan
AVRBN	orban
JAYARAM	jayaram
VYVA	viva
RAJ	raj
LVSANTVS	losantos
'QYLA	aqila
KVSMAS	cosmas
NAGASAKY	nagasaki
MYTRVVYK	mitrovic
BASYL	basil
JYZAN	jizan
MVD	mod
ARYKSVN	ericson
SVLYTAS	sotilas
JAYAN	jayan
ARDYS	ardis
JVSLYN	joslin
DVRHAM	durham
ANDRYAS	andreas
JAVYD	javed
KATRYNTJH	katryntje
GAJNH	gagne
MAHAJAN	mahajan
RATKS	rutks
TVNG	tung
AVRAYZ	averis
PANAS	panas
MKKARTY	mccarty
AYLVR	aylor
SVA	swa
RABYDYAKS	robideaux
DAYVVN	dauwen
PARSVNZ	parsons
YAYN	iain
ASLAVK	slawek
ABVLYN	abolin
SYPRYANV	sipriano
TVLY	tuli
HAGAN	hagan
KALYSYAK	kalisiak
KVRDAS	kordas
MAY	mai
KASAMA	kasama
DYNT	dint
RAY	rai
DAS	das
KAKY	kaki
TVNY	tony
RVSYALA	rotiala
BAYRTAY	baertie
BALSVN	balson
HAVDVN	hawdon
BYLYNSKY	bilinsky
VAJDYK	vajdic
ASTRYD	astrid
SAKSNA	saxena
AVLY	olli
RAFA	rafa
FRNASYSKAZ	frnaciscus
LYBRYK	librik
GVPALAN	gopalan
SANTV	santo
HAMMANZ	hammans
SASKA	suska
BRANDY	brandi
YAMYNAH	yaminah
FYSK	fisk
DRAVN	drown
BAVDVYYN	baudouin
AKDAG	akdag
HANG	hung
LALYT	lalit
VASYK	wasik
SLYM	slim
BARTVLYNY	bartolini
PVRYNTVN	purinton
FYNSTAD	finstad
LVDVVYKAS	ludovicus
MATA	mata
PYNSVN	pinson
KAMPYVTR	computer
KVMPTVN	compton
AVT	ott
BVSTRAM	bostrom
MARKV	marco
