MYLNVR	milnor
KASAMA	kasama
ASTYNSN	stinson
NAKASVRA	nakasora
JVANYTA	juanita
GRYKV	greco
BVMHARD	bomhard
ANBV	anbu
RAMBV	rambo
ALVAN	alwan
LANGDVN	langdon
PYNYAN	pinyan
KALAHAN	calahan
LYDYA	lydea
LYVYNGSTVN	livingston
FVJY	fuji
TAMAY	tamai
KYNGSTVN	kingston
ANAY	anay
ASTARGS	sturges
SANG	sung
MARKHAM	markham
GVANG	guang
MASKYAS	mascias
ARYN	erin
DYVYS	divis
BRYYTVN	britton
KVAST	kwast
TVYDA	toida
AMARYT	amarit
FRANSYNTYH	francyntie
PAYNY	payne
FYDALGV	fidalgo
ASTARGYL	sturgill
ASPVTYS	seputis
TYRZA	tirza
MANSYL	munsil
ZVRYNK	zurink
BYRA	byra
PATRYSYA	patricia
BRAYS	brice
BRVTY	bruty
AVRKNY	orkney
KAMSKAYA	kamskaya
RASTRAM	rostrom
LAPVTA	laputa
HYVVYT	hewitt
SYTA	sita
SVRYN	sorin
ASTALKH	stolcke
ARBY	orbi
KRYSTAL	crystal
DYVNYDA	dionida
ASKVYVYL	esquivel
ASPYRZ	spears
GANS	gans
JAYN	jain
LVBV	lobo
GVRV	guru
TVRDA	torda
'LYM	alim
GVRAV	gorav
MARGVLYS	margolis
TAKA	taka
MYNA	mina
MKMAHAN	mcmahan
GRYNHAM	grinham
FVY	fui
ASTK	stec
AND	and
BARYAKS	bariaux
VYNZ	winz
MYMY	mime
ARMAND	ormond
LADASKY	ladasky
SYSK	sisk
ASKRYBLYNG	scribbling
BAT	bat
ALAHDVD	alhudud
ANBAR	anbar
PARMAR	parmar
ASTRVSTRAP	stroustrup
MARKSN	marxen
PANAS	panas
VAYD	wide
LYZARDZ	lizards
SYTA	sita
BLVZVM	bloxom
VAYL	vail
DVRYNDA	dorinda
SYN	sin
FADYL	fadil
MAKARAYG	macaraeg
SYANV	siano
KALTVN	colton
KASVN	kasun
NVRDBVRG	nordborg
VALVR	valur
LKS	lax
BARTHVLVMYVS	bartholomeus
ARFANAKYS	orfanakis
RVGVZA	rogoza
MADYS	madis
DVNATV	donato
FRANSYSKA	fransiska
AKMAN	akman
S'YD	said
AYR	air
MYLAM	milam
TYMVR	timur
GYBSVN	gibson
KAMBS	combs
BLASYVS	blasius
HARDYNG	harding
TVBYAS	tobias
GLDASTYYN	goldsteen
ASTYVNSVN	stevenson
BALYT	balit
RVSYALA	rotiala
RYZVY	rizvi
VYLMVT	wilmot
SVLYTAS	sotilas
VARYANTZ	variants
BRAYS	bryce
RAYBLT	rybolt
A'LY	aali
LABKYN	lubkin
YAV	yaw
ANVPAM	anupam
PANYKV	panico
HARPVLD	harpold
FLYMYNG	fleming
HARVHYSA	haruhisa
HVDSVN	hodson
MABAY	mawby
LYNDRVTS	lindroth
RVNALD	ronald
AYVRS	evers
DYVAN	dewan
PALVMBV	palumbo
BARKSDYLY	barksdale
SVSA	susa
RVKAN	rukan
GARSYA	garcia
KYNGSFVRD	kingsford
RYVNSVN	runeson
BAS	bas
KASAT	kasat
ASTAKR	stoker
KVYN	kuin
HAN	han
LYDVYNA	lidwina
VYK	vik
BYPYN	bipin
MYNTVN	minton
RAGATZ	ragatz
LVRJYV	lorgio
FRNASYSKAS	frnaciscus
NABYL	nabil
KRYSSAYNTYH	chrescyntie
YAYN	iain
MAVN	maun
AVRCARD	orchard
GAN	gan
RAFAL	rafal
BVYZY	boisy
YARLA	iarla
DANKV	danco
RYDH	rida
MYLNVR	milnor
LVYYNG	luinge
KYVZVN	quezon
LAM	lam
VYLADVT	viladot
KYVZVN	quezon
HANKH	hanke
GANSVN	gunson
BRYJ	brij
DVRAPT	durupt
KARPLAS	karplus
AYNVN	eynon
BADYN	baden
DAS	das
GANDY	gandy
BLVZVM	bloxom
ANDAMZ	adnams
RYGARD	regard
HANKZ	hanks
BRAVN	brawn
RVHM	rohm
PAYVLTJ	paultje
GRAYYNGR	grainger
KYNT	kint
ASKYPY	skippy
VYRAF	viraf
FYNAN	finan
SASAKY	cacace
AMAL	amal
LVYYZV	loizzo
ASTYVN	steven
DAYAN	dione
SAMZ	sams
AMYKVS	amicus
PASYFYK	pacific
SANZ	sanz
NAVAS	navas
NYD	nid
LABYN	lubin
JVZA	juza
SASTYK	sustik
AJAY	ajay
AHLAND	ohlund
BAYLA	bayla
DVHA	duha
GANYSAN	ganesan
PVLVVYN	polowin
DAV	dov
MAY	mai
GRANT	grant
JANKYNSVN	jenkinson
ALYAS	alias
GRAYYV	grieve
SASKA	suska
SVDAN	sudan
YVRK	york
VYKTVR	victor
AYNGRYSVL	ingresole
KALA	cala
AVTA	otha
RVLDAN	roldan
RASK	rusk
PRAHL	prahl
YYKA	yeka
RADRAMVNY	rudramuni
ASTAD	stude
TVNAR	tonar
ARSY	arce
ARPYN	arpin
MARKHAM	markham
BAND	bond
AVVRDAL	overdal
SYANG	siang
LAV	lau
MANYSKAS	maniskas
DVRAND	durand
HANKZ	hanks
DALYNAR	dolinar
KLYFTVN	clifton
SAYDA	saida
MASKYAS	mascias
MARALY	murali
SYLVA	silva
AVBAJA	obadja
ZARYH	zaria
AYGRTVN	egerton
KASTANV	castano
YAV	yaw
BVNAR	bonar
LYNK	link
AVLSN	olsen
RAHVL	rahul
DYYALA	diyala
BRAYN	brien
DAV	dov
LVMAS	lomas
ASKYPY	skippy
MARLYN	marlin
LALY	laly
YANVVYTZ	yanowitz
AVYS	avis
RVHN	rohn
DVYNYNG	duening
SYLVA	silva
KANAK	kanak
FRAZYYR	frazier
BAVKAM	bawcom
TVSKANV	toscano
KYM	kim
NVDA	noda
LAMBARDV	lombardo
VYJBRAND	wijbrand
BAYDA	bayda
SAKAYV	sakaue
PRANGS	prongs
BYPYN	bipin
MABAY	mawby
LYDYA	lydia
GVYYN	gwynn
TVRKV	turco
MAYZ	mize
MAYR	mire
LVRY	lory
AMY	amy
AVSTRANDR	ostrander
FAYK	fike
KAKYVR	kakure
MARKV	marco
HANKZ	hanks
ADH	ade
SASZY	sasze
