YARVN	yaron
GVYYLYM	gwillim
ANANDA	ananda
JYM	jim
AYTCVN	itchon
KYSVN	cason
LVKAS	lucas
VYND	wind
ASTYPLZ	staples
RABKYN	rabkin
JVNAS	jonas
KVYST	quist
JYSVZ	jesus
HADVBA	hudoba
KRYSVJYN	krisoijn
GRAF	graf
KARL	carl
BLAL	blal
AVHRMN	ohrman
AYNT	aint
KLAYN	kline
LAVZAK	lauzac
AVRBN	orban
AYDVAYSVZ	ludovicus
KAYAK	kayak
BYLYNSKY	bilinsky
BVYRKVYL	boerkoel
DYL	dil
AYRL	earl
TAD	tad
ASPYR	speer
JVRAH	jurah
SAGA	suga
AMVS	amos
BANYTV	bonito
MYLKS	milks
ASYF	asif
DAYR	dayr
FRANSYSYVS	frnaciscus
GAVYND	govind
'LYMA	alima
AYMAN	ayman
MARLA	marla
ANV	anu
LYZARD	lizard
SVR	sor
GVYL	goel
YAMN	yumn
SAGARS	sugars
JAYARAM	jayaram
ARGAN	organ
VAYLDR	wilder
JYNTVN	ginton
SVMA	soma
DYKSN	dixon
NAYLZ	niles
DRAP	drop
TVNGA	tunga
GVLVMB	golomb
KAMALA	kamala
ALVYN	elwyn
DANYS	danis
ANTVNY	antoni
FVJY	fuji
KLATZ	klotz
TYTMAS	titmus
JANG	jung
SAYM	syme
BVSA	busa
BADZYAK	budziak
KVYNTANA	quintana
TYMYAN	timian
GAYMVND	guimond
GALPYN	galpin
LAHYJ	lahij
DAVNYNG	dawning
ABY	ebe
MABANAG	mabanag
DYAMANTARAS	diamantaras
PYL	pil
SVZY	suzy
JYRARDYN	gerardin
KAYRD	caird
PAKALA	pakala
DAHVK	dahuk
MVRLAN	morlan
RVSYALA	rotiala
KLAVDYA	claudia
ASK	ask
AYNGYJD	engaged
BARVA	barua
RVNY	roni
LAMBVRN	lamborn
SANTYK	santic
ASLYV	slave
JAYANT	jayant
ALZ	elz
MANV	manu
ANVVY	envoy
RVSLYN	roslyn
VYVYANH	viviane
MVNTANV	montano
FRANSYSKA	fransiska
KYNGSFVRD	kingsford
KASTA	costa
MKRAYH	macrae
MATVLA	matula
RAFALKV	rafalko
RAVYNDRAN	ravindran
FARAT	furat
BRATYNA	bratina
VARYANTZ	variants
DAVN	down
DVBRYZ	dubris
RYGV	rigo
SYMPLYSYTY	simplicity
DRVR	dror
VAYL	vail
KVAST	kwast
HALTZ	holtz
FARAT	furat
MYLMAN	melman
ANTYLA	antila
TAYLBRY	tilbury
TYV	tio
GVYYLYM	gwillim
ASLVP	slope
DVGAN	dugan
TRVKS	truex
HARRYG	harrig
AMVS	amos
DVNHAM	dunham
BARYAKS	bariaux
DVSTY	dusty
BANDZ	bonds
KVBSA	kobsa
RVNDA	ronda
AYMVN	eamon
LYMYNG	liming
BAKAYA	bakaya
MARYVS	marius
TYTMAS	titmus
VYSKA	visca
LANDRVM	landrum
GRAG	grog
SAVYR	sauer
R'NA	rana
KYNZMAN	kinsman
DYNT	dint
SYTJY	sytje
ANYJMA	enigma
AYSLYK	icelic
KAMSKAYA	kamskaya
ANVN	anon
LYNKVYS	linkous
GVDSVN	godson
PARSVNZ	parsons
PAYK	pike
GVRYK	gorik
DAVSVN	dawson
SANTYK	santic
DVDA	duda
KYAT	kiat
AVRV	orue
ANGLAND	englund
JVDAS	judas
MVNTANARV	montanaro
GVH	goh
GAYDA	gayda
VYLDYNG	wilding
KRAYG	craig
ASKRYBLYNG	scribbling
PVYSL	poisl
SYMYNGTVN	symington
MKRAYH	macrae
HABA	haba
LYVYVY	levavy
PYRARD	pirard
ALYZA	alisa
NVKS	knox
TRAVN	trown
'YN	ain
TAYSN	tyson
AKS	axe
KAPLAN	kaplan
LYTVYN	litvin
JHANG	jhang
KRAYG	kraig
DAVVD	dawud
LYMN	lymn
LATKYNZ	lutkins
KRAVFVRD	crawford
MARGVLYVKS	margulieux
NAZARYTYAN	nazaretian
ASMYD	smead
KAYK	kauk
ADVVART	eduwart
KLAYSVN	claeson
DANALD	danald
KVHN	cohn
MARTYNZ	martens
TAKSBRY	tuxbury
YVRANYM	uranium
ASKAYT	eskite
BALMA	balma
ASKLTVN	skelton
MVGANTY	moganti
MARKVS	marcus
TRYM	trim
BRY	bri
MYKAYL	mikael
HYVNGAN	hiongun
LAL	lal
PVYV	pouw
NYNSTAR	ninstar
HAYVARD	hayward
LAPVTA	laputa
VAFA	wafa
GAS	gus
PALVMBV	palumbo
HAGAN	hagan
LYMBVRG	limburg
HAVVLA	havola
MYTV	mitu
DAGZ	dogs
LVMAS	lomas
BRY	bri
HYYN	hean
SYTA	sita
GRYT	grit
ARBYD	irbid
JVAY	juay
MADYSVN	madison
AKSV	aksu
AGALY	agali
BRVDA	broda
HAV	haw
AKA	aka
DAHVD	dahuk
SANG	sung
SYSLV	sislo
AYM	aim
FARAG	farag
MAHTV	mahto
MADVRAY	madurai
SANTVS	santos
TANYS	tanis
LVATS	loats
KAZVNVZY	kazunori
MAYR	mayr
HAHTAHA	huhtala
KANSTABARYS	constabaris
KYNGFAY	kingfai
ASKP	skep
DANZ	danz
AYSY	ayse
RYBAR	ribar
ASTALKH	stolcke
KVBV	kubo
JHANG	jhang
VYKTVR	victor
PLASTYNV	plastino
KAM	kam
BALYN	balin
MKKAVN	mccown
BKS	bex
LYYVVH	lieuwe
KAY	kai
FVNDAL	fundal
KAYNY	caine
JALA	jala
BAVDVYYN	baudouin
SLYM	slim
ANDRYA	andrea
BYFRAST	bifrost
FAYYZ	fayiz
FARAT	furat
LVKAS	lucas
PYRVZ	piroz
AYSVN	ayson
LVYYNG	luinge
MASKARY	mascari
BVM	bum
DARHAM	durham
BAGDAN	bogdon
TAFTZ	tufts
MANV	manu
YVMVRA	uemura
KNVFYNKH	knufinke
ATA	ota
SASKA	suska
DART	dart
ASLNGZVALD	slangsvold
LVMBARDV	lombardo
SVA	swa
NVRHA	norha
TANG	tong
ATRY	atri
SVNJA	sonja
ABYNA	ebina
