DABYNSVN	dobinson
MANVLY	manoli
HVDAYDAH	hudaydah
ALAPATY	alapati
SAMYT	sumit
LVSYTV	losito
DYVYA	divya
GYVYN	gavin
ASPYRYNG	spearing
MYNTAKVA	mintaqah
KVRNZ	corns
BRAYNKLR	brinkler
TAMATYVS	tomatius
'LYA	alya
LYDYA	lydia
TVYT	toit
NVRY	nuri
LAYL	lyle
SVAMY	swami
AVAN	awan
HYVVYT	hewitt
ASNV	snow
KARDAL	kardal
BALTAKS	baltaxe
ASTNFVRT	stenfort
DVPALM	depalm
VARMA	varma
MANV	manu
PYLVYV	pilvio
SVL	sol
JAN	jan
HARTAH	hurtah
PVRKV	porco
HARKYN	harkin
GAMAL	gamal
AKYLA	aqila
HARTAG	hartog
BYNG	bing
BLASY	blasi
BAVKAM	bawcom
HAMAH	hamah
AMYT	amit
VARGV	vargo
BARYAKS	bariaux
PARMAR	parmar
AYZDY	izadi
PYNTVN	pinton
ALKYNGTVN	elkington
AYDA	aida
SAVAN	sawan
PADVA	padua
ASTYVZ	steves
RASK	rusk
'YN	ain
SVLV	solo
TYMVR	timur
ASKATY	scotty
ASKVRR	scorer
VYLAS	vilas
AMA	ama
KLATZ	klotz
JAYANT	jayant
ASTRYNJR	stringer
SABHANY	subhani
KRYS	kris
HRLAYNDYZ	herlindis
BKS	bex
SANTVS	santos
ASNYL	snail
DARVN	doron
BYSAYV	bissau
TVM	tom
DABVYS	dubois
GNAGY	gnagy
VAYL	vail
MYLAM	milam
AVFYNGTVN	uffington
ASPARNDAM	spaarndam
GRAYYNGR	grainger
DYVYDSVN	davidson
DANZ	danz
MVD	mod
KRAK	kruk
ARBVR	arbur
PLASTYNV	plastino
HYNDRYKA	hendrica
VATKYNZ	watkins
AYSLYK	icelic
RAST	rust
KRYSPYJN	crispijn
DAGZ	dogs
SAMVSKY	samosky
AGATY	agate
TAV	tow
AYLYNG	ayling
FRYTZYVS	fritzius
ARAN	eran
JAMVNA	jamuna
DABYNSVN	dobinson
VYNSVN	vinson
GAT	gat
LADVYG	ladwig
ASMYD	smead
KYV	kao
AFZAL	afzal
NVKV	noko
LYDYA	lydia
HAKABAY	huckaby
RATKS	rutks
RYVDT	ruudt
RYGAN	ragan
BALD	bald
DJAMYLA	djamila
MVRYTA	morita
ALVYN	elwin
FYRMA	firma
ANDAMZ	adnams
RVHAN	rohan
ASLYP	sleep
MARGVLYN	margolin
RAKVN	rukan
MVRNYNG	morning
LVND	lund
MKKAVN	mccown
PVALMA	puelma
NYMTZ	nimtz
AYSKANDR	iskander
HYN	hin
DANKV	danko
AJAY	ajay
BALYN	balin
DYVYDSVN	davidson
BRVYLV	broilo
GRAYYV	grieve
PRYSYNG	pricing
DAMYANV	damiano
MADVRAY	madurai
DVRA	dora
AYSAN	eason
VAYLDR	wilder
PASYFYK	pacific
BVZVVA	bozuwa
GRAF	graf
RAHY	rahi
TALBVYZ	talboys
GASKYNZ	gaskins
MYNKY	minqi
FADVR	fodor
AGBVRN	ogborn
FVY	fui
KATRYNA	katrina
FRAZYYR	frazier
HYLSVN	hilson
TVMATYVS	tomatius
LVRY	lory
LYAM	liam
YAMHA	yamha
TVBYN	tobin
DVNYNY	donini
ASNV	snow
SVNG	sung
GRAYY	graae
VYK	vik
AYNT	aint
DANZ	danz
ANTVNY	antony
TYRZA	tirza
ASTRYNJR	stringer
SVRAJ	suraj
ZALAN	zalan
ARNVT	arnot
ASMA	asma
FRANKVYS	francoys
GALYLA	galila
KVAN	kwan
NAPTVN	napton
PVTYT	petit
MAHA	maha
TVLY	tuli
AVR	ore
AKSV	aksu
BAV	bao
KLAYSVN	clayson
KRYSSAYNTYH	chrescyntie
JVANG	juang
KVYL	coil
LAN	lon
HABA	haba
NAYKVLAS	nicolaes
MAGVAYR	maguire
TAHRYHA	tahirah
ARNH	arne
BRVYN	bruyn
KNVB	knob
VYND	wind
DAHAK	dahuk
DVHA	duha
RAV	rov
BRYAN	bryan
MASAHYRV	masahiro
NARLA	narla
BYFRAST	bifrost
KATLYR	cutler
ASTYSY	stacey
LANDYS	landis
PARDYNGTVN	pardington
BATRA	batra
MATANA	matana
PYNA	pina
KVJYAS	kogias
SYDVR	sidor
VVN	wun
GYBVR	gabor
KALSYN	calsyn
MVNK	monk
AVDRA	audra
ASPLYD	spleid
SYMPLYSYTY	simplicity
HYN	hin
BAPTYST	baptist
LVYD	loyd
SYMYNG	siming
GYFT	gift
MVK	mok
LAYVY	liewe
RVBYNSVN	robinson
VALDRAM	waldram
KVSKYMAKY	koskimaki
LAV	law
FABYANV	fabiano
ASKVLYNG	scowling
DABAS	dubuc
BALD	bald
KALYSYAK	kalisiak
HAHTAHA	huhtala
NAZARYTYAN	nazaretian
JAMVNA	jamuna
RAM	ram
DVMBA	domba
KANRVY	conroy
KRYSVYJN	krisoijn
JYM	jim
KAYA	kaya
RASV	rasu
LVPATKYN	lupatkin
DAGAN	dugan
HABA	haba
ASTNFVRT	stenfort
ALKS	alex
DYMYTRYV	demetrio
DYAB	diab
MATSVMVTV	matsumoto
RAN	ron
BYAN	bian
BAVDVYYN	baudouin
RVYS	ruiz
RYHANH	rihana
MAYZ	mize
ANTARAMYAN	antaramian
MVGANTY	moganti
GRANDASTRVM	grundstroem
JVDY	judy
AKYL	aqil
RVBYNSVN	robinson
SYLVYA	silvia
ALYNGTVN	alington
KASAT	kasat
BVSTRVM	bostrom
KASPRZAK	kasprzak
HVRYV	horio
LYVYVY	levavy
ASTVART	stewart
ANYART	enyart
PAGLYA	paglia
ASTYVN	steven
HAYZ	hise
MADYS	madis
BYLYNSKY	bilinsky
PYATJY	pietje
NYVMAN	neuman
ASKLTVN	skelton
BYANGTAY	byungtae
MVRAVAN	moravan
KATVPYS	katopis
VYVYK	vivek
AYMVN	eamon
HARYV	horio
ALVYN	elwin
DYVYD	david
KALTVN	colton
VYNSVN	vinson
BYATLYNG	beutling
ALVARVS	alvarus
AMPTH	ampte
TALBVYZ	talboys
KATVALA	katwala
LAGVMVRVF	lagomorph
GVRVSAMY	gurusamy
SVRANA	surana
ANATVLY	anatoly
