BASMA	basma
KAVYTA	kavita
HYNZ	hinz
ADKYNZ	adkins
DVNYNY	donini
AND	and
MATAKV	matako
ASTVARD	steward
BVAY	buay
JASTJY	justje
ASLYMAN	slimane
VAYZ	wise
VYLKYNSVN	wilkinson
ARVAL	orval
KARMVDY	carmody
VLADAN	vladan
TAYLBRY	tilbury
GRAV	grau
RYTA	rita
SANK	sunk
VYGSTVN	wigston
AMVRY	amory
DVRAPT	durupt
GADBVYS	gadbois
MARTYJN	martijn
RVYZ	ruiz
YVNGSAP	yongsup
AKYTVMV	akitomo
GVH	goh
PLYSKYN	pliskin
ZVVAYTA	zuvieta
AVLY	olli
RVNDA	ronda
PAYK	pike
JYGANG	jigang
RAVYNDRAN	ravindran
SYKVRA	sikora
NAVYA	navia
AVALD	ewald
ABYAB	abiab
VYGTVN	wigton
DVLMAN	dolman
MYTV	mitu
ALYVT	eliot
MADYS	madis
LYVYVS	livius
ASTVART	stewart
ANAS	anas
MVBAY	mawby
KRYSTYJNTJH	kristijntje
GALY	gali
BANGARTZ	bongarts
BYKSLR	bixler
FVRSAYT	forsyth
LYNDZ	lynds
KYNARD	kinard
SYANG	siang
GADYL	gadil
DAVNYNG	dawning
AMARAL	amaral
KAVS	kaos
ANTRYKYN	entrikin
HADVBA	hudoba
PVRKV	porco
JVANA	juana
DAVSVN	dawson
SKARP	scarp
SANDMAN	sandman
ASTYRN	stearn
KALHYNH	culhane
AVMGA	omega
DVYNYNG	duening
ASTVRY	storey
AYNDAYRSN	indiresan
BRANDY	brandi
RADVA	radwa
GARSYA	garcia
TVLYV	tulio
KARBALA	karbala
PYZVLYTV	pizolato
KAMPAGNA	campagna
ANALVG	analog
HYVKYNZ	hawkins
DYAMANTARAS	diamantaras
TAMAS	tamas
BVNYN	bonin
ASTRLYNG	stirling
RAFYKYV	rafique
AND	and
PLASTYNV	plastino
ALSVN	olson
'DYL	adil
KASVN	kasun
JYGANG	jigang
SVKVMAR	sukumar
MAYRZ	myers
LVRY	lori
BAJYK	bajic
LAMBARD	lombard
ARMSTRANG	armstrong
NYVKVYST	newquist
SASKA	suska
KVRTH	korte
KYTAMVRA	kitamura
DVRAND	durand
MVNTVYA	montoya
FAVAZ	fawaz
MAYSAL	missal
VYBVVV	wibowo
DVNATV	donato
HANSVN	hanson
BARTHVLVMYVS	bartholomeus
PYRAN	piran
KNVB	knob
KANDY	kandi
MAR	mar
BALD	bald
HYYN	hean
RVNDH	ronde
SYMVNH	simone
JAMVNA	jamuna
HAKSL	haxel
ASTYVN	steven
NYD	nid
BAZBY	buzby
PARTVN	parton
DAYVVN	dauwen
JYNAKYRAMAN	janakiraman
SYVA	siva
HAPSVN	hopson
MYKVLYK	mikolic
TVNY	tony
SYNKLAYR	sinclair
LAL	lal
DADGYVN	dudgeon
PVMA	puma
HARYNKAR	harincar
MYAV	miao
HRLAYNDYZ	herlindis
KANYG	konig
RALF	ralf
FVLKANYS	fulconis
AMPSVN	empson
VYKRAM	vikram
ASKV	osku
BYRNH	byrne
AYRYK	eirik
AYM	aim
PVALMA	puelma
ARKTYKY	arktiki
VAYLDR	wilder
VARMA	varma
JVHANY	juhani
KVMPTVN	compton
RAYBLT	rybolt
MYSA	mesa
BALTAYS	baltais
RVSTAD	rostad
VAN	wan
HYJDAN	higdon
GVDSVN	godson
PARDY	pardi
KARHART	carhart
LALY	laly
NYKVLAS	nicolas
PANT	pant
RVSANA	rosana
LABKYN	lubkin
MVRLAN	morlan
MAK	mak
VYNSN	wincn
HANY	hani
NAKAGAKY	nakagaki
GAT	gat
GVLVMB	golomb
KAV	cao
AYNMN	inman
AYSAK	isacq
KRYSSAYNTYH	chrescyntie
SVHM	sohm
LATKYNZ	lutkins
PAYTVN	payton
SYMVNH	simone
LVDVRF	ludorf
SAGARS	sugars
GYLYTA	geleta
PYPVNY	piponi
JAN	jan
GVRAV	gorav
FRYTZYVS	fritzius
HADYL	hadil
MVNTA	monta
TYRZA	tirza
LVRJYV	lorgio
DYKSVN	dixson
GVRAL	gural
VAYNTH	wyntje
SASTYK	sustik
LAVYGNH	lavigne
DABSVN	dobson
MARTYZN	martijn
KAMAMA	camama
VYVYAN	vivian
RADVA	radwa
SVRVALY	sorvali
BANYTA	bonita
JAKVBZ	jacobs
PAYVLTJ	paultje
NARLA	narla
YAP	yap
AYS	ice
KYNGFAY	kingfai
KLANTVN	clanton
YASYRAH	yasirah
JVDAS	judas
BASKAR	baskar
TAYLV	thilo
ASTRYM	stream
TVLA	tula
DYVAR	dewar
PAKVAT	paquet
ALAYS	elyse
ARYKA	erika
KALHYNH	culhane
DVLAN	dolan
RYHANA	rihana
HRNSBAY	hornsby
ARLYNDH	arlidge
BLAL	blal
DAYVVN	dauwen
SYTLAYV	cittlau
GALYLA	galila
GVRYK	gorik
VYKLVND	wiklund
KAMPAR	kompar
DAMYAN	damian
KALYA	kalia
SAFT	soft
'LYM	alim
KARNYA	carina
ARYA	arya
'FYF	afif
BLAHA	blaha
LYNDGARD	lindgard
AYSTMAS	isthmus
DAK	duk
FAVST	faust
PALFVRD	pulford
ALMVMAN	elmoman
KANTH	conte
RANA	rana
PAN	pan
DVBAY	dubay
ABRAPT	abrupt
SVBVTKA	sobotka
AVYNZ	ewins
ASTYN	stian
LAYVLY	lively
ABRAPT	abrupt
AMYT	amit
KRVM	crom
BLANZDVN	blunsdon
AGRAVALA	agrawala
LYSVN	lison
GRYT	grit
LYANG	liang
RANY	rony
BVSTAK	bostak
ASKYN	skean
AYNTJH	eyntje
KVYYNTVN	quainton
YVRK	york
BYR	bir
ASTYD	stead
RADHA	radha
RVKAN	rukan
FRANSYNTAY	francyntie
KVSVGH	kosuge
HARALD	harald
ADMVNDS	edmonds
HAVKYN	hawkin
HARMANVS	harmanus
LVZANV	lozano
VYJNAND	wijnand
ARYKA	erika
PRASANA	prasana
NAGASYVA	nagasiva
ASPYR	speer
KANG	cong
KRYSP	crisp
ASLATR	slater
'YN	ain
HARALD	harald
PAYTR	pitre
AMY	amy
LAYMAK	limace
TYMBVL	timbol
AYNG	inge
FYNK	fink
FVLKANYS	fulconis
