NYGRA	nigra
GVSTAVVS	gustavus
FYDVR	fedor
TYMYAN	timian
SVNDARAM	sundaram
SATKAS	sutkus
MARGVLYVKS	margulieux
AMPSVN	empson
MARLYN	marlin
BVNAR	bonar
GVRALAVALA	goralwalla
FVTYNVS	fotinos
KARNYA	carina
PAVLYK	pavlik
ARGAN	organ
AYS	ice
MARKSN	marxen
KVANRADVS	coenradus
KAMHVLZ	kamholz
LAMPY	lampi
TRVMBV	trumbo
BAJYK	bajic
SVNJA	sonja
AGYL	aqil
ARYK	erik
ASKVLY	scully
TAYRAY	tierie
ASTRYNGR	stringer
SYLVAN	sylvan
ASTAFVRD	stafford
TVRDA	torda
FARKAS	farkas
APVNTH	aponte
GVY	gui
SYRVYZ	sirois
MKMAHAN	mcmahan
SYMVNH	simone
ASPYN	spine
PRVMVNTVRY	promontory
HARATZ	haratz
DYMARS	demars
NYYVTN	newton
AYLKA	ilkka
HAPKARFT	hopcraft
NARLA	narla
KLAZVRA	klazura
KARPLAS	karplus
MYLVT	milut
VYGSTVN	wigston
BABA	baba
LAYVRYTSN	lauritsen
SAN	son
LKS	lax
ANVJYT	anujit
HYSLAP	hyslop
BAYARD	bayard
ASTAG	stagg
HARVARD	harvard
SASLAV	saslav
JAKVBY	jacoby
ADMVNDS	edmonds
RADRAMVNY	rudramuni
BVYZY	boisy
BLVM	blum
GARYTV	garito
FARYHA	fariha
MKDVNALD	mcdonald
ARNH	arne
KART	kurt
DVRAPT	durupt
VYMAL	vimal
PAPAY	papay
RVSANA	rosana
DAG	dag
GYPJH	gepje
LVRA	lora
BRYVNY	bryony
FAYRVZ	fairuz
LANDYS	landis
VYRYANA	wiryana
PVRTNVY	portnoy
TAHARA	tahara
AYNGMAR	ingemar
LVBYN	lubin
BRY	bri
DYSANTV	desanto
ASTYVZ	steves
HALY	hale
GATLYN	gatlin
KAYRD	caird
KLAG	klug
AMY	amy
TRYM	trim
VYMAL	vimal
GADBVYS	gadbois
VYMPJH	wimpje
LYDYA	lydea
LANG	long
KVYRYN	querin
ALYA	alya
PVYNTYNG	poynting
VLADAN	vladan
AMA	ama
YARLA	iarla
ALDZ	olds
YANG	yang
LARVKVYH	larocque
DAYVYN	divine
NABYL	nabil
KRANSVYYK	cranswick
BYNG	bing
RAVYRAJ	raviraj
AYRYZARY	irizarry
ANVPAM	anupam
ZAKY	zaki
JAKVBSVN	jacobson
KAYA	kaya
SAYVYR	sawyer
MVNK	monk
KASTRV	castro
ASTARKY	starkey
HVAR	hoar
VAST	wust
MANV	manu
'ADL	adel
GAYMVND	guimond
AVRN	orne
LVNAV	lunau
BRVHL	brohl
JANG	jong
AVBYD	ubaid
RVYZ	ruiz
ALTZ	oltz
AYNMN	inman
MAYRS	myers
DAVNYNG	downing
BRVANHAT	braunhut
SVSA	susa
DARVN	doron
RAVDA	radwa
JVRAH	jurah
ALAYN	alain
ASKLTVN	skelton
ADAM	adam
DYVYLDH	dewilde
MAYV	mayo
FYGVRA	figura
AMYRA	amira
LYND	lind
PRAHL	prahl
HASAKAH	hasakah
KYLG	kilg
SVLD	sold
AVLSN	olson
AGYLA	aqila
HARYV	horio
ZVRYNK	zurink
VYLDYNG	wilding
AVYRSA	aversa
ANBV	anbu
KVL	col
SYKVRA	sikora
BYLYNGASLAY	billingsley
GVADA	gouda
KYVNG	cuong
TAPYV	tapio
PRABST	probst
MATSVDA	matsuda
AYGLV	igloo
ALVF	elof
DVBVYS	dubois
ATKYNZ	atkins
RABYV	rubio
GVYYLYM	gwillim
PVRKV	porco
AYVJNH	eugene
BAPTYSTA	baptista
DVY	doi
DAVN	down
RASPYNY	ruspini
BAYRN	byrne
BLVNSDVM	blunsdon
ALKSY	alexy
ASKALY	scally
KALBYDA	kulbida
LYVNZ	lions
HYRVTA	hirota
ASTNKAMB	stancomb
SVR	sor
PVLYS	polis
VYNSN	wincn
NVLF	nolf
AVCZ	ochs
GVNNA	gonna
PYNTVN	pinton
MVNRV	munro
MARZ	marz
AFAF	afaf
PATRYK	patric
DART	dart
LVDVVYKA	ludovica
HYRVTA	hirota
AYNTJH	eyntje
VATV	vato
MARTYNZ	martins
KAV	kao
PYZVLYTV	pizolato
JAGV	jago
HYTSVN	hitson
MANDA	manda
DANAVAN	donovan
SAYKS	sikes
DVRAPT	durupt
LVTZ	lutz
FATYS	fotis
KATALANV	catalano
MAV	maw
VYVKS	vieux
RABYN	rubin
MANDA	manda
MAK	mak
RAYLY	raile
KAKY	kaki
DYVYDYAN	davidian
ASFAR	sphar
MARY	mary
BRVZ	broz
FLYMYNG	fleming
PVKVRNY	pokorny
KAYNY	caine
KARYDA	karida
VYNSVN	vinson
ALM	alm
FLYKS	felix
AKS	axe
AYSYZAKY	ishizaki
FVJY	fuji
PYVN	pion
RYNG	ring
GVRV	guru
LYND	lind
MARANY	marani
ASTAMPR	stamper
VYRYANA	wiryana
MANYKS	mannix
HAYZ	hise
FYLYAS	filias
AVADYA	awadia
HALAN	hulan
AVSBVRN	osborne
AVTVLYNY	ottolini
SALVMVN	solomon
LATZ	lutz
SAMGYN	sumgin
BDYRA	bdira
KVASYM	quasim
RAMY	rami
TVNGA	tunga
MYTVN	maton
BYKVN	bacon
KRVPYK	kropik
LAHYJ	lahij
TARYK	tariq
PVLGAR	pulgar
PYNZ	pins
SASZH	sasze
KARDAL	kardal
SAYM	syme
SAMYT	sumit
BARTVNYKV	bartonico
GYFT	gift
BVRM	borm
S'YDH	saida
PRAHL	prahl
FAYK	fike
BYSAYV	bissau
MYLNVR	milnor
KVAAYNTN	quainton
KARAN	karan
ZHRA	zara
HAMY	hami
KAYNY	caine
ALKSANDRVZ	alexandros
SVHAS	suhas
MADYGAN	madigan
ADYT	adit
KRYSTA	krista
MVRNYNG	morning
NAPVLYTANV	napolitano
SYMPLYSYTY	simplicity
SAMANTA	sumanth
KARA	kara
NAGASYVA	nagasiva
DRAP	drop
ZYL	zyl
BVNYTZ	bonitz
FANGVS	fungus
VYDAD	widad
MADVRAY	madurai
LVDVVYKAS	ludovicus
KVTZ	kutz
LYVNARDV	leonardo
FAYF	fife
BARKASFYLD	barksfield
KALBYDA	kulbida
YAGLA	yagla
ADVARD	edvard
DYNA	dina
ARBY	orbi
VAYA	vaya
AVLY	olli
BALHAM	balham
LYMYNG	liming
AYRVN	aaron
KASTVRY	kasturi
ANGLAND	englund
JVBAL	jubal
PVGA	puga
RVLDAN	roldan
KVKAL	kokal
PANDYT	pandit
RYTYSGRT	ritsgert
MAYLN	milne
BALSVN	balson
VYLA	vila
HARKYNZ	harkins
SVTV	soto
AVRAM	avram
DAMYNY	dominy
MYNAMV	minamo
VYVLA	viola
ZVRYNK	zurink
MVRAY	moray
ALMYNTAKAH	almintaqah
KARTY	karty
ASTYVNSVN	stevenson
DVNG	dong
RAMVLVS	romulus
HAJYR	hagir
SVAMY	swamy
GVPTA	gupta
GAV	gao
DANGYVN	dungeon
MYMY	mime
KAYA	kaya
GLATZ	glatz
SYLK	silk
MARGVLYVKS	margulieux
MAK	mak
NYYVTN	newton
SVLYS	solis
BLASK	blask
DVBVYS	dubois
MVGANTY	moganti
PANJABY	punjabi
BRY	bri
MVNKAR	moncur
AFZAL	afzal
AMADVR	amador
MVMFVRD	mumford
AVN	aun
SVAMY	swamy
MARTYJNTJH	martijntje
BARY	bari
HAVVLA	havola
BVYKV	boyko
KAMPAGNA	campagna
ASLYMAN	slimane
BRAHYM	brahim
FADYLA	fadila
AVYNG	ewing
KRYSSAYNTYH	chrescyntie
DRAYNH	draine
JYNTVN	ginton
DAYVYN	divine
DANG	dong
MKGVYRK	mcguirk
KVYRYN	querin
GYNKZ	genks
JAKVBZ	jacobs
FARAG	farag
KANTARA	cantara
PAVV	pouw
LADYVYL	ladeuil
ARTYZ	ortiz
AVTV	otto
SYLVA	silva
PYLAZV	peloso
KVANLAN	quinlan
DAYR	dayr
HANKH	hanke
AYRLAYNZ	airlines
MARSY	marcy
ANASTASYA	anastacia
KYNT	kint
TRAYNTH	tryntje
LYNDAL	lindal
R'NA	rana
FAYF	fife
GARMZ	garms
KYM	kim
DVRYS	doris
ALYSYA	alicia
DANKV	danco
KVRBYN	corbin
BRAYN	brien
LYPKYN	lipkin
HANTYNGTVN	huntington
LAYL	lyle
BASYLYVS	basilius
DANZ	danz
KRYYK	creek
PLASTYNV	plastino
VYKTYM	victim
AVRLYNZ	orleans
FAGANS	fagans
ALFARV	alfaro
AMAND	amand
FALKV	falco
AYGRTVN	egerton
AYRLAYNZ	airlines
FLYVRY	fleury
HALTZ	holtz
BARKVLV	barculo
RYMVN	rymon
KARVYN	karwin
RYM	rim
AKYLA	aqila
ASPYR	speer
BYFRAST	bifrost
RYBAR	ribar
DNVKS	denux
ANAZ	anas
TVBVTYS	tubutis
KYAT	kiat
AVRM	orem
STRATVN	straton
ADVVART	eduwart
JAKVMYNTYH	jacomyntie
ANDRYA	andrea
AYMVN	eamon
LASKA	laska
BAT	bat
KVDAMAH	qudamah
ASKVLY	ascoly
FAGANS	fagans
DAVSAN	dawson
GAV	gao
GARTYN	gartin
HARMZ	harms
ALSVN	olson
ANANT	anant
HAVKYNZ	hawkins
ABH	abe
GVDATA	gudata
ALMV	elmo
KAMPVS	campos
SVR	sor
VATKYNZ	watkins
TALYBAH	talibah
AYMAN	ayman
BARKVLV	barculo
DAY	day
KAZVHYRV	kazuhiro
DNVKS	denux
MARALY	murali
NAHAM	nahum
ALMYNTAKVA	almintaqah
DYVYLDH	dewilde
PARKYN	parkin
AVGVSTV	augusto
GRAD	grad
LAMPY	lampi
LVTYNZ	lutins
ASVALD	oswald
TVFTH	tufte
LVRTVN	lorton
ASTABRT	stobert
TAYRAY	tierie
VADAPARTY	vadaparty
BYNVY	binoy
VAN	wan
SANJAY	sanjay
ANSAR	anwar
SVRK	sorc
SYRVS	cyrus
MASNA	masna
TAY	tye
VYNSN	wincn
MVK	mok
SABHANY	subhani
SYMS	sims
VAJDYK	vajdic
MVNK	monk
RVSTAD	rostad
MARGVLYN	margolin
MANSYL	munsil
RAHVL	rahul
TALBVYZ	talboys
BAD	bud
ASMYD	smead
HYVNGAN	hiongun
SALMY	salmi
APLYN	aplin
KVHAN	cohan
JYRARDYN	gerardin
HARKYN	harkin
GASLYNG	gosling
DVRA	dora
RASPYNY	ruspini
GRAV	grov
LYSKANV	liscano
AYR	air
ALFVRD	elford
SAKAMVTV	sakamoto
ASPYRZ	spiers
KAPYLA	kapila
RAKYKVT	racicot
DANA	dana
LAMBDA	lambda
AGALY	agali
MAVN	maun
ALRVY	elroy
FAYRVZ	fairuz
NAPTVN	napton
VLADAN	vladan
KYSLV	kislo
AMVRY	amory
BALSAM	balsam
NVKV	noko
VYKLVND	wiklund
MVD	mod
KVYL	coil
SVZV	sozo
MAMFVRD	mumford
AYS	ace
SAHASY	sahasi
BYPYN	bipin
ALFVRD	alford
VYKTYM	victim
MAMA	mama
ASKY	skee
BANDZ	bonds
SYMAL	cemal
FVLKANYS	fulconis
SVDYPTV	sudipto
BYLHAR	bilhar
GRASKYN	gruskin
PYVRYNTN	purinton
ALSVP	alsop
SVLTAN	sultan
DAPAY	dupuy
VYLASKV	velasco
BRVZ	broz
DRAYNH	draine
LAY	lye
LYNK	link
KRYSTA	krista
KAVDLYNG	quodling
HYND	hind
DASYVK	doseok
KAMBS	combs
ASPVSTA	spousta
MAYR	mire
ATARAS	ataras
FAYZA	faiza
KARP	karp
JVAN	juan
AGVSTYNY	agostini
AVRKNY	orkney
MAHA	maha
HAYNLY	hinely
DRYDJY	dridge
FYNK	fink
APSYLVN	epsilon
LYVYNGSTVN	livingston
SYVA	siva
HYRVTA	hirota
BYZVAS	biswas
BVZKART	bozkurt
KAMB	kamb
TAPLYN	taplin
MADYGAN	madigan
VAH	wah
MYR	mir
LYTVYN	litvin
MARVAHA	marwaha
NAKAGAKY	nakagaki
NVRDBVRG	nordborg
MKGAVYN	mcgavin
DYMYTRY	dimitri
MARKVS	marcus
AYNDAYRSN	indiresan
RVHM	rohm
KARVYN	karwin
MABAY	mawby
KVSTA	kosta
DANG	dong
MYNGV	mingo
VADAPARTY	vadaparty
KRASBY	crosby
SVLAR	solar
ZARYA	zaria
AVBRHVLZ	oberholz
KRVG	krug
SRAYNH	shryne
TATARY	tatari
BAKAYA	bakaya
NVNYS	nunis
AVBR	ober
ATKYNZ	etkins
LAYMAK	limace
ARGAR	orgar
DABYNZ	dobyns
JVNYN	jonin
BRYSBYN	brisbin
BVDRA	budur
KARHART	carhart
TYNA	tina
SADYKVYH	saddique
ALYA	elia
HVGAN	hogan
PRYYVTY	priotti
DANG	dong
BYANGTAY	byungtae
RAZDAN	razdan
VALDRAM	waldram
DALYNAR	dolinar
BALD	bald
ASPYTZR	spitzer
ZAYRA	zaira
BLASK	blask
LALKYN	lulkin
DYKAVTY	decouty
AVKYNZ	oakins
GVVDYNG	gooding
DARVN	doron
AVAN	awan
ANYART	enyart
TAPYV	tapio
SYRAFYN	serafin
JVAY	juay
BAZBY	buzby
KAMBZ	combs
BYNVY	binoy
VALKA	walka
RAYDN	ryden
KYNYVN	kinyon
TAGLV	tuglu
KANYTZ	cunitz
APVNTH	aponte
RAMYRV	ramiro
LYBRYK	librik
VYZBRAND	wijbrand
AMA	ama
ANVVY	envoy
LYSTVN	liston
GAY	guy
HARDYSVN	hardison
ALBAHAH	albahah
TYMVNYN	timonin
SVANK	swank
ALMKVAST	elmquist
PRANAV	pranav
ARMAND	ormond
NYKVLAS	nicolas
VYGSTVN	wigston
BAYRTYH	baertie
TVYYG	twigg
PVRANYK	puranik
RVSYALA	rotiala
ADNAMZ	adnams
RADHYKA	radhika
TAMARA	tomura
SYANG	siang
RADHYKA	radhika
BLAVADNYK	blavatnik
GVDRAN	gudrun
NVYA	noya
MADAKS	maddux
SAYTZ	sites
VYLKYNZ	wilkins
ASTRYNJR	stringer
PYNZ	pins
LYMYNG	liming
HAHTAHA	huhtala
ANTRAPY	entropy
KAVDLYNG	quodling
KVAYNTVN	quainton
ADNAMZ	adnams
GVRAV	gorav
HARDYSVN	hardison
ALVYN	alwyn
KVGVMA	kogoma
BYTZ	bitz
FVRDHAM	fordham
BATRA	batra
ARYN	erin
MAYR	myer
TRAYNTZ	tryntje
BANKRAFT	bancroft
HALTZ	holtz
BVNGARD	bongard
NYDAL	nidal
AKYLAH	akilah
BKS	bex
LYZA	lisa
BARTVNYKV	bartonico
YASYRAH	yasirah
MARY	mary
VYDAL	vidal
GVYYN	gwynn
LVSANTVS	losantos
BYRA	byra
NADYG	nadig
BRAN	bran
PANDVLFYNV	pandolfino
PANFYL	panfil
RVSALYN	rosalyn
RAZDAN	razdan
BABA	baba
AYFJ	ifje
LAYHV	laiho
BALBYR	balbir
PARTVN	parton
ASKAVN	skaven
TAD	tad
HVRN	horn
DVRAZYV	dorazio
MVNTAGV	montagu
BVSTRVM	bostrom
BARNABY	barnaby
ALKAN	elkan
AKSFRD	axford
HAJ	haj
RAVT	rout
ARVYNG	irving
BYAVYS	beavis
MYNARYK	minarik
RAYMVND	raymond
KAMPVS	campos
PRATVL	pratul
GABARA	gabara
ANRYK	enric
AVLY	olli
LYLA	lila
ALTZ	oltz
ASTYSY	stacey
KAGBVRN	cogburn
DVLAN	dolan
AYSLT	iselt
ALVKAL	alukal
HYND	hind
RAVDAH	rawdah
KASTRYKVM	castricum
KVYRYN	querin
ANZALVNY	anzalone
AMBAR	embar
RASV	rasu
AYRLAYNZ	airlines
RAVYRAJ	raviraj
HAYNGH	hainge
KALYARV	caliaro
DVRA	dora
ASTYRNZ	stearns
LANTZ	luntz
SYSK	sisk
AYNC	inch
SAYTV	saito
BLVZVM	bloxom
ASTYGBRG	stigberg
MVRTVN	morton
AYNANA	inanna
KARLYN	carlin
TAKV	taco
SVRK	sorc
LYBRYK	librik
ARSKAYN	erskine
RABYJN	robijn
KARASV	karasu
ARAYZ	aries
VANG	vang
TALBVYZ	talboys
MARYN	marin
KYN	kin
BYTZ	bitz
PRYSTVN	preston
YVFYNGTVN	uffington
MVNK	monk
MAYR	mayr
JASTYH	justje
ALSVN	elson
SATKAS	sutkus
ZVRYSYKA	jurisica
JYVVYL	jewell
LASTRY	lustri
FARYHA	fariha
PAKVAT	paquet
MARYNV	marino
TYV	tio
