DVGAN	dogan
ASTYL	still
MYLVARD	milward
HANYFA	hanifa
GYVVN	givon
KANTARA	cantara
MANK	monk
AYNGLYS	english
SAMVYL	samuel
RVBVZ	roboz
LAYMAK	limace
NYKVLA	nicola
LASKARY	lascari
ASLYP	sleep
PAY	pai
SVNA	suna
RYDA	rida
DABVYS	dubois
MVRAY	moray
BLYNKV	blinco
SANTA	santa
YAP	yap
ANAGRAM	anagram
JAVYD	javed
ASLVMN	sloman
SYSK	sisk
HARVARD	harvard
BARKAY	barkai
BRVHL	brohl
MADVN	madon
DVDA	duda
GANG	gang
AYLVR	aylor
LATZ	lutz
LYKYVRY	liquori
VAYLDR	wilder
HABA	haba
BABA	baba
KVNV	kono
ASKVLYN	scullin
AVZBRN	osburn
ADMVNDS	edmonds
AVBRTAS	obertas
KATY	kati
VYNATA	vinata
VAYA	vaya
HRLAYNDYZ	herlindis
RVBY	roby
SVKVL	sokol
HAFS	hafs
ADYT	adit
TVNGA	tunga
KVRY	kory
ASMA	asma
PYNKY	pinky
MAYSAL	missal
AVBR	ober
YASYN	yasin
LKS	lax
ASTYVZ	steves
GANTRAM	guntram
RVSANA	rosana
HAVVLA	havola
ARSKAYN	erskine
R'NA	rana
LYRYKAL	lyrical
ANAS	anas
NAKAGAKY	nakagaki
NYVARK	newark
AMYR	emyr
DAMYAN	damian
KVRP	korp
ABYAD	abiad
ASKVRR	scorer
ASPANGLR	spangler
KAVLYNG	cowling
'RBYL	arbil
MANYSKAS	maniskas
BLANSDAN	blunsdon
MYMY	mime
LVMBARDV	lombardo
ABHAY	abhay
ARBYD	irbid
HANT	hunt
SYNK	sync
VYLADVT	viladot
HAGAN	hagan
DVGAN	dugan
FALSAM	folsom
SVL	sol
LYSTVN	liston
SVRYN	sorin
BVD	bud
MVGANTY	moganti
TVMANY	tomany
NVTZ	notz
GVH	goh
SAKSYM	saxnem
TAYSN	tyson
MVNTAGV	montagu
KATALANV	catalano
KVYRYN	querin
GAYNVR	gainor
KVAYMAN	coeyman
KANG	cong
AMYT	emit
ASNL	snel
ALMAS	almas
KAPANGA	kapanga
HAMY	hami
DVNYNY	donini
ASTDYNA	stedina
AMY	amy
AKLVF	eklof
MAYRS	myers
GVRYK	gorik
ASTRYDM	strydom
ADMYSTVN	edmiston
MKGVYRK	mcguirk
NYNVYS	ninoys
ANAYLYN	anilane
ALAYN	alain
PRYYVTY	priotti
BRYGVY	bryguy
LARVKVYH	larocque
PAYVLTJ	paultje
BALTAKS	baltaxe
DYAMVND	diamond
GANAVAN	gunawan
HASBY	husby
GRAFT	graft
AYLYN	ileen
PAPAY	papay
YASYRAH	yasirah
PARMAR	parmar
DABVYS	dubois
AMNA	amna
GAYMVND	guimond
AVYRSA	aversa
GRAFT	graft
DYL	dil
HVRYNG	hornig
AYLVARD	aylward
KAMDAR	kamdar
PABLV	pablo
BYNVY	binoy
LYVN	leon
NYKALAS	nicolas
ASPR	spur
MYSTRY	mistry
KYKVMA	kikuma
RYTYSGRT	ritsgert
AVYRSA	aversa
KARL	carl
KVYNT	quint
ALF	alf
KVANRADVS	coenradus
YVMN	yumn
MATAKV	matako
ASKV	osku
SANTV	santo
VYNTJY	wyntje
TALBVYZ	talboys
AYNGYJD	engaged
FARAG	farag
VAYD	wide
MYSRA	misra
KARABVLVT	karabulut
BARY	bari
FARAGV	farago
TRANYTSA	turnitsa
KRAYDR	crider
MATLV	mutlu
SYRVYZ	sirois
VARGAS	vargas
FRYTS	frits
DVNHAM	dunham
HAFS	hafs
DVBVYS	dubois
HARMZ	harms
PYZVLYTV	pizolato
JALA	jala
HAYVKZ	hawkes
ABA	aba
DVRYNDA	dorinda
PYYK	peak
MARYANA	mariano
GATZ	gatz
VYKTYM	victim
DADA	dada
ALFVRD	alford
'QYL	aqil
HARVARD	harvard
ATKYNZ	atkins
AFZAL	afzal
HVGARTY	hogarty
MANSYL	munsil
TVNGA	tunga
HAFSAH	hafsah
HAMAH	hamah
AVGVR	augor
MYZYRA	mizera
MVRLAN	morlan
AMANV	amano
ASKVLYNG	scowling
LVSYTV	losito
FVRLANG	furlong
LVTZ	lutz
ANYJMA	enigma
GATZ	gatz
RANA	rana
MAYNR	miner
'BDAL'ZYZ	abdulaziz
AYALA	ayala
ANSYH	anisa
HAHTAHA	huhtala
GADBVYS	gadbois
SVDARMV	sudarmo
KASTY	casti
AYDYD	aidid
GAJNH	gagne
VYMAL	vimal
ARMAND	ormond
MYLVARD	milward
KLAYN	kline
KVMVRYTA	komorita
LVSYTV	losito
DAKLVZ	ducloz
LANDRVM	landrum
ASTYSY	stacey
ASKP	skep
AGRAVALA	agrawala
SVNG	sung
ASNYD	sneed
ASTAR	starr
MATAKV	matako
AVADYA	awadia
TVRKV	turco
ADYT	adit
SVTV	soto
MAYR	myer
HARYV	horio
TRVN	tron
HAYM	hime
BRYGVY	bryguy
MYLYND	milind
DRYV	drew
MARKVS	marcus
TVNAR	tonar
YVMN	yumn
ALTAYR	altair
AYVRS	evers
SAMZ	sams
PYLATV	pilato
KALHYNH	culhane
BVNGARD	bongard
KLATZ	klotz
BYANG	byung
TARVB	tarub
YVZR	user
AVLSVN	olsson
AYGLV	igloo
PRVTVS	protus
JYZAN	jizan
RAFALSKY	rafalski
PANDYT	pandit
KAMPVS	campos
RABVYL	raboel
ANAZ	anas
MVRYN	morin
LVDVVYKA	ludovica
GATZ	gatz
NAPVLYTANV	napolitano
KYNYVN	kinyon
ASTNFVRT	stenfort
HAPSVN	hopson
ALYVT	eliot
DYMARYP	dimaryp
KALPAK	kalpak
ABVBA	aboba
GANATRA	ganatra
LYAV	liao
DVBRYKYN	dobrikin
BAJVA	bajwa
LARJA	larga
FARAT	furat
DAYRKTVR	director
NVKS	knox
LASKVS	laskos
BRYJ	brij
LABRYVLA	labriola
RYVNVLD	reinoud
FRAMSAN	fromson
ASKLVYR	sklower
BAVKVS	baukus
MARYH	murie
LYMBVRG	limburg
VYLHAYT	wilhite
RAYSL	risel
MARV	marv
MVRTAN	morton
RVZYTA	rosita
JVANYTA	juanita
HAYD	hyde
SASLAV	saslav
ASTAR	starr
BVDAR	budur
DVMBA	domba
HARATZ	haratz
ANJLYSYA	anglesea
ANTRVSYV	antrosio
GRYNHAM	grinham
HABVRA	habura
DYB	dib
BABVRAV	baburao
SVSYA	sucia
KAVS	kaos
PANYKV	panico
BVD	bud
AYDVAYSVZ	ludovicus
GRAD	grad
KALPANA	kalpana
BLVNSDVN	blunsdon
LAMBRVS	lambros
MYLARA	melara
TYMBVL	timbol
KVA	kwa
SANJAY	sanjay
MYGVYL	miguel
LADYK	ladic
SANTSBRN	sansburn
DARYL	daryl
VYLASKV	velasco
HALM	halm
TAY	tai
HYVNGAN	hiongun
AVZMN	ozmen
AMYHAY	amihai
AYNKH	einke
GVPALAN	gopalan
MVNAZ	munoz
ASTN	stan
FRAYDMAN	friedman
LYSVN	lison
ALMYNTAKAH	almintaqah
NAZARYTYAN	nazaretian
ASTYN	stian
GARDYNR	gardner
AYRLAYNZ	airlines
VARN	warn
DATRY	datri
DVRAN	doran
LAYVY	liewe
TAHRYHA	tahirah
LAYVSAY	livesay
AYLR	iler
KAYN	cain
DVGAN	dugan
RAMBV	rambo
ZAHYD	zahid
KVY	coy
LYTLY	lytle
RAFAYL	rafael
LYRYKAL	lyrical
FVRSAYT	forsyth
SYRKVYS	cirques
FANGVS	fungus
KRAVSVN	crowson
SANA	sana
AKY	aki
MVGANTY	moganti
MVTVRZ	motors
HAYNGH	hainge
ASTRADR	strader
DYMYTRYV	demetrio
NYKALAS	nicolas
HAYDAR	haidar
DATRY	datri
PYVRYNTN	purinton
LAV	law
NVDA	noda
ALMKVAST	elmquist
KAMBYY	combee
AYFJ	ifje
SAMANTA	sumanth
DRVDYS	drudis
GVYDV	guido
BVAY	buay
SYN	sin
ALMAS	almas
AND	and
MADABA	madaba
MAKARAYG	macaraeg
AKYLA	aqila
NVRA	nuri
HAYNLY	hinely
SAMVSKY	samosky
ASYF	asif
TAPYK	topic
KYNARD	kinard
ZAKY	zaki
SAMZ	sams
SVANK	swank
TYNA	tina
KVLYN	colin
GRAV	grov
AYGV	igoe
HANG	hung
LANKTVN	lankton
BADVYYN	bauduyn
BAJVA	bajwa
RVSA	rosa
LAY	lye
BVDY	budi
KLVTH	klute
DYNA	dyna
RAFY	rafi
FADL	fadl
SYVA	siva
GARSYA	garcia
SAYKV	psyko
RASV	rasu
NANDVANY	nandwani
AVRFYVS	orpheus
KVTLA	kotla
LAPYDARY	lapidary
AYNGALZ	ingalls
TATARY	tatari
JARVYS	jarvis
GAT	gat
BVDAR	budur
AGVYRV	aguero
MVRYSVN	morison
ALF	alf
LAVZAK	lauzac
LAVTVN	lawton
GAS	gus
MYZYRA	mizera
TVSKANV	toscano
BALHAM	balham
JAYN	jain
GAT	gat
MAVN	maun
KAYNY	caine
RVTZ	rotz
GVRDYN	gordin
MATANA	matana
DVNAY	dunae
SYKY	siqi
BAVA	bawa
VAST	vost
MVRAY	moray
VYLAS	vilas
LAMBRVS	lambros
KASPRZAK	kasprzak
ASPAT	spath
SYNKLARY	sinclair
JYRMASKA	germuska
GAYMVND	guimond
AKGAN	akgun
GNAGY	gnagy
GADFRVYD	godfroid
NYVYSVN	nevison
LANDRVM	landrum
AYMAN	aiman
AYCYRV	ichiro
BALSARA	bulsara
HVGV	hugo
FABRV	fabro
VYKTVR	viktor
DATSVN	dotson
MALTYN	maltin
MVNS	muns
SVLV	solo
DAYANYSYS	dionisios
DYVAN	dewan
ASTATZMN	stutzman
BRVKSL	brooks
VARTY	varty
PANYSY	panici
LYVNZ	lions
DANZ	danz
SYLK	silk
PVRVS	proos
LVJYK	logic
ALVKAL	alukal
DYAZ	diaz
FRANKVYS	francoys
ASTYANSN	stiansen
BLVZVM	bloxom
ATKA	atka
MASARA	masaru
ASTARGYL	sturgill
GVRASPY	gorospe
LYANG	liang
ASTAR	starr
SYMYNG	siming
AKYTVMV	akitomo
BRYVNY	bryony
ALDZ	olds
SAMANTA	sumanta
AVNAYZ	unaiza
DYKSN	dixon
GADYL	gadil
GRAFT	graft
SAKS	saxe
KVBV	cobo
HARRYG	harrig
VYLASKV	velasco
SVDYP	sudip
SASAKY	cacace
KARBALA	karbala
DANKV	danco
HRLAYNDYZ	herlindis
LVK	lok
AKVNA	acuna
AVTJH	oetje
HVLKAMB	holcomb
NYGRA	nigra
KVRVYN	corwin
ASTYVN	steven
GVLAND	goland
KAPLYNK	kaplenk
ATA	ota
RVYS	ruiz
VYGJYN	wiggin
GASPAR	gaspar
SARMA	sarma
ALMVMAN	elmoman
HARYV	horio
RAZDAN	razdan
PVHAR	pohar
AMVS	amos
FRASTY	frosti
PVYV	pouw
AYNGL	ingle
AKYLAH	akilah
BAV	bao
GVAN	guan
PYNKVVYTZ	pinkowitz
DAVAD	dawud
SANTV	santo
BVLTAN	bolton
MANK	monk
DAG	dug
AYLYS	eyles
KVASYM	quasim
VAYS	wise
AYSTYN	istian
FRAYDMAN	friedman
AZAD	azad
AVBYD	ubaid
MARKVPVLY	marcopoli
DANGTAY	dongtai
MYLYND	milind
AVRV	orue
MASARA	masaru
NYMTZ	nimtz
ASTRYDR	strider
BAGAY	bugay
ALMKVYST	almqvist
KARY	kari
KALYSYAK	kalisiak
AYNGALZ	ingalls
ALMVDYVAR	almudevar
DYB	dib
DRVR	dror
TVYYG	twigg
TVMY	tomi
PAKVAT	paquet
ASTAYNMN	stineman
ZVRYNK	zurink
VYZBRAND	wijbrand
HYTZ	hitz
BAABAR	baabar
RAVT	rout
ASKVRR	scorer
KAYAK	kayak
SYMYN	simin
MAVN	maun
VATV	vato
VYLMVT	wilmot
YVMN	yumn
ASTABZ	stubbs
GRVHVL	grohol
PVGA	puga
GANYSAN	ganesan
ARVYVLA	arviola
AL'YN	alain
MVLYNARY	molinari
MYLVARD	milward
BLVZVM	bloxom
VYVKS	vieux
GVDSVN	godson
BRAVN	brawn
MAHAJAN	mahajan
KRAMHVRN	crumhorn
LVJYK	logic
HVDAYDAH	hudaydah
ABST	obst
MYZYRA	mizera
SYANV	siano
KLAYSVN	clayson
NVYA	noya
JAYN	jain
NADVLNY	nadolny
KVVAR	kovar
HVLRVYD	holroyd
KARLKVYST	karlquist
HYKARV	hikaru
BRVNYYV	bruneau
AGBVRN	ogborn
VYTAKA	vitaca
ASTARGS	sturges
PARKZ	parks
HYNZ	hinz
AYRL	earl
JYGANG	jigang
AKSV	aksu
LVPATKYN	lupatkin
HAV	hau
JANSKY	jansky
ARAYZ	aries
MARGARYTA	margretha
SYMYNG	siming
BVMHARD	bomhard
KAPYLA	kapila
LVFSTRVM	lofstrom
JYVK	jiok
BASKY	bosky
SYLVYV	silvio
ALYVA	oliva
DRAM	drum
SALMVND	salmond
LVKAS	lucas
LAYRD	laird
DRAP	drop
ATKA	atka
PYVRYNTN	purinton
LVRJYV	lorgio
AYS	ace
NAKAGAKY	nakagaki
LYDVYNA	lidwina
KAKY	kaki
BARTVNYKV	bartonico
ZAHYD	zahid
'BDVL	abdul
ADNAMS	adnams
KVHN	cohn
LVATS	loats
FALTVN	fulton
GALY	gali
DARHAM	durham
AVVLYV	avolio
FARYD	farid
SYMVNA	simona
DAK	doc
KVYN	quin
ASNL	snel
KLAYN	kline
DANAVAN	donovan
FLAT	flat
KRAK	kruk
RVZYTA	rosita
ARFYVS	orfeus
FVRTS	forts
ANSKAMB	anscomb
BARTVLYNY	bartolini
RYMVN	rymon
LAYKZ	likes
MADYV	madeo
AYKAM	eckam
ADMYSTVN	edmiston
HARTYGAN	hartigan
ASTYANSN	stiansen
GAYDRY	guidry
MYRTY	mirti
FAYZA	faiza
MYLGRAM	milgram
BANTYNG	bunting
ARVYVLA	arviola
GADYL	gadil
LYDVYNA	lidwina
KRYSTYN	kristin
FRAZYYR	frazier
ARYN	erin
MYZYRA	mizera
PRANGS	prongs
VYNDVM	windom
RABVYL	raboel
BVAY	buay
KLYFTVN	clifton
PVPAT	popat
'ALY	aali
SVZY	suzy
TYSZA	tisza
PARSANZ	parsons
HVGV	hugo
DYVYSVN	davison
NVRDBVRG	nordborg
KALAFVT	kalafut
TAYV	thao
MVNTANARV	montanaro
BVDVR	budur
MARKSN	marxen
SADYKVYH	saddique
ASPRVT	sproat
LAN	lan
VAYD	wide
RAZDAN	razdan
BABYTZ	babitz
ASPYR	spear
GRANT	grant
ASTARTLD	startled
HYVNGAN	hiongun
VYBVVV	wibowo
SAMBVLYK	sambolec
PVSV	poso
LYVYVY	levavy
RAM	ram
PARDYNGTVN	pardington
RVLFH	rolfe
TAKA	taka
RAYLY	raile
PYRARD	pirard
TAYJMN	tijmen
TVM	tom
KATRYJN	catrijn
FAYNRTY	finerty
MVKASA	mukasa
MYRTY	mirti
VYVLA	viola
KYVNG	kiong
MYLGRAM	milgram
D'A	dua
NAV	nau
KVDY	cody
HARKYN	harkin
MKKARTY	mccarty
ASPRVT	sproat
DAV	dow
MVNTANV	montano
HYTSVN	hitson
HYTZ	hitz
HYNZ	hinz
DVY	doi
YANG	yang
HASYK	husik
PATRVKLVS	patroclus
ANAGRAM	anagram
AVTJH	oetje
MANA	mana
MAV	maw
JAYN	jain
ASPRVT	sproat
LVKAS	lucas
ZARYA	zaria
MATANA	matana
BVRG	borg
DVRAND	durand
MVNK	monk
ALMAR	elmar
ASTARYNGR	staringer
ASNYL	snail
DYAMANTARAS	diamantaras
ANV	eno
JYVK	jiok
JAKVBSVN	jacobson
AVMAKY	ohmaki
KVRKAM	corkum
KAVLYNG	cowling
JALA	jala
NYTYN	nitin
ASK	ask
PLYSKYN	pliskin
DVNHAM	dunham
AVLSN	olson
AYVSV	ayuso
LVRD	lord
TAMY	tomi
DVY	doi
HYSLAP	hyslop
DAMYTRV	dumitru
RYGARD	regard
HVRYV	horio
KALYSYAK	kalisiak
DYKSVN	dixson
VYRCVAL	virtual
GRAYSLDYZ	griseldis
SALYAN	salian
KYVNG	kiong
MVTYSV	mutiso
ADANA	adana
JAN	jan
'DYL	adil
GYLRVY	gilroy
RAYDN	ryden
ASTNKAMB	stancomb
SVPRATYK	supratic
AYRLAYNZ	airlines
