KALB	kalb
MVRAY	moray
GALYLA	galila
MARVAHA	marwaha
BARNARD	barnard
RASV	raso
KVYN	quin
ASKLTVN	skelton
KALVYN	calvin
LATALA	latala
SALYAN	salian
MVRLAN	morlan
PRAYM	prime
BALYT	balit
KAVS	kaos
AMADVR	amador
ANAS	anas
FALTVN	fulton
ALVARVS	alvarus
MYLAM	milam
SYLVYV	silvio
KLYFTVN	clifton
JVANG	juang
ANYSH	anisa
KYRK	kirk
RAZDAN	razdan
MYKAYL	mikael
ASKALY	scally
GRVHVL	grohol
JANARDHAN	janardhan
KVTZ	kutz
NVDA	noda
SANDHV	sandhu
YVNGSAP	yongsup
FRAMSVN	framson
ARSKAYN	erskine
SVNDARAM	sundaram
HANYFA	hanifa
BLVNSDVN	blunsdon
SVRAJ	suraj
PYNYAN	pinyan
RAVDA	radwa
SAVL	saul
SAKAYV	sakaue
GRAF	graf
DYNA	dyna
ARFVRD	orford
GANTRAM	guntram
HAVK	howk
AKGAN	akgun
MARSY	marcy
PARTVN	parton
BASMA	basma
SVDYPTV	sudipto
ASTABZ	stubbs
VYNSTVN	winston
LYNGAS	lingus
SYKVRA	sikora
AYZV	izzo
ADVVART	eduwart
VYMPYJ	wimpje
VYRJYNYA	virginia
VAYD	wide
PYRAVAT	pirawat
PYLVYV	pilvio
MARV	marv
VARGV	vargo
ASTRYDM	strydom
ANGLAND	englund
AKSFRD	axford
MARGARYTA	margretha
AVSYZ	oseas
HALAT	halat
ASKALY	scally
TAPTANY	toptani
BAKAR	bacar
AYS	ice
KRVM	crom
GABA	gaba
MANGAN	mangan
MANYSKAS	maniskas
ALFVRD	alford
BRVHL	brohl
KARLTVN	carlton
MARGVLYVKS	margulieux
HYLSVN	hilson
DANLVP	dunlap
NADVLNY	nadolny
ALMKVAST	elmquist
TVDAR	tudor
TATSVRV	tatsuro
BYTZ	bitz
TRYM	trim
RANA	rana
KVANRADVS	coenradus
SYMS	sims
GYVVN	givon
ANASTASYA	anastacia
SVHAS	suhas
BARVNYA	baronia
AYNGMAR	ingemar
VALVR	valur
BVSTRAM	bostrom
LYNKVYS	linkous
HALTVN	holton
ASKYLS	skiles
BAKYR	baqir
VASYK	wasik
MARGVLYVKS	margulieux
PARSVNZ	parsons
KYSLV	kislo
AVHALVRAN	ohalloran
KVKAL	kokal
AMYTAVA	amitava
ASTRVK	strock
BRAM	bram
ASNV	snow
ANANT	anant
MVRYTA	morita
NAHAM	nahum
AYLVARD	aylward
PAKALA	pakala
KVRL	corl
AYSTYN	istian
MYSYK	misik
DVRAND	durand
FYRMA	firma
MARKVS	marcos
AVKRAYN	ukraine
DANYLV	danilo
PVLV	polo
GVH	goh
SARNA	sarna
HASAKAH	hasakah
SAVLZ	sauls
ASTRYAN	stroyan
SYLVAN	sylvan
LVRD	lord
FARAT	furat
ZAHYD	zahid
JVAB	joab
RADRAMVNY	rudramuni
RADAK	radek
JAYAN	jayan
VARMA	varma
KARYAGA	cariaga
DRVDYS	drudis
SYMYNG	siming
HARTAG	hartog
DVYNYNG	duening
TAY	tye
DYMA	dema
KAKY	kaki
BANTYNG	bunting
DRYV	drew
ANAND	anand
ANTRYKYN	entrikin
DYVAYN	devine
MAR	mar
ALF	elf
DVALYBAY	dowaliby
VANSY	vance
FVRJY	forgy
LAHYJ	lahij
ASLNGZVALD	slangsvold
JYVRDANV	giordano
HVRKAN	horkan
BABA	baba
MANV	muno
RVSANA	rosana
SYMVNA	simona
AVKRAYN	ukraine
TRAFTVN	trafton
BAVA	bawa
RVAY	ruey
HAMPTVN	hampton
KVAYNTVN	quainton
TVVYS	twiss
MANSYL	munsil
PRAM	pram
JYN	jin
DJAMYLA	djamila
JANKYNSVN	jenkinson
BADYG	budig
KVAST	kwast
ATKA	atka
GRAD	grad
GALV	galo
ZAYNAH	zaynah
VYDAL	vidal
GVDRAN	gudrun
ASKRYBLYNG	scribbling
DAG	dog
BALYN	balin
KVRDYK	kordic
'DYL	adil
BVDLA	bodla
MVNS	muns
BRAYS	bryce
MANYKS	mannix
'AYMN	ayman
LVK	luk
NAV	nau
AGVYRV	aguero
LYLA	lila
KALPYN	culpin
LKS	lax
KATVPYS	katopis
ASNYL	snail
NAJYA	najya
LVJYK	logic
JASTJH	justje
KVYN	kuin
MATAR	matar
DABYNZ	dobyns
MYKAYYLYZ	michaelis
GVANYAV	guanyao
GYVVN	givon
TAPTANY	toptani
SYR	cyr
KVYNT	quint
ABDVN	ebdon
JANG	jung
AYTCVN	itchon
NANSY	nancy
SVBHANDV	subhendu
ALTMAN	altman
MABANAG	mabanag
KVANG	kwang
HAFS	hafs
ASKV	osku
YVK	yok
GAYVN	gawne
AYNGRM	ingram
SANZBVRN	sansburn
JASTJH	justje
SYNKLAYR	sinclair
TAPYV	tapio
KNVFYNKH	knufinke
PYVRYNTN	purinton
TVRKV	turco
BARTA	barta
ALKYNGTVN	elkington
LAPVTA	laputa
JARBVT	jarbot
SVHA	soha
MARVAHA	marwaha
MARTYNZ	martens
'LYMA	alima
LANDYS	landis
MYLARA	melara
MABANAG	mabanag
RADHYKA	radhika
DYMA	dema
BVLDT	boldt
MARK	marc
BRAHAM	braham
FYDVR	fedor
AKYL	aqil
NAKAMVRA	nakamura
GANYSAN	ganesan
FALTAK	foltak
SAYKV	psyko
RVHAN	rohan
SYKVRA	sikora
SVHA	suha
MADVRAY	madurai
PYNDAR	pindar
AYSTMAS	isthmus
ASPAT	spath
TVRKV	turco
LYNKVYS	linkous
MASARA	masaru
RABVYL	raboel
PAYK	pike
PZARAYS	pezaris
LABKYN	lubkin
GAVYN	gavin
BRAYS	brice
ARMATV	armato
BANKRVFT	bancroft
PZARAYS	pezaris
LYTLY	lytle
ZYZY	zeke
ASPVLARYC	spolarich
HARBVD	harbud
MATAR	matar
PARMAR	parmar
NANDVANY	nandwani
FRYNK	frink
PYRAN	piran
SANDMAN	sandman
AYT	ait
SYRAFYN	serafin
FLAYGYR	flygare
ASFAR	sphar
HRABY	hrabi
AKSLY	oxley
LAY	lai
BLAM	blum
RAV	rov
AVBAJA	obadja
KAYLAS	kailas
MAYTAG	maytag
BYRNH	byrne
ASTRADR	strader
RYBAR	ribar
MAV	mao
ABRAMSVN	abramson
GASTYN	gostin
RAFALSKY	rafalski
DYMYTRY	dimitri
JVNV	juno
MAYR	myer
PARTVS	partos
TAD	tad
YANVVYTZ	yanowitz
JYRMASKA	germuska
BRY	bri
KAKTVS	cactus
AYNTLSAT	intelsat
DAMVN	damon
DVARTH	duarte
JAMVNA	jamuna
ASTRY	stray
JARBVT	jarbot
HARYNKAR	harincar
MYLYND	milind
APLYN	aplin
KANDY	kandi
GADBVYS	gadbois
KAKY	kaki
DYNA	dina
HAR	har
DYNGSVR	dingsor
GRANVYN	granvin
AYMVN	eamon
MVNTANV	montano
KVYL	quel
KYNYVN	kinyon
KANTH	conte
BRYAN	bryan
MARY	mary
AVYNG	ewing
ASTYNTJH	steentje
ANSYH	anisa
AVADYA	awadia
KYMVN	kimon
FRANKV	franco
HAMPTVN	hampton
KYTAMVRA	kitamura
KAYA	kaya
AVKYNZ	oakins
ARNVT	arnot
RADV	radu
DADGYVN	dudgeon
PYRARD	pirard
DYNA	dyna
FRANGAKYS	frangakis
MAYR	mayr
KRAVFVRD	crawford
MVNK	monk
BANTVN	banton
HYVKYNZ	hawkins
PYVN	pion
FLYKS	felix
MVNRV	munro
MARTZ	martz
KANYS	canis
VYNTVN	winton
NARDY	nardi
ASTN	stan
MVRANV	morano
MVRAS	moras
'YN	ain
TVVYS	twiss
MYNTVN	minton
KANZY	kanze
KYV	kao
KALKAN	kalkan
ASPVSTA	spousta
ARAM	oram
SVANK	swank
SVRAB	sorab
RAFA	rafa
KNVFYNKH	knufinke
NADYG	nadig
FAVST	foust
SASZY	sasze
FYGVRA	figura
ABH	abe
KLANTVN	clanton
AYDYD	aidid
'RRYFA	arrifa
LKS	lax
ASPYR	spear
DANZ	danz
HVRGAN	horgan
BAKSKA	bocska
AKVNA	acuna
ASKVLY	ascoly
ABVLYN	abolin
PRAYL	prael
MVRYN	morin
ALVK	alok
ASMVT	smoot
KRYSJH	krisje
MYTV	mitu
KVYALSKY	kowalski
LARA	lara
VAYA	vaya
ATARAS	ataras
KVA	kwa
ASPYTZR	spitzer
MYLKV	milko
VASLV	waslo
MARYSH	maryse
BRYVN	bryon
KVRAM	coram
MVNS	muns
JAGARD	jagard
BLANSDAN	blunsdon
AVTJH	oetje
BRVKSL	brooks
VASLV	waslo
ARMATV	armato
NYDAL	nidal
ANANT	anant
ASTABZ	stubbs
NYKV	nico
SAKS	saxe
MANRV	munro
LADVVYKA	ludovica
PAYNH	payne
MAYV	mayo
AKTVN	acton
ARPYN	arpin
FVN	van
BLVHM	blohm
RAMBV	rambo
MARYH	murie
ASTYANSN	stiansen
ARKTYKY	arktiki
SAND	sand
DYMA	dima
PAGLYA	paglia
BALTAKS	baltaxe
NAPVLYTANV	napolitano
PVLYYAM	pulliam
ARLYNDH	arlidge
VYKLVND	wiklund
RAM	ram
KAYRD	caird
MYNTZ	mintz
BVS	bos
GLVRYA	gloria
KVSKYMAKY	koskimaki
RVBYN	rubin
ARM	arm
LYZARD	lizard
RVYZ	ruiz
KASVN	kasun
MAHAVLT	mahault
MAYRYK	myrick
DYVAKARVNY	divakaruni
VYVA	viva
GVADA	gouda
BVNAR	bonar
BAKVS	bakos
BRAYS	bryce
KALAFVT	kalafut
KVTLA	kotla
HANG	hung
LANA	lana
JANVTJH	janotje
BALGA	balqa
FRAZYYR	frazier
FABRH	fabre
LVYYZV	loizzo
BLVNSDVN	blunsdon
LAYBZ	libes
SAMZ	sams
TVSV	tuso
RVY	roy
BYAVYS	beavis
SVDAN	sudan
KAMBZ	combs
ASMYTZ	smiths
MALTYN	maltin
BALYGA	baliga
RYM	rim
MAYZ	mize
VARYANTS	variants
DAMYNY	dominy
DVZYYR	dozier
LVFSTRVM	lofstrom
HAPKYNZ	hopkins
BVDRA	budur
DYMYTRYVS	dimitrios
LVMAS	lomas
AZAD	azad
GVDATA	gudata
HAFS	hafs
SAMANTA	sumanth
NAGASYVA	nagasiva
MAYZ	mize
KVANRADVS	coenradus
BANDZ	bonds
KALPANA	kalpana
ASPVTYS	seputis
RVNDH	ronde
PABLV	pablo
BARKVS	barcus
KARP	karp
LARSVN	larson
KYVZVN	quezon
TYTAY	tytie
KVNV	kono
DANYS	danis
PYPGRAS	pipgras
LAVRAY	lawrie
MARKSN	marxen
SASZY	sasze
SYRYLV	cirilo
PAM	pam
VAYNTH	wyntje
BLASYVS	blasius
VARN	warn
MYNARYK	minarik
JYVVYL	jewell
DABSVN	dobson
SVDYPTV	sudipto
DRAM	drum
SVART	swart
MADYSVN	madison
PABLV	pablo
ATARAS	ataras
ASKATY	scotty
VADAPARTY	vadaparty
ASTVRY	storey
VAST	vost
HARYHARAN	hariharan
KLAYN	klein
SVKVMAR	sukumar
NAHAM	nahum
FVRJY	forgy
KAVDLYNG	quodling
RVSALYN	rosalyn
GRYSVALD	griswald
NYDA	nida
AYVGNH	eugene
ALMYNTAKVA	almintaqah
YVBYRA	ubiera
AKY	aki
JASTJH	justje
LYNK	link
ABYAD	abiad
ATKYNZ	etkins
AMYT	emit
PANDYAN	pandian
BYVDVYN	bauduyn
DARYL	daryl
MVRAN	moran
BABA	baba
VALTVN	walton
PANDA	panda
VAYS	wise
ARYKA	erika
HAYNGH	hainge
YVRMV	yermo
LANTZ	lantz
AVTJH	oetje
GLATZ	glatz
MKKARTY	mccarty
RADRAMVNY	rudramuni
VYZBRAND	wijbrand
VYVKS	vieux
AKLVF	eklof
MVRYSVN	morison
LYVAYN	levine
KAMBS	combs
KRAY	cray
FRAZYYR	frazier
BRVDA	broda
KASAMA	kasama
TVRYN	turin
SYLVYA	sylvia
FVY	fui
DAYR	dyer
VYGTVN	wigton
LAVD	loud
KVRBYN	corbin
TAY	tai
MVNTAG	montag
ASLVN	sloan
KYRYL	cyril
KRYSSAYNTYH	chrescyntie
TRAFTVN	trafton
ASKYN	skean
ASPVRY	sporay
NYDH	nida
VAN	van
PATRYK	patric
KALPANA	kalpana
LVRJYV	lorgio
ZYGMVNT	zygmunt
TAKV	taco
FADL	fadl
NVNYS	nunis
LYM	lim
ARMAND	ormond
DYLYP	dilip
SAGARS	sugars
AMVRY	amory
ABYL	abel
SYNAN	sinan
AYS	ice
PARKYN	parkin
NYHALANY	nihalani
LADVVYKVS	ludovicus
NVLF	nolf
DYVYLDH	dewilde
AMYRA	amira
SYTA	sita
AVALD	ewald
MARTY	marty
RAZDAN	razdan
LYNGAS	lingus
BRYTV	brito
HYKARV	hikaru
MYSA	mesa
VAYNTH	wyntje
AHLAND	ohlund
ABY	ebe
JVAV	joao
MVRANV	morano
PYZYALY	piziali
KAVS	kaos
GRAHAM	graham
PAY	pai
GVRVYTZ	gorwitz
HYGARTY	hegarty
ABRAMSVN	abramson
FALTAK	foltak
HARTAG	hartog
BYNG	bing
BYANGTAY	byungtae
FAYNK	finke
BRAHYM	brahim
FVNDAL	fundal
NVVYK	novik
KVYYT	quitt
KART	kurt
LYVNZ	lions
SANDHV	sandhu
DADA	dada
VAYN	vine
LAYN	lynn
BLAZ	blaz
ASKARS	scarce
BKS	bex
KARDYNALY	cardinali
MS'VD	masud
SAKAYV	sakaue
D'A	dua
SVLAR	solar
MVTYSV	mutiso
ASKYN	skean
SYTYA	cetia
AYRVN	aaron
SAKSNM	saxnem
KARVYN	karwin
BRAN	bron
KARP	karp
MABANAG	mabanag
BASV	basu
TAMAS	tamas
AYZV	izzo
RAFA	rafa
GVRTVN	gorton
GRYGVR	gregor
YVBYRA	ubiera
KVMPTVN	compton
ALSVP	alsop
MYLMAN	melman
ZYZY	zeke
PARKYN	parkin
BRYJ	brij
VYDAD	widad
ASTYL	steel
BAGDAN	bogdon
TAYRVN	tyrone
HAYD	hyde
MAVPYN	maupin
KALAFATAS	kalafatas
MVRANDV	morando
ASLYP	sleep
PVTYT	petit
TVLYV	tulio
HANTYNGTVN	huntington
VYNSTRVM	winstrom
FALSAM	folsom
KRH	kre
BYRK	birk
ASTRYNGR	stringer
BADVYYN	bauduyn
VYRYANA	wiryana
GVRVYTZ	gorwitz
BAVM	baum
KALAFVT	kalafut
RYSLYNG	rysling
MANKS	monks
HARKYNZ	harkins
MANKS	monks
DVYNYNG	duening
JHANG	jhang
ALAYN	alain
SAVVY	savoy
ASPYR	spear
MKKARTY	mccarty
MAYV	mayo
KVANG	kwang
PRVMVNTVRY	promontory
HAYM	hime
SANRAYZ	sunrise
GANTY	ganti
DRAYNH	draine
MARTYZN	martijn
BRY	bri
DVRAN	doran
AYTJY	oetje
BAY	bai
HVRKAN	horkan
LYVYNGSTVN	livingston
TAKV	taco
SYR	cyr
GVVDYNG	gooding
SYHSVBHVN	sihsobhon
BARTVNYKV	bartonico
RVGVZA	rogoza
GYBVR	gabor
JYVRDANV	giordano
HAFS	hafs
LAYRD	laird
MARGVLYN	margolin
AFTAB	aftab
FAYF	fife
DYMA	dima
PVRVS	proos
BALYGA	baliga
BYZVAS	biswas
SAYDA	saida
PVALMA	puelma
PYPGRAS	pipgras
KYVZVN	quezon
SVYFT	swift
HABVRA	habura
LANDYS	landis
HAYN	hain
ARFANAKYS	orfanakis
JVDAS	judas
GVPALA	gopala
HAN	han
RADHYKA	radhika
PVYSL	poisl
HALY	hale
YVZR	user
ALYA	elia
BARTA	barta
ANBV	anbu
GARBH	garbe
JVSVYG	joswig
KAVDLYNG	quodling
DADH	dade
GVGVAN	goguen
JAYANT	jayant
PARKZ	parks
AVRAHAM	avraham
RVBYNSVN	robinson
DYKSN	dixon
ASLYV	slave
BAKVS	bakos
MADYSVN	madison
SYRKVYS	cirques
RAJ	raj
KANG	cong
ALFANSV	alfonso
MAYT	myth
BABAH	babah
PARSANZ	parsons
ALMKVYST	almqvist
JANK	junk
TVBYN	tobin
RVNDH	ronde
FYGARD	figard
KYV	kao
PYNDAR	pindar
PVALMA	puelma
MARTYJN	martijn
SYLA	sela
