AYVRSVN	iverson
'RBYL	arbil
YANYV	yaniv
MYNTAKAH	mintaqah
KYVNG	cuong
YASYN	yasin
VYLKYN	wilkin
PVRYNTVN	purinton
KRYSTYN	kristin
GASPAR	gaspar
DAMYVN	damion
GASKYNZ	gaskins
KRVPYK	kropik
ARASMVS	erasmus
DANGTAY	dongtai
AKLVF	eklof
SANTJY	santje
SVLV	solo
YVNAL	uenal
ASTYVZ	steves
BVLDT	boldt
DANYS	danis
FRANGAKYS	frangakis
DYMARYP	dimaryp
ADVNYS	adonis
KANYG	konig
FAVZY	fawzi
LVKV	loco
KAMBS	combs
RAYMVND	raymond
MARTYJNTJH	martijntje
PYNYAN	pinyan
TAKA	taka
MYRVT	mirut
VYKAS	vikas
KVYYLYN	quillin
KVYNT	quint
AMAND	amand
ARDYS	ardis
BARTVLYNY	bartolini
RVNYT	ronit
RAVYNDRAN	ravindran
PYYRY	pieri
GADBVYS	gadbois
ANGLAND	englund
LVPATKYN	lupatkin
PRANGS	prongs
BAKSKA	bocska
BARFVRD	barford
SYNK	cinq
DABSVN	dobson
RAGATZ	ragatz
PATRYZYV	patrizio
GASLYNG	gosling
FYDALGV	fidalgo
PVTYT	petit
ASLAVMYZ	slawomir
PARK	park
MALVNY	malone
FYDALGV	fidalgo
ALMVDYVAR	almudevar
VYVYK	vivek
YVK	yok
PYNKY	pinky
ZAYNAH	zaynah
JASTYN	justin
LYDVR	lidor
BRADY	brady
LVYD	loyd
MVZYNA	mozina
ARFANAKYS	orfanakis
RADHYKA	radhika
AYSLT	iselt
KAZY	kazi
AMYVT	amiot
DVALYBAY	dowaliby
GVRAV	gorav
ASTAKS	stocks
MARYV	mario
MAHAVLT	mahault
MYLT	milt
HAMYLTVN	hamilton
LYA	lea
SVART	swart
SYMS	sims
GVANYAV	guanyao
MVNKZ	monks
DANZ	danz
ADKYNZ	adkins
SYPRYANV	sipriano
KAVDLYNG	quodling
PVRTNVY	portnoy
HAKABAY	huckaby
JAKVBZ	jacobs
LVN	lon
AVGVST	august
ALVARVS	alvarus
BLYNKV	blinco
SVR	sor
MVRAY	moray
VYNZ	winz
MANDAR	mondor
KYM	kim
ABYA	abia
ASLAVK	slawek
ASTVARD	steward
ALZ	elz
ASTYANSN	stiansen
PYZVLYTV	pizolato
PANYKV	panico
MAVBY	mawby
FADVR	fodor
NYKV	nico
MARK	marc
NADVLNY	nadolny
DVBYNSVN	dobinson
BVYRKVYL	boerkoel
HVA	hua
HALAT	halat
DYMYTRYVS	dimitrios
FALTAK	foltak
ARFYVS	orfeus
LABRYVLA	labriola
PASKV	pasco
DAG	dag
KRVPYK	kropik
VYRCVAL	virtual
DRYNKS	drinks
LAVRAY	lawrie
NVYA	noya
LYMYNG	liming
TRAYNTH	tryntje
BDYRA	bdira
KAMHVLZ	kamholz
LANGDVN	langdon
ASTANVL	estanol
DYVAYN	divine
JAKVBSVN	jacobson
SVRANA	surana
VYDAL	vidal
SVRAJ	suraj
KARVSV	caruso
LYNDVN	lyndon
KRH	kre
TAYV	thao
KVYSMAN	coisman
KLAVDY	claude
BASKY	bosky
KARLYN	carlin
JANSJH	jansje
NAYMAH	naimah
DANKV	danco
AMARAL	amaral
BALGA	balqa
LABRYVLA	labriola
KARTY	karty
MVRAD	murad
KRYSPYJN	crispijn
SVAGATV	swagato
GVADA	gouda
RVSYALA	rotiala
KVTRVNYV	cotroneo
PAYVLTJ	paultje
AVSTRANDR	ostrander
DVDAMANY	dodamani
PYNYAN	pinyan
AYVLYN	evelyn
HYRAY	hirai
HAYNS	hines
BRAN	bron
AKVNA	acuna
BRYGVY	bryguy
GVRAV	gorav
DYMA	dima
ABRYNY	ibrini
GALV	galo
LAZARA	lazara
DYLYP	dilip
ANALVG	analog
SYKVRA	sikora
AMYRA	amira
NANSY	nancy
AKYN	akin
RADV	radu
YAMYNAH	yaminah
BRYSBYN	brisbin
RVKSAN	roxsan
ANJLYSYA	anglesea
QVASYM	quasim
AMARDYV	amardeo
KALBYDA	kulbida
HYTZ	hitz
BVDV	bodo
DANG	dung
KVYRYN	querin
LASTRA	lastra
SASZY	sasze
'LY	ali
ANDRYA	andrea
TRVMBV	trumbo
LALY	laly
AYNGMAR	ingemar
BALD	bald
ALSVN	olson
AMS	ems
TRAFTVN	trafton
RANA	rana
MYKAYL	mikael
AVT	ott
ADAB	adab
SYTA	sita
TRAVAJLYA	travaglia
DVBYNYN	dubinin
PANDA	panda
RAMYRV	ramiro
LAYMAK	limace
BKS	bex
HAYNZ	hynes
BVLDVYJN	boldwijn
FAYZA	faiza
BVSTRAM	bostrom
AYCYRV	ichiro
MANDAR	mondor
BVS	bos
BRANDY	brandi
ADVVART	eduwart
MYMY	mime
BYANG	byung
SAMANTA	sumanta
HAYNLY	hinely
'BDAL'ZYR	abdulaziz
AYKAM	eckam
FYRMA	firma
MYLAD	milad
ZHRA	zara
SYRAFYN	serafin
SANDMAN	sandman
MARTYNTJH	martyntje
ARHARD	erhard
VYTAKA	vitaca
CYBANSKY	cybanski
KVMVRYTA	komorita
LAYVSAY	livesay
DARYL	daryl
MATVLA	matula
NYPTVN	napton
DASYVK	doseok
LAFGRYN	lofgren
PYRAMYD	pyramid
ZVLD	zold
PRADV	prado
MADYGAN	madigan
ASKVRR	scorer
KARTYK	kartik
AKGAN	akgun
BARVN	baron
LVS	los
LYNDVN	lyndon
DVBYNSVN	dobinson
ASTNSRAD	stensrud
KADRYBYSYK	kadribasic
KADMVS	cadmus
HYTZ	hitz
SYMYN	simin
MAMA	mama
ASKVLYNG	scowling
AYGLV	igloo
TAYLV	thilo
MAYK	mike
ASLYP	sleep
TVNG	tung
ALVYN	alvin
AYRD	aird
PYPGRAS	pipgras
LADVYG	ladwig
BANTVN	banton
DAVSVN	dawson
LAPASV	lapaso
DVRAN	doron
GRAYY	graae
GARAFALV	garofalo
PVYSL	poisl
KVBV	kubo
MVRAVAN	moravan
MYNTVN	minton
YAMAHA	yamaha
KASAT	kasat
PYAK	paik
PARSANZ	parsons
KVMPTVN	compton
MARTY	marti
ASLNGZVALD	slangsvold
GARBH	garbe
YVFYNGTVN	uffington
AYSAK	isaac
GVLAND	goland
GAYDRY	guidry
PARSVNZ	parsons
TVYYG	twigg
LANGV	lungu
AYMAN	ayman
AMYNA	amina
LYSKANV	liscano
AVYS	avis
NYKVLAS	nicolas
VYLA	vila
KALPANA	kalpana
MVRYN	morin
GRASKYN	gruskin
HARPVLD	harpold
MYRTY	mirti
ASTARYNGR	staringer
JANG	jang
PVYSL	poisl
PADVA	padua
FAYK	fike
MAYR	myer
GVNY	gony
ZVRYNK	zurink
ANYSH	anisa
LANKART	lonkart
JVNAS	jonas
BAYARD	bayard
KAPSVN	kapson
GAVYN	gavin
TRYVYTZ	truitje
BAND	bond
FAGAN	fagan
HAVTYN	hawtin
BAS	bas
JVLY	joly
RAYMVND	raymond
BARBAS	barbas
NAGASYVA	nagasiva
AKA	aka
LYNK	link
BAPTYSTA	baptista
GVRGAN	gorgon
SAYTJ	sytje
KVYYTZ	kewitz
ZYGMVNT	zygmunt
AYVTYK	ivetic
AYR	air
JAD	jud
DVRHAM	durham
ANAKYN	anakin
ASTYVN	steven
MARLA	marla
GAT	gat
SYVA	siva
KAYL	kyle
RADVA	radwa
AYGLV	igloo
NAHAM	nahum
'QYLA	aqila
ANYSH	anisa
LYNDRVTS	lindroth
SVAMY	swamy
KARBALA	karbala
HAYVL	houle
GVVDYNG	gooding
ALYMA	ulima
AVRLYNZ	orleans
DAGAN	dugan
PRAHL	prahl
JAYARAM	jayaram
HAYN	hine
AYLYS	eyles
JYSVZ	jesus
VANK	vonk
HYJDAN	higdon
LYRYKAL	lyrical
NAZARYTYAN	nazaretian
BRANDY	brandi
FYRMA	firma
PVLGAR	pulgar
AKY	aki
PRANGS	prongs
BRYDY	brady
BVNYTZ	bonitz
VALVR	valur
KALYAN	kalyan
HAYVKZ	hawkes
'LYA	alya
HARDYNG	harding
BANGARTZ	bongarts
PRATVL	pratul
ASBRYNK	asbrink
DAGAN	dugan
HAKSL	haxel
GVRGAN	gorgon
LAND	lund
BALSAM	balsam
PARDYNGTVN	pardington
PVGA	puga
LYZ	liz
KRYS	kris
KRYSTAL	crystal
JVRY	jory
DVRDAL	dordal
KYRK	kirk
AYRD	aird
MASNA	masna
MARVAHA	marwaha
DAG	dug
'QYL	aqil
ANANDA	ananda
TYMVNYN	timonin
ARAN	eran
BANGARTZ	bongarts
HAMAH	hamah
SVLV	solo
ADARA	edara
ABHAY	abhay
KAPYLA	kapila
KAMPTVN	compton
KVDAMAH	qudamah
DVMYNYK	dominic
LALKYN	lulkin
JVN	jun
TAMARA	tomura
KARDAL	kardal
RYTA	rita
VYBVVV	wibowo
FRAYTGRSA	fritgersa
ASNYL	snail
PRVMVNTVRY	promontory
VAH	wah
GRAF	graf
RVNDH	ronde
VYDAD	widad
NARAD	narad
BYKVN	bacon
ASTVRR	storer
MVNAZ	munoz
KRYYK	creek
TYN	tin
HRABY	hrabi
TVLA	tula
KVRP	korp
AVRM	orem
ASLVN	sloan
AYRYS	ariss
AMYKVS	amicus
BAVA	bawa
AMARYT	amarit
ASMVT	smoot
KALA	cala
MAMFVRD	mumford
DVDAMANY	dodamani
AYRYK	eirik
BASYLYSK	basilisk
BLVZVM	bloxom
DYTVTALA	ditutala
DVNATY	donati
'BDAL'ZYR	abdulaziz
RABY'H	rabiah
PYNKY	pinky
ABST	obst
JAST	jost
DYMARS	demars
ASTARGYL	sturgill
FADVR	fodor
KAYN	cain
KYNSVN	kinson
AKGAN	akgun
MVGANTY	moganti
DAMVN	damon
AQBAL	ikbal
DVRA	dora
LYA	lea
AVHALVRAN	ohalloran
DADA	dada
RABY'H	rabiah
AKYLAH	akilah
SYKVLV	sicolo
LAVRAY	lawrie
BYN	bin
MYMY	mime
VYLASKV	velasco
PRAHL	prahl
GYLYTA	geleta
HANY	hani
SVHAS	suhas
BRANSDVN	brunsdon
ARGAN	organ
ADVARD	edward
BABA	baba
DNVKS	denux
PANDZ	ponds
AGATY	agate
PAYNY	payne
BYAVYS	beavis
HAVN	hawn
SAGA	suga
LYNDAN	lyndon
ASPVLARYX	spolarich
BARFVRD	barford
FVTYNVS	fotinos
ALMYNTAGAH	almintaqah
BRVKAV	brokaw
BKS	bex
LYMN	lymn
HVDSVN	hodson
GAVYNDAN	govindan
BABAH	babah
PVGA	puga
MAV	mau
AVGVRY	aogori
AVR	ore
TAMPAS	tampas
SYMVNZ	simons
FABYANV	fabiano
DVRYNDA	dorinda
MARLYN	marlin
RADHA	radha
ABRYNY	ibrini
BAN	bon
KLBAY	kilby
DANGTAY	dongtai
BRYSTVL	bristol
NYKVLYK	nikolic
ASTARKY	starkey
JVSVYG	joswig
DVBAY	dubay
ADVARD	edvard
ASKVLY	scully
AYSMN	isman
KRYSP	crisp
NAS	nas
DAYBALA	dyballa
ZALAN	zalan
HALM	halm
KAZY	kazi
JHANG	jhang
ASKYN	skean
TRVN	tron
ABH	abe
SYRYL	cyril
KARY	kari
DYVAYN	divine
DVRN	dorn
FLYKS	felix
KATZ	katz
SAYVYR	sawyer
LYNKVLN	lincoln
GAVYN	gavin
ASTALKH	stolcke
MVZYNA	mozina
KAMSKAYA	kamskaya
GVYYN	gwynn
BYVDVYN	bauduyn
HVLKAMB	holcomb
YVZR	user
ARGAN	organ
BAYDA	bayda
ATRAM	atram
VYNTVN	winton
BARKAY	barkai
VALTVN	walton
AVZBRN	osburn
AFZAL	afzal
HAMY	hami
KRAK	kruk
ZARA	zara
SADYVP	sudupe
ABDVN	ebdon
SANTJY	santje
MAHAVLT	mahault
JANG	jong
GVRAN	goran
LAS	las
AGVSTYNY	agostini
ALAPATY	alapati
FRAYDY	friday
AKYHYKV	akihiko
JYVK	jiok
LANDYS	landis
ASTYNTJH	steentje
HVA	hua
RAFA	rafa
DAVAD	dawud
BRAN	bran
DAMYNYKAS	dominicus
ALVKAL	alukal
AVRAYZ	averis
PARMAR	parmar
ASKV	osku
SVHAS	suhas
JYRARDYN	gerardin
S'YDY	saidi
SKARP	scarp
KANT	kant
SYVNKA	cionca
ASTAKY	stucki
BARKVS	barcus
PAPLASKAS	paplaskas
RAVYNDRAN	ravindran
RYDKVYST	rydquist
BABVRAV	baburao
PARSANZ	parsons
DYAB	diab
HYN	hin
GANYSAN	ganesan
HARARY	harari
SVBVTKA	sobotka
SABRAMANYAN	subramanian
ALKSY	alexy
NVRDBVRG	nordborg
DYSAY	desai
NAVYA	navia
KATALANV	catalano
ASTVN	stoun
SYMVN	simon
GVDRAN	gudrun
MATA	mata
LVDVVYKA	ludovica
AYNGLYS	english
HVGARTY	hogarty
KVRVYN	corwin
LYMYNG	liming
SAHASY	sahasi
TAYLR	tyler
MAVPYN	maupin
DYAMANTARAS	diamantaras
SYMYN	simin
KARVSV	caruso
SANYL	sunil
LAS	las
BAABAR	baabar
MARTYJN	martijn
DAMYVN	damion
BRAN	bron
VARYANTS	variants
GYLPYN	gilpin
AYSAK	isaac
LVPATKYN	lupatkin
HARDYSVN	hardison
FRAYTGRSA	fritgersa
LYBYD	lebed
LYDYA	lydea
KADYN	kadin
DYMARS	demars
MARZ	marz
DVNA	dona
LABDVN	labdon
ATVSY	atusi
KRH	kre
HAMARKVYYST	hammarquist
DVRHAM	durham
ABRYNY	ibrini
ASPVSTA	spousta
ASLATR	slater
PVSV	poso
VAYGL	wigle
PASKV	pasco
DYMYTRYS	dimitris
NYD	nid
KANAKAKVRN	kanakakorn
TYTMAS	titmus
JVAN	juan
GARVFALV	garofalo
PAYPR	piper
BYG	big
FAYNRTY	finerty
TVLAY	tully
AYNAYN	inauen
KVHAN	cohan
VYZBRAND	wijbrand
BYVDVYN	bauduyn
DANAVAN	donovan
AVDRA	audra
ARVYVLA	arviola
ALVF	elof
AMBRVSYV	ambrosio
ASLAN	sloan
TRAYNVR	traynor
AYVTYK	ivetic
LAMARK	lamark
HANTYNGTVN	huntington
JVNYVR	junior
ASKVLYNG	scowling
MYMAS	mimas
MADAKS	maddux
RVYS	ruiz
ANYL	anil
KLBAY	kilby
DARYL	daryl
KAMPAGNA	campagna
ASMYTZ	smiths
ASKVLYN	scullin
GAYDV	guido
ASPVSTA	spousta
HYNSVN	hinson
FAYRVZ	fairuz
PRASAD	prasad
ALKS	alex
MVNAZ	munoz
NAN	nan
NYK	nic
PVGA	puga
ARYA	arya
GASKYN	gaskin
VAYZ	wise
AVRN	orne
KARYAGA	cariaga
SYLVAN	sylvan
DATRY	datri
TRYVLV	triolo
RANA	rana
PARSVNZ	parsons
HALST	holst
MVNTANV	montano
FAGAN	fagan
MANKVS	mancus
AVLA	olah
MADVN	madon
ASTVARD	steward
MVNTVYA	montoya
KRVPYK	kropik
VAYZ	wise
NYVAN	neuen
AVADYA	awadia
ANDRYA	andrea
HVRYV	horio
DYNA	dyna
NANDVANY	nandwani
GRAG	grog
BVNAR	bonar
TVFTH	tufte
DVSTY	dusty
KRYST	crest
ASTVRLYR	storleer
ASPYDN	speden
AVGVRY	aogori
ANTVNYS	antonis
TABVK	tabuk
PAN	pan
JAKVBY	jacoby
KRYSTYAN	kristian
GARTYN	gartin
ALMV	elmo
MARTYNZ	martens
KAMAR	kumar
AYTCVN	itchon
KYVNG	cuong
MKRAYH	macrae
MYSTRY	mistry
KVNVPKA	konopka
SANDMAN	sandman
KANAK	kanak
ATYYA	atiya
TAPYV	tapio
JVLY	joly
AVRKNY	orkney
BASYLYSK	basilisk
DVLMAN	dolman
NAVYA	navia
FABRYS	fabris
ASKALY	scally
BVYKV	boyko
BATRA	batra
ANTANAYTYS	antanaitis
SYMVNDS	simonds
YANVVYTZ	yanowitz
SASKA	suska
ASLAVK	slawek
BASKY	bosky
SASZH	sasze
BARNARD	barnard
ASK	ask
TARYK	tariq
ABRYNY	ibrini
KAY	kai
AYRP	earp
PALFVRD	pulford
KRVK	krok
GVRGANZ	gorgons
BLAL	blal
SYKY	siqi
ASLATR	slater
SAYDA	saida
PAKALA	pakala
VYRJYL	virgil
KARLAYL	carlile
KANBVY	conboy
MAYTAG	maytag
HVAR	hoar
VYPYN	vipin
AYBYRVNK	ibironke
GAV	gao
GRAYSLDYZ	griseldis
BASTYK	bostic
GVYN	gwin
ALYLYVNAS	alelyunas
AVTA	otha
SANDHV	sandhu
KAMBYY	combee
ANTVNYS	antonis
ABRAHAM	abraham
