PVYV	pouw
HVAR	hoar
TVNG	tung
GYNTVN	ginton
ALMAR	elmar
DYTVTALA	ditutala
HAPKRAFT	hopcraft
SAKARY	sakari
ADMVNDZ	edmonds
MYNARYK	minarik
VYLKYNSVN	wilkinson
VVJAK	vojak
PVGVSYAN	pogosyan
KVYYTZ	kewitz
PAKS	paks
AVRFYVS	orpheus
MADYS	madis
MATLV	mutlu
KAMHVLZ	kamholz
SYMVNH	simone
ASTFANV	stefano
GRASKYN	gruskin
PLATFVRM	platform
YYKA	yeka
VYMPJH	wimpje
LAZARD	lazard
MARSTVN	marston
KRH	kre
ANGLAND	englund
BRYTV	brito
KLATZ	klotz
MAY	may
VARTY	varty
BYG	big
HARYNKAR	harincar
HVRST	horst
AYBYRVNK	ibironke
LANGV	lungu
KLAG	klug
AYZAK	isacq
BAGZ	bugs
MKKAVN	mccown
AKYLAH	akilah
KANAK	kanak
JAG	jog
PANYKV	panico
ASKV	osku
BASTARD	bastard
KAYRD	caird
BARKAY	barkai
GARYTV	garito
YVNGSAP	yongsup
DYAB	diab
AYSY	ayse
JAN	jun
KYNGFAY	kingfai
MAYRS	myers
AYNAYN	inauen
VYTV	vito
BARVN	baron
PLASTYNV	plastino
ASTYVN	steven
GRAYSLDYZ	griseldis
HARDYN	hardin
HYTSVN	hitson
BYLYNGASLAY	billingsley
HAMPTVN	hampton
KAV	kao
KVANG	kwang
VYLYNGZ	willing
BVYRKVYL	boerkoel
TAMARA	tomura
SVNJA	sonja
TVRMALA	tormala
ATV	oto
SVBHANDV	subhendu
LVPATKYN	lupatkin
TRAVN	trown
MYLVS	milos
KALMAN	kalman
PYNKY	pinky
BALTAYS	baltais
ASVALD	oswald
KVYYNLN	quinlan
SAVLZ	sauls
KAMHVLZ	kamholz
HARTAG	hartog
BASYN	basin
AMYVT	amiot
JAYANT	jayant
RANA	rana
KYVSMATV	kusumoto
'LYA	alya
DVRAPT	durupt
AYSTMAS	isthmus
BANGARTZ	bongarts
ALKS	alex
AYVSV	ayuso
ANTVNY	antony
TAMAY	tamai
HYVNGAN	hiongun
MARAZAS	marazas
ADRYS	idris
AYSPVRT	iceport
PAPAY	papay
JVANA	juana
MVRTAN	morton
ATKYNZ	atkins
PLATFVRM	platform
KAMBS	combs
MVRYTA	morita
FARAG	farag
AVYARS	oyarce
AVCZ	ochs
MARY	mury
MANV	manu
AYLVT	eliot
GVLVMB	golomb
VYRAF	viraf
MYNA	mina
ANAND	anand
FVRTS	forts
SVHAS	suhas
PVMA	puma
VYDAD	widad
BAKVS	bakos
KYNA	kina
VYZBRAND	wijbrand
AVNAYZ	unaiza
BARNABY	barnaby
SATKAS	sutkus
AVYNG	ewing
KALB	kalb
MVNTAGV	montagu
VAYZ	wise
BYK	bik
AYRD	aird
ASPVRY	sporay
TAMAY	tamai
GLVRYA	gloria
LAYND	linde
PRYTZ	pritz
MARZ	marz
ASPR	spur
JASTJH	justje
KVRT	cort
KRVSBY	crosby
FRAYDY	friday
MS'VD	masud
AGVSTYNY	agostini
TAKY	taki
RASKYN	raskin
TVSYNG	tusing
FRANSYNTAY	francyntie
ZVRYNK	zurink
DAGAN	dagan
MKRAYH	macrae
HAYVKZ	hawkes
ARVAL	orval
BVSTRVM	bostrom
DYL	dil
ASNV	snow
MYLGRAM	milgram
LVSY	lucy
BARKASFYLD	barksfield
SASAKY	cacace
DAV	dov
KVSMAS	cosmas
VANSY	vance
GRYTZ	gritz
HVNG	hung
BVYKV	boyko
GVDAT	gudat
SVLTAN	sultan
YVRK	york
LYSVN	lison
BADZYAK	budziak
BVLVS	bulus
VADH	wade
MYNAMV	minamo
BAVDVYYN	baudouin
DVRYS	doris
BANGARTZ	bongarts
SAMVYL	samuel
MVRLAN	morlan
BAPTYSTA	baptista
SKYVRYTY	security
AVRAM	avram
HARKYN	harkin
GATZ	gatz
KVAST	kwast
JAN	jan
KRYSTYAN	kristian
DVSTALYK	dostalik
ANANT	anant
TATARY	tatari
LYVYVS	livius
KRAY	cray
KAMAMA	camama
KNVFYNKH	knufinke
AMARA	amara
KADV	kado
PASKV	pasco
MYAYNDRT	meindert
SARDV	sardo
PVYNTYNG	poynting
DVA	dua
LAZARD	lazard
ZARVS	xaros
MYRMAK	mirmak
TRANYTSA	turnitsa
BALMA	balma
DABSVN	dobson
VYNSN	wincn
JVAV	joao
ASBRYNK	asbrink
RADHA	radha
LVKAS	lucas
FARYD	farid
MYZYRA	mizera
MYTVN	maton
SLAT	slut
DYRKS	dirks
VYLKAS	wilcox
LAYVSAY	livesay
LYBLYT	liblit
GNAGY	gnagy
HAKSL	haxel
MASNA	masna
SYRKVYS	cirques
HAHTAHA	huhtala
BARVNYA	baronia
KARN	karn
KVRDAS	kordas
JANSJH	jansje
BRVDA	broda
ASKAVN	skaven
ASTV	stew
KRYSTYN	kristin
DAYVYN	divine
ANTRYKYN	entrikin
NYNVYS	ninoys
KAYL	kyle
GRYYN	green
DYANA	diana
ALMV	elmo
VAYD	wide
DHAMAR	dhamar
BARD	bard
PVYNT	point
AYRARDY	ierardi
SVLVMVN	solomon
LYVYVS	livius
LANG	lung
TYRZA	tirza
KAV	cao
LAM	lam
FABYANV	fabiano
AMPSVN	empson
FYNAN	finan
NANDVANY	nandwani
ADNAMZ	adnams
FRANKVYS	francoys
ASKVRR	scorer
NYNVYS	ninoys
LASKVS	laskos
KAZY	kazi
ADVVART	eduwart
FYSK	fisk
KNVFYNKH	knufinke
RAHVL	rahul
GVRASPY	gorospe
LAPYDARY	lapidary
KALBYDA	kulbida
RYTA	rita
NYD	nid
PVTZ	putz
KALPAK	kalpak
KVTLA	kotla
PARTVN	parton
KRYSVJYN	krisoijn
VYMPJH	wimpje
BVSTVN	boston
SKARP	scarp
ALFVRD	elford
MARYSH	maryse
LAKY	lucy
MVNTYJV	montijo
TAHRYHA	tahirah
KYNT	kint
KANYTZ	cunitz
DVNATY	donati
LABDVN	labdon
ABRAHAM	abraham
FRAYDMAN	friedman
ZAPARA	zapara
LAZARD	lazard
MYMY	mime
AVRAHAM	avraham
ASLAN	sloan
ANAYZA	unaiza
FAYZA	faiza
LYNGAS	lingus
MAV	mau
RYGAN	ragan
ALANA	alana
AVRHV	aurho
DANG	dung
DAK	duk
KAVLYNG	cowling
PYVN	pion
DVRFMAN	dorfman
HANT	hunt
BRVANHAT	braunhut
DANGTAY	dongtai
ASPAT	spath
KASY	koci
JAYANT	jayant
ZARA	zara
HARTYGAN	hartigan
ABY	ebe
SAYP	sipe
FAYRVZ	fairuz
BAYRTYH	baertie
GVADA	gouda
ASPVSYTV	esposito
LARJA	larga
ASTAMPR	stamper
TAYTY	tytie
RYSLYNG	rysling
TVRMALA	tormala
VAST	wust
PASYFYK	pacific
DANG	dung
LYVYVS	livius
NYNJA	ninja
TYMVR	timur
KARTYS	curtis
AMBRVSYVS	ambrosius
TYMBVL	timbol
ASKLTVN	skelton
GAMAL	gamal
KLAZVRA	klazura
ADAM	adam
VYLAS	vilas
RAHY	rahi
BARVNYA	baronia
MVBAY	mawby
FRNASYSKAZ	frnaciscus
SAYVYR	sawyer
BLANSTAN	blanstan
LYTVYN	litvin
MATA	mata
NVRY	nuri
KVANG	kwang
KYN	kin
MKRAYH	macrae
PYNTVN	pinton
BAPTYSTA	baptista
ASTK	stec
MAYRZ	myers
QVASYM	quasim
FVRK	fork
LYVN	leon
ABVLYN	abolin
NYKVLYK	nikolic
FAVZY	fawzi
KAKYVR	kakure
KVRT	cort
ASPVSYTV	esposito
MAHAVLT	mahault
AYVRS	evers
HAFS	hafs
ASKYLS	skiles
KVYYLYN	quillin
DVBAY	dubay
SAHASY	sahasi
MANV	mano
SAYDA	saida
YASYRAH	yasirah
KYPLYNG	kipling
KVLYN	colin
RYZVY	rizvi
MVNDFRANS	mondfrans
ASTRYNGR	stringer
DVLMAN	dolman
GVPTH	gupte
MAYZ	mize
DYVYS	divis
RYBAR	ribar
RVBYNSVN	robinson
RABY'H	rabiah
LATALA	latala
KAMPAR	kompar
'RRYFA	arrifa
HYRT	hirt
BAKVS	bakos
ADRY	adri
JYA	jia
KVRBYN	corbin
BAYLS	byles
KYRK	kirk
ANTRVSYV	antrosio
GANDY	gandy
TAMPKYNZ	tompkins
YVK	yok
KARMVDY	carmody
MARV	marv
RABKYN	rabkin
BARKVLV	barculo
KYBV	kibo
HAGA	haga
TRAVAJLYA	travaglia
AYRYZARY	irizarry
GRAV	grov
DAGAN	dagan
MYTRVVYK	mitrovic
DVMBA	domba
PVLK	polk
NYD	nid
DVBAY	dubay
ANTAL	antal
PASYFYK	pacific
BASTYK	bostic
JYM	jim
VADH	wade
JASTAS	justus
YAGLA	yagla
KVGVMA	kogoma
ASTRVK	strock
JANVTJH	janotje
AVAN	awan
KARDYNALY	cardinali
DYSMVND	desmond
HYVM	hume
MAHALY	mahaly
BRYJ	brij
RYMVN	rymon
HAYBZ	hibbs
BARTA	barta
ALAYS	elyse
RYGARD	regard
KARMVNA	carmona
MATANA	matana
RAFAYL	rafael
BRYND	brind
AYNANA	inanna
TVBYN	tobin
DVYNYNG	duening
BAR	bar
DVMYNGV	domingo
NYKVLAS	nicolas
VYSAL	wisal
ASTYNBRG	stenberg
AYVNS	evens
PANGBVRN	pangborn
DAK	duk
AYRP	earp
LVM	lum
ATA	ota
SAVSAN	sawsan
LVYYNG	luinge
ALKSY	alexy
LANSYNG	lancing
DRAMATYS	dramatis
SAKSYM	saxnem
PARHAM	parham
ARBYL	arbil
BRYYTVN	britton
MVNTANV	montano
HAPKYNZ	hopkins
SVKVMAR	sukumar
MYRMAK	mirmak
KART	kurt
MASATAKA	masataka
DVNA	dona
SADYVP	sudupe
PYVRYNTN	purinton
BARNAM	barnum
GVRM	gorm
ASTYNTJH	steentje
GVNVT	gonot
AYDA	aida
SARDV	sardo
VYRYANA	wiryana
SANANDV	sunando
MANKS	monks
MAYV	mayo
GNAGY	gnagy
GVPTA	gupta
KVANG	kwang
RAFAYL	rafael
LAYBZ	libes
HADSVN	hudson
DYAB	diab
AKL	akl
HAMARKVYYST	hammarquist
ASK	ask
KANAK	kanak
MYKVLYK	mikolic
TVYDA	toida
LAY	lai
BARKRAFT	barcroft
KALAFVT	kalafut
AYVRS	evers
JASTYN	gustin
NAYMAH	naimah
AMARYT	amarit
PVH	poh
HVA	hua
ASKVAYRL	squirrel
SVL	sol
JYNTVN	ginton
YAMAHA	yamaha
KYVNG	cuong
YAN	yan
RVHAN	rohan
ATRY	atri
SADYVP	sudupe
FALKV	falco
GVGVAN	goguen
DAHVK	dahuk
MVHAN	mohan
JYSVZ	jesus
AKYHYKV	akihiko
LYDVYNA	lidwina
BALDYNGTVN	baldington
KASTANV	castano
TRAYNTZ	tryntje
MAMFVRD	mumford
TVLAY	tully
MKDVNALD	mcdonald
MLBAY	melby
YVRANYM	uranium
DRAGANYS	draganis
GALAHAD	galahad
ALVKAL	alukal
ZAYNAH	zaynah
DYSANTV	desanto
KAZDAN	kazdan
RADV	radu
MLBAY	melby
LAVSTAD	lovstad
DANGTAY	dongtai
DANYYLS	daniels
TYV	tio
BAVDVYYN	baudouin
JYN	jin
ASTARBAK	starbuck
MYNARYK	minarik
PAVLYK	pavlik
DAV	dow
ALMYNTAKAH	almintaqah
ASPVLARYC	spolarich
BVNAR	bonar
KANTARA	cantara
SYR	cyr
GANG	gang
BLAZ	blaz
YASYRAH	yasirah
SAVARAM	savaram
GABA	gaba
MVRAY	moray
HVDAYDAH	hudaydah
SYANV	siano
SVDAN	sudan
JARVALA	jarwala
RAHVL	rahul
MVNAZ	munoz
AYNGL	ingle
BAKAYA	bakaya
MVNTANV	montano
MYN	min
KVDVGNV	codogno
DANLVP	dunlap
ASTAPLYC	stuplich
BASYLYVS	basilius
KRYSTYN	kristin
PAYK	pike
SANVNDV	sunondo
ARYKSVN	ericson
BALMA	balma
GAVYNDAN	govindan
HYSAN	hisan
DYMARYP	dimaryp
ARTYZ	ortiz
PRABST	probst
VYNZ	winz
AYNGLYS	english
GAYNVR	gainor
DYPAK	dipak
HYGARTY	hegarty
DAHVK	dahuk
DYSMVND	desmond
PYYRY	pieri
TAYRVN	tyrone
SARNA	sarna
HART	hurt
NYNV	nino
LYVYV	liviu
MYLARA	melara
ANDRYAS	andreas
LVFSTRVM	lofstrom
KVSTYS	kostis
NADVLNY	nadolny
BANDZ	bonds
AYNGMAR	ingemar
HARBVD	harbud
NADYG	nadig
DVK	doc
ARLYNG	arling
KYRK	kirk
LVNAN	lonon
MALVNY	malone
'QYL	aqil
ASLVP	slope
MYNA	mina
SLAT	slut
ARBYL	arbil
MABANAG	mabanag
JYBSVN	gibson
FALSAM	folsom
ASKLTVN	skelton
SABGLASYAL	subglacial
MARYN	marin
GRYYN	green
SARDV	sardo
NARDY	nardi
GANTY	ganti
KARA	kara
ASKV	osku
TVLA	tula
GRABNAR	grabnar
KVRL	corl
DYVNYDA	dionida
KALKAN	kalkan
BARKAY	barkai
ASPVTYS	seputis
DAYAN	dione
VYNKV	vinko
AVTV	otto
VYMAL	vimal
NADVLNY	nadolny
KARBAJAL	carbajal
SVDAN	sudan
RAMVS	ramos
HVDSVN	hodson
AYLYNG	ayling
PVRTNVY	portnoy
KANAK	kanak
VYKAS	vikas
ASTRLYNG	stirling
BYLYNSKY	bilinsky
MVNK	monk
KRYSTA	krista
DVRFMAN	dorfman
RYM	rim
BADYN	baden
ATYYA	atiya
KARL	karl
LVNAN	lonon
TAMAS	tamas
SAGARS	sugars
KVYYNLN	quinlan
KVBLA	kubla
PASKAL	pascal
KVYYT	quitt
AYMAN	ayman
MKDVNALD	mcdonald
NVTZ	notz
SYRAFYN	serafin
GVNZALV	gonzalo
DYMYTRY	dimitri
BANKRVFT	bancroft
DJAMYLA	djamila
RASKYN	raskin
KANYG	konig
AVAD	oued
GASTYN	gostin
LVKAS	lucas
AVYARS	oyarce
TVBVTYS	tubutis
VVJAK	vojak
LADVVYKVS	ludovicus
LAMYKYN	lamykin
VANG	vang
RVKAN	rukan
ANSYH	anisa
AVNSTY	onesty
JVRAH	jurah
KARBAJAL	carbajal
HALAN	hulan
ALANGKV	elangco
JYSVZ	jesus
ANJY	engi
HYSAN	hisan
PARDYNGTVN	pardington
TYNG	tyng
BVSTRVM	bostrom
JVNAS	jonas
DVSTALYK	dostalik
LVMBARDV	lombardo
BASKAR	baskar
ALVA	alva
HAV	hau
MVRAN	moran
RASKYN	raskin
ASTYNBRG	stenberg
NAJYA	najya
SYMYN	simin
KARP	karp
RYVDT	ruudt
JVLY	joly
HALAN	hulan
LVSY	lucy
TAM	tom
KVSMAS	cosmas
ASTRYTY	steriti
ASMAL	small
RYZVY	rizvi
RAVY	ravi
FRANSYSKA	fransiska
MVRLAN	morlan
HASKYNZ	hoskins
FRAYDMAN	friedman
RAGATZ	ragatz
HYTZ	hitz
ANAY	anay
BARKASFYLD	barksfield
ANDRYS	andris
SAGARS	sugars
KVAN	kwan
KANDY	kandi
VAH	wah
FADYL	fadil
ASLVMN	sloman
LABYN	lubin
AYNGL	ingle
ALVARVS	alvarus
SYLVYV	silvio
LYDVR	lidor
JYZAN	jizan
HABVRA	habura
AVKRAYN	ukraine
TVFTH	tufte
TVNY	tony
MARGVLYN	margolin
GASKYNZ	gaskins
BLAHA	blaha
RAYDAH	raidah
AYGV	igoe
JYAN	jian
MASNA	masna
KVTZ	kutz
KVYL	coil
PYNG	ping
ARBYD	irbid
SARVATH	sarwate
AYNGLYS	english
ANYJMA	enigma
MANYKS	mannix
KASANVVA	casanova
KVL	col
YVNYZA	unaiza
SYVN	sune
HANKH	hanke
BRVHL	brohl
RYSLYNG	rysling
TAM	tam
DYVYD	david
PARKYN	parkin
ABYAN	abyan
ASKYN	skene
RYTYSGRT	ritsgert
MAMFVRD	mumford
MYAYNDRT	meindert
AYK	aik
DAG	dag
AVN	aun
NANSY	nancy
DANYLV	danilo
MANGLANY	manglani
KALBYDA	kulbida
MARK	marc
TYPAL	tipul
AYLYS	eyles
KYTAMVRA	kitamura
ASTYANSN	stiansen
FAYK	fike
MVRABYTV	morabito
LVSYTV	losito
KYNYVN	kinyon
GVYN	gwin
PAM	pam
BANGARTZ	bongarts
ADKYNZ	adkins
ABRAMSVN	abramson
HARALD	harald
GRYGVR	gregor
YAV	yaw
