MVTVRZ	motors
AMYT	emit
PVPAT	popat
BADVYYN	bauduyn
NYDA	nida
KARBALA	karbala
PYRVZ	piroz
AND	and
HALPYN	halpin
VYKTYM	victim
RYSLYNG	rysling
KAVLYNG	cowling
HALTZ	holtz
PYVTR	piotr
ALDZ	olds
BVAY	buay
RAN	ron
AFTAB	aftab
JYVK	jiok
DNVKS	denux
MYTRVVYK	mitrovic
RAKVN	rukan
DABYNZ	dobyns
LYNDVN	lyndon
SAMVYL	samuel
MARTY	marty
KAVLYNG	cowling
AYNTJH	eyntje
HALAT	halat
SABHANY	subhani
BALSVN	balson
KVRP	korp
KARASV	karasu
BVST	bost
AMARDYV	amardeo
AVDVN	audun
VYLAS	vilas
SYRKVYS	cirques
CYBANSKY	cybanski
BRAYD	bryde
GRAHAM	graham
KVAYMAN	coeyman
GVNY	gony
ALVKAL	alukal
ASTYLZ	stiles
LADVVYKVS	ludovicus
YARVN	yaron
GVYL	goel
TANAK	tanak
MARSTVN	marston
ASKVLY	scully
AVLA	olah
ARVYVLA	arviola
LAP	lap
ASK	ask
SYMYNG	siming
SYANV	siano
AYDA	aida
RAVYNDRAN	ravindran
SVBHANDV	subhendu
RAVT	rout
AYVRS	evers
BRAVN	brawn
BALGA	balqa
ASKVLY	ascoly
SANA	sana
RVNY	roni
GASYK	gasic
KYM	kim
BVNGARD	bongard
KRVK	krok
HYTZ	hitz
AMYR	amir
HYNTVN	hinton
PVGA	puga
PVTZ	putz
SANDAR	sundar
MARYSH	maryse
KAPSVN	kapson
ATVL	atul
FRANKV	franco
DAVT	dout
AYMAN	ayman
FARAT	furat
PANDA	panda
PASKV	pasco
HVAR	hoar
MARLYN	marlin
HAVTYN	hawtin
VYLYANY	villani
LANGDVN	langdon
FLAYGYR	flygare
ASTNFVRD	stanford
GYL	gil
VYKTVR	victor
TANAK	tanak
AMYVT	amyot
VARN	warn
LYNK	link
DVRYNDA	dorinda
RYMVN	rymon
SVHA	soha
HARYV	horio
NYHALANY	nihalani
MVHAN	mohan
BYK	bik
ASTDYNA	stedina
'QYL	aqil
HYNTVN	hinton
DVYNYNG	duening
MANAMA	manama
ALRVY	elroy
MARKHAM	markham
KYN	kin
SAKAMVTV	sakamoto
BAYLZ	byles
MANAMA	manama
SAVARAM	savaram
RAFALKV	rafalko
AMNVN	amnon
LYNDGARD	lindgard
MAKARAYG	macaraeg
YARVS	yaros
RVZYTA	rosita
PRASANA	prasana
VASLV	waslo
ATYYA	atiya
HARVLD	harold
MASNA	masna
BVDAPATY	bodapati
ASPYRZ	spears
FLAT	flat
GARVFALV	garofalo
HANKH	hanke
JARBVT	jarbot
BRVYN	bruyn
ABRAHYM	ebrahim
AMYKVS	amicus
TAKSBRY	tuxbury
ALMYNTAGAH	almintaqah
RVLFH	rolfe
MYTV	mitu
VARYANTZ	variants
KYNZMAN	kinsman
RVYMATA	roimata
VYJNAND	wijnand
PAPLY	popli
MAYK	mike
LYM	lim
BAABAR	baabar
ARDYS	ardis
VVJAK	vojak
SYPRYANV	sipriano
GAYA	gaya
FALKV	falco
ALMAS	almas
LYTVYN	litvin
KVJYAS	kogias
BARY	bari
KAMPAR	kompar
KARLKVYST	karlquist
JVSYP	josip
NYVAN	neuen
ANGLASMA	engelsma
LAP	lap
DYSANTV	desanto
DVRAN	doran
MANY	mani
KRAYJ	craig
SVAMY	swamy
BALHAM	balham
MVRAY	moray
LAYNG	laing
ASTARGYL	sturgill
DAV	dov
SYTLAYV	cittlau
FRAYTGRSA	fritgersa
HANY	hani
LAL	lal
KALB	kalb
MARGVLYN	margolin
ABYAB	abiab
KALA	cala
PALFVRD	pulford
KARLAYL	carlile
BAVM	baum
PARSANZ	parsons
BRYDY	brady
ALZ	elz
AQBAL	ikbal
VALDRAM	waldram
MARY	mary
PYZYALY	piziali
GALYZYA	galizia
HVDAYDAH	hudaydah
KRH	kre
DAKLVZ	ducloz
ADYSAK	adisak
KAZVHYRV	kazuhiro
HASBY	husby
JVNYVR	junior
DYVYS	divis
BRYSTVL	bristol
FALTAK	foltak
DAVKNYZ	dawkins
SVAN	swan
MVNTANV	montano
BANKS	banks
BASKY	bosky
AMVNA	emona
ASTVARD	steward
MVNKS	monks
ALMAS	almas
AKGAN	akgun
KARPLAS	karplus
MS'VD	masud
DYVAYN	devine
GAGNH	gagne
DVRMA	dorma
HASYK	husik
ALYA	elia
PVSV	poso
RVHN	rohn
SANG	sung
HAYDAR	haidar
RVBYN	rubin
RABKYN	rabkin
ALVAN	alwan
BLANZDVN	blunsdon
PVRVS	proos
DATSVN	dotson
VYRT	wirt
NYVKVYST	newquist
TATSVRV	tatsuro
ZYTV	zito
ARNAT	arnot
MARTY	marti
PYLVYV	pilvio
ALDYN	eldin
DYAMVND	diamond
KVLYHA	koliha
ASTVRY	storey
ASKATV	scotto
LYVYNGSTVN	livingston
HYNZ	hinz
JASTJY	justje
DVMYNGV	domingo
DATSVN	dotson
ANTVNYVS	antonius
FYNK	fink
KVAYMAN	coeyman
KASTVRY	kasturi
ALVYN	elwin
LVBYN	lubin
BABYTZ	babitz
ANYART	enyart
SALMY	salmi
RABKYN	rabkin
TVRKV	turco
TVMATYVS	tomatius
GAMAL	gamal
VARN	warn
RYGARD	regard
HAV	hau
MVNTYJV	montijo
TANYS	tanis
ARDYS	ardis
SAYTZ	sites
ASTYP	steep
LAP	lap
JVAY	juay
ABVBA	aboba
DADGYVN	dudgeon
NVRA	nuri
KALYA	kalia
DRAP	drop
ASMYRNV	smirnov
AYNTJH	eyntje
VYKTYM	victim
'LYM	alim
SASZH	sasze
PRANGS	prongs
LYSY	lacy
KVYNT	quint
PAL	pal
KVYST	quist
RASV	raso
HAVARD	havard
JYAN	jian
KVAST	kwast
RAFYKYV	rafique
VVLTRNYNG	woltering
KANRVY	conroy
VALTVN	walton
ADNAMZ	adnams
ALYSVN	elison
KRVB	krob
DYVAYN	devine
LKS	lax
KANTARA	cantara
KATLYR	cutler
FABRYS	fabris
KARLTVN	carlton
FVNYVK	foniok
JAKVBY	jacoby
KARA	kara
HYVM	hume
VYNATA	vinata
HYLSVN	hilson
AYDA	aida
BALKA	balqa
NANSY	nancy
AYGRTVN	egerton
ASFAR	sphar
GABVR	gabor
PANDZ	ponds
FVRSAYT	forsyth
YARVN	yaron
HAYD	hyde
ANTRAPY	entropy
FRAST	frost
ARYKA	erika
TAFTZ	tufts
SYMYNG	siming
BARBAS	barbas
AMYVT	amiot
KVSMAS	cosmas
BARKAY	barkai
KVRDAS	kordas
ASKAYT	eskite
BVNVMV	bonomo
MYTVN	maton
HAVVLA	havola
RAJV	raju
PANGBVRN	pangborn
LAND	land
LADVYG	ladwig
BYRD	byrd
RASTRAM	rostrom
MAY	may
LAYN	lynn
SVKVL	sokol
LAK	loc
SYLVA	silva
SVLAR	solar
ASPYTZR	spitzer
TRVYYJH	truitje
VASYK	wasik
HABA	haba
RYGV	rigo
ANTAL	antal
RAYSTLYN	raistlin
KVYL	coil
SVDYPTV	sudipto
PRASAD	prasad
RAYSTLYN	raistlin
GRAD	grad
MANVLY	manoli
ALVYN	elwin
MVTYSV	mutiso
ANGLAND	englund
MAYR	mayr
PAL	pal
HVRYV	horio
BVRGA	borge
LAN	lan
TAM	tam
DVRDAL	dordal
ASPAT	spath
LVPATKYN	lupatkin
ANYART	enyart
JABJH	jobje
KVNYNG	koning
JYNG	jing
AVBR	ober
ALKS	alex
HAYNS	hines
HYSAN	hisan
PRAHL	prahl
ALSVN	elson
MYLARA	melara
SVAMY	swamy
MARKVS	marcos
KVRBYN	corbin
SVSYA	sucia
AVAN	awan
AZALYA	azalea
RAMYRV	ramiro
AVRN	orne
TATSVRV	tatsuro
KVRDYK	kordic
MANDAR	mondor
GRAFT	graft
HVYMAN	hoyman
HVGARTY	hogarty
DYVAYN	divine
BRVYN	bruyn
SAVARAM	savaram
ARVAL	orval
FVNDAL	fundal
LVRJYV	lorgio
KALAFVT	kalafut
AYLSA	ailsa
DVNYNY	donini
BYVKRAFT	biocroft
LYKYVRY	liquori
VYVA	viva
MASATAKA	masataka
GVRTVN	gorton
KRYSTAL	crystal
LVMBARDV	lombardo
ARBANAS	arbanas
BYAN	bian
SVBHANDV	subhendu
BRATYNA	bratina
SANK	sunk
RVBYNSVN	robinson
AFZAL	afzal
GANTY	ganti
TYVNYS	teunis
DAGAN	dagan
AVALD	ewald
HAJ	haj
TAYLR	tyler
AYDA	aida
ASTRYAN	stroyan
MVRTAN	morton
TVRDA	torda
LVRY	lori
RVY	roy
AVRYVLY	aureole
ALFVRD	elford
ASLVMN	sloman
VYTAKA	vitaca
GVAN	guan
VYDY	vidi
RYYNKS	rienks
AYGLV	igloo
MAYRS	myers
JVNV	juno
KVAYNTVN	quainton
DAYAN	dione
HARKYN	harkin
DVBRYKYN	dobrikin
JVNYVR	junior
KRYYK	creek
KARPLAS	karplus
ALSAP	alsop
KALA	cala
MARZ	marz
ASLVN	sloan
ZYZY	zeke
MADVRAY	madurai
TVLY	tuli
DRAVN	drown
KALDYS	kaldis
GYZAV	gizaw
HYSLAP	hyslop
ZYTV	zito
RAFALSKY	rafalski
KALVYN	calvin
SVLVMVN	solomon
YAYN	iain
YARVS	yaros
JVRY	jory
BALHAM	balham
TAYLBRY	tilbury
VYPYN	vipin
KASTY	casti
SAYTJ	sytje
RAN	ron
ZAYRA	zaira
AVGVSTV	augusto
TRAFTVN	trafton
AMA	ama
DANSY	dancy
KYLG	kilg
DAN	dun
AAMYNA	aamina
KATRYN	katrin
DVBYNYN	dubinin
VASYK	wasik
PASKAL	pascal
SAKAMVTV	sakamoto
KASTRYKAM	castricum
AYGRTVN	egerton
AYR	air
MARSY	marcy
GRAF	graf
PARHAM	parham
AYN	ayn
JVDY	judy
VYKTVR	victor
PALFVRD	pulford
SVHAS	suhas
TVYDA	toida
ASTYSY	stacey
MANGAN	mangan
ZALAN	zalan
RVJAS	rojas
BADYG	budig
NAYMAH	naimah
DYSMVND	desmond
TVLAY	tully
GRAYYNGR	grainger
TVLANY	tolani
KVLYHA	koliha
ASKVLYNG	scowling
HRABY	hrabi
DAKLVZ	ducloz
AMBAR	embar
BVKSY	buxey
HAFS	hafs
JVNYVR	junior
KVRL	corl
JASTYH	justje
PYNYAN	pinyan
LYZ	liz
GRAH	grah
BRYNK	brink
VARMA	varma
ADMVNDZ	edmonds
ALSAN	olson
TKS	tex
KARVLYN	carolyn
BRVHL	brohl
TAFT	toft
KLAVDYA	claudia
AYRD	aird
RVSYALA	rotiala
MVNYZ	muniz
PAN	pan
AYSRT	israt
BYPYN	bipin
YAMHA	yamha
PAM	pam
BARVA	barua
ATV	oto
KYBV	kibo
DVMBA	domba
LVRJYV	lorgio
ATV	oto
MVGANTY	moganti
MAYSAL	missal
PANDA	panda
VYLDYNG	wilding
GASKVYYN	gascoyne
BVHL	buhl
HVLM	holm
KRYSTA	krista
BVZKART	bozkurt
RADVF	radov
AYNT	aint
KYRYL	cyril
BLASY	blasi
AFA	afa
MVNTAGV	montagu
BVLDVYJN	boldwijn
BVRST	borst
VAYMN	wyman
ALFVRD	elford
KYNT	kint
ATKYNZ	etkins
HASTYNGZ	hastings
GAYDA	gayda
KYNGSFVRD	kingsford
ZAFYNA	zafina
AVGVSTYN	augustyn
ANGLAND	englund
GAYDV	guido
MANDA	manda
JVDAS	judas
AVGYNH	eugene
JVHANSVN	johansen
RVYMATA	roimata
AFYF	afif
SAMVN	sumon
BVSTRVM	bostrom
HYNTVN	hinton
AVGYNH	eugene
AYSRT	israt
KVSKYMAKY	koskimaki
BRAHYM	brahim
KLANTVN	clanton
YAKVB	yacob
KAPYLA	kapila
YVMN	yumn
BYRNH	byrne
LANGSTVN	langston
ASMYD	smead
RABYNSVN	robinson
SVNDARAM	sundaram
ASLNGZVALD	slangsvold
NYYVTN	newton
APVNTH	aponte
JYRARDYN	gerardin
JASTYH	justje
ASTRYD	astrid
BLAZ	blaz
FRANSYSKVS	frnaciscus
TVMYTYVS	tomatius
SASAKY	cacace
LYANG	liang
RAFALSKY	rafalski
FRANSYNTYH	francyntie
RAFA	rafa
ASPARZA	esparza
JYNAKYRAMAN	janakiraman
AMYRA	amira
KVRTH	korte
BARGVS	bargus
LAYHV	laiho
VYVA	viva
GVYDV	guido
KADYN	kadin
ADVNYS	adonis
VVJAK	vojak
ALAYS	elyse
DAYVYN	divine
AKMAN	ekman
HYVVYT	hewitt
ARFVRD	orford
ASTRYD	astrid
BAB	bob
ALVAN	alwan
JVSYP	josip
ZYTV	zito
HALVB	holub
ASTFANV	stefano
YANG	yang
MYN	min
KRYSVJYN	krisoijn
ANTARAMYAN	antaramian
BLAM	blum
KRYST	crest
KANYVN	canyon
DYVAN	dewan
ALAPATY	alapati
MVRABYTV	morabito
BVSA	busa
DYMYTRYS	dimitris
HAV	hau
FRYNK	frink
KANYTZ	cunitz
PYVTR	piotr
ASLYNY	slaney
ANRAH	unruh
NYYVTN	newton
YVNYZA	unaiza
GVRAV	gorav
NYGRA	nigra
RYGAN	ragan
BAYLYNGTVN	billington
MARYANA	mariano
GASLYNG	gosling
JASTAS	justus
GASTAVVS	gustavus
BAYLYNGTVN	billington
NARDV	nardo
BLAZ	blaz
HARRYG	harrig
MARTYN	martyn
JVHANSVN	johansen
LARVKVYH	larocque
VARGAS	vargas
KVSVGH	kosuge
MADYV	madeo
BASYN	basin
LYKYVRY	liquori
AVGVST	august
ARBYD	irbid
PYRAMYD	pyramid
ASTYGBRG	stigberg
HADSVN	hodson
LYDYA	lydea
DYKSVN	dixson
PARDY	pardi
SANA	sana
KALAFVT	kalafut
NYVAYNGTN	newington
KVYL	coil
KVYYT	quitt
VYNSTRVM	winstrom
SAVSAN	sawsan
KYMVRA	kimura
GANYSAN	ganesan
ASPVRY	sporay
DVRMA	dorma
HAVDVN	hawdon
YAMAHA	yamaha
NYMTZ	nimtz
SYTARAM	sitaram
HVLRVYD	holroyd
AYVRY	ivery
DAVAD	dawud
VYLA	vila
HAYD	hyde
DYPAK	dipak
JYAN	jian
KYNA	kina
BVYZY	boisy
AVRCARD	orchard
RASTYN	rastin
AYGLV	igloo
DAY	duy
AMYR	emyr
ANTVNYVS	antonius
BLYNKV	blinco
TRANYTSA	turnitsa
PYLATV	pilato
NAGASAKY	nagasaki
MARKV	marco
NYN	nin
SAGARS	sugars
DANALD	danald
YVNYZA	unaiza
TVSKANV	toscano
PYRYZ	perez
SAMZ	sams
MAYR	myer
DADGYVN	dudgeon
PASKAL	pascal
TRAFTVN	trafton
RVNDA	ronda
DAK	duk
'LAALDYN	alaaldin
BASYN	basin
RASTYN	rastin
ADMVNDZ	edmonds
DYAMVND	diamond
FRANKLYN	franklin
AYS	ice
DAK	duk
KANV	cano
AVBYD	ubaid
FAYYZ	fayiz
FARAGV	farago
RAJ	raj
PYLATV	pilato
RVSANA	rosana
RAZDAN	razdan
MYLKS	milks
ADVVART	eduwart
AYNVN	eynon
HABVRA	habura
YVZR	user
KAYL	kyle
FLVDYN	flodin
ALZ	elz
SVTV	soto
PVYNT	point
ANRYKYV	enrique
PATRYK	patric
GRYTZ	gritz
ASPYDN	speden
LVTYNZ	lutins
AVGVSTYN	augustyn
ABVLYN	abolin
ASTAG	stagg
NYKV	nico
ANTANAYTYS	antanaitis
LANDRY	landry
LYBLYT	liblit
JYVK	jiok
ARVYVLA	arviola
DVMYNYKAS	dominicus
NAPTVN	napton
MVRANDV	morando
SVAMY	swamy
AMPTH	ampte
HYVVYT	hewitt
GVYYN	gwynn
DASYVK	doseok
SANG	sung
ALF	alf
MAYZ	mize
RYDA	rida
FYLYAS	filias
BYVDVYN	bauduyn
BARY	bari
YANG	yang
JVRY	jory
VAFA	wafa
ANDRYS	andres
SYMYNG	siming
LAY	lai
SABRAMANYAN	subramanian
DANSY	dancy
GRYT	grit
ANV	anu
RVBYN	rubin
ATYYA	atiya
ASKVLY	scully
SANTV	santo
ATKYNZ	atkins
NYTYN	nitin
AFTAB	aftab
DYNT	dint
ALAYS	elyse
ARNVT	arnot
