MVRTAN	morton
AYLVT	eliot
BYNVY	binoy
LANKA	lanka
SAYTJ	sytje
GABARA	gabara
VAN	van
ANTVNY	antoni
FVRK	fork
ARYKA	erica
ASTYK	astik
ALYVT	eliot
DAMVN	damon
APVNTH	aponte
KAMALA	kamala
AYNANA	inanna
BRYN	bryn
TYVGA	tioga
BAVDVYYN	baudouin
KVSMAS	cosmas
ANAGRAM	anagram
ANBAR	anbar
AMBRVSYV	ambrosio
GVRTVN	gorton
DAY	day
PVLV	polo
HARATZ	haratz
JAN	jun
DAVT	dout
VASYK	wasik
DAYR	dayr
MYLARA	melara
KARHART	carhart
NVDA	noda
PRVTVS	protus
BAKAYA	bakaya
KVANLAN	quinlan
PYNTVN	pinton
MANGLANY	manglani
DANDAS	dundas
ASPYRYNG	spearing
HANSVN	hanson
KARLAYL	carlile
HARBVD	harbud
ASTVK	stock
KARYDA	karida
KRANSVYYK	cranswick
LAY	lye
MARGVLYS	margolis
LYDYA	lydia
BARTHVLVMYVS	bartholomeus
SVRANA	surana
JVAV	joao
LYTVYN	litvin
S'YD	said
LAMASTVS	lamastus
KAV	cau
ADAN	adan
KYKVMA	kikuma
BASMA	basma
'DYL	adil
TRAFTVN	trafton
TAPYK	topic
LVYYZV	loizzo
KARTY	karty
ASPRVT	sproat
ARFYVS	orfeus
ASKVLYNG	scowling
LAVSTAD	lovstad
PANT	pant
AVSNZ	owens
VARMA	varma
GALV	galo
MANVLY	manolo
KLYFT	clift
PRAKTYKVM	praktikum
YAGLA	yagla
ASKVLY	ascoly
TVLA	tula
HYRT	hirt
LYANG	liang
NARDY	nardi
KARTYK	kartik
ABRAM	abram
VYJDAN	wijdan
SASZY	sasze
ANSYH	anisa
DABYNZ	dobyns
ANTVNYVS	antonius
MYLKY	milky
BRYN	bryn
SYMVNDS	simonds
ASTRYTY	steriti
KVSMAS	cosmas
KVRBYN	corbin
PYRAVAT	pirawat
ADVNYS	adonis
LADVYG	ladwig
KAMDAR	kamdar
RVNDH	ronde
BYK	bik
VYVYAN	vivian
KVANG	kwang
NAZARYV	nazario
GATZ	gatz
KRYSTYN	kristin
NYVAN	neuen
HAVK	howk
ASKVLYNG	scowling
PARMAR	parmar
SAYM	syme
ARVNAH	arunah
MARZ	marz
BRVYLV	broilo
'QYLA	aqila
ASTVN	stoun
MANK	monk
HVDSVN	hodson
TANAK	tanak
KLAYN	klein
HVLRVYD	holroyd
DAG	dog
AVTJH	oetje
FRANKVYZ	francoys
LAY	lye
FAYYZ	fayiz
TVLA	tula
MYLAD	milad
ATARAS	ataras
HANSVN	hanson
ASTYANSN	stiansen
RAYBLT	rybolt
TANAK	tanak
HAMARKVYYST	hammarquist
JYA	jia
JAYARAM	jayaram
PRYSYNG	pricing
YVNYZA	unaiza
LAYL	lyle
HYVVYT	hewitt
AYVGNH	eugene
KALKAN	kalkan
MYLGRAM	milgram
HARTAH	hurtah
LVTZ	lutz
PYYRY	pieri
NVLF	nolf
KYVNG	kiong
DYAMANTARAS	diamantaras
ALANA	alana
BLAM	blum
KLANTVN	clanton
KVYYTZ	kewitz
TAKV	taco
BRVYLV	broilo
SVL	sol
LVRA	lora
AMNA	amna
DYVAKARVNY	divakaruni
BLANZDVN	blunsdon
BRYN	bryn
S'YDY	saidi
SYKY	siqi
RASKYN	raskin
BARVN	baron
AMVRVSV	amoroso
BVLDT	boldt
LASK	lusk
ATV	oto
BALD	bald
BYNG	bing
DAK	duk
PAKALA	pakala
NVVYK	novik
GARTYN	gartin
ALYZA	alisa
GAYDRY	guidry
ARBY	orbi
NAS	nas
TVSV	tuso
AVL	owl
LANTZ	lantz
SVYFT	swift
ASTV	stew
DAVD	daud
NAVAS	navas
SANZBVRN	sansburn
KASTY	casti
GAV	gao
SAYTV	saito
AYLYNG	ayling
BANYTA	bonita
KRVG	krug
LAMPY	lampi
MANYKS	mannix
YANVVYTZ	yanowitz
SYNG	sing
DYMARYP	dimaryp
BASYLYKA	basilica
MVNAZ	munoz
PVKVRNY	pokorny
BLASY	blasi
BRYVNY	bryony
BRYVN	bryon
AVKSVL	oxwell
MAMA	mama
AYMAN	aiman
GYL	gil
MVTVRZ	motors
FVRJY	forgy
'BDAL'ZYR	abdulaziz
LAS	las
HANYFA	hanifa
GYL	gil
BYATLYNG	beutling
ASTYNTJH	steentje
MYSA	mesa
TAYLBRY	tilbury
RVSLYN	roslyn
PYNYAN	pinyan
TANTVN	tanton
TVSKANV	toscano
ATARAS	ataras
FAYZ	faiz
DRYNKS	drinks
TYNY	tiny
ALMKVAST	elmquist
DVRAN	doran
LYVYS	lewis
NYDH	nida
CAYLD	child
FRANSYSKA	francisca
RADHA	radha
BVSTAK	bostak
KAPANGA	kapanga
BANTYNG	bunting
AHLAND	ohlund
LYNDAN	lyndon
TAMY	tomi
HAVN	hawn
AYVRSVN	iverson
ARNVLD	arnold
RADAK	radek
ASTYN	steen
ASKATV	scotto
KADMVS	cadmus
FVRLANG	furlong
KRVSBY	crosby
VANK	vonk
AYSVN	ayson
ANAZ	anas
RYMVN	rymon
ASTAMPR	stamper
AKYLAH	akilah
DAVT	dout
ADYT	adit
LARA	lara
KAVS	kaos
HARMAN	harman
ASKVAYRL	squirrel
KALYLA	kalila
PRVY	pruy
AYZV	izzo
KARMVDY	carmody
AMBRVSYV	ambrosio
ANVAR	anwar
AZALYA	azalea
JVZYH	josie
KVN	kon
MANK	monk
VYGJYN	wiggin
KAV	cao
SYMVNDS	simonds
JYGANG	jigang
MARSY	marcy
KANYG	konig
HYJDAN	higdon
RYVNSVN	runeson
SASLAV	saslav
AYR	air
RAVDAH	rawdah
KVVAR	kovar
AYNG	inge
DANSY	dancy
AL'YN	alain
FLVDYN	flodin
AYS	ice
BARKVLV	barculo
FRNASYSKAS	frnaciscus
NAKAMVRA	nakamura
KVKAL	kokal
ADVARD	edvard
KAVLYNG	cowling
ARVYVLA	arviola
DAYANYSYS	dionisios
PYYRY	pieri
TALYBAH	talibah
ALKS	alex
RAVYNDRAN	ravindran
KLVB	club
GADY	gadi
GVYL	goel
VYVA	viva
HVGAN	hogan
ABRAHYM	ebrahim
AYSTYN	istian
ASKP	skep
KADYN	kadin
SYKVLV	sicolo
SASLAV	saslav
KVA	kwa
ALYN	elin
AYNKH	einke
MAYRS	myers
DANSYNG	dancing
HAVVLA	havola
KYNSVN	kinson
ASLAN	slone
LATKYNZ	lutkins
DVMYNGV	domingo
ZAYNAH	zaynah
GVRALAVALA	goralwalla
PVRKV	porco
NAGASYVA	nagasiva
RVSV	rosu
MVNTVYA	montoya
LATKYNZ	lutkins
DARBY	darby
BAKYR	baqir
AVL	owl
AYGV	igoe
AYSYZAKY	ishizaki
KASTRV	castro
TVNG	tung
DALYNAR	dolinar
FRAYDMAN	friedman
DAY	duy
DYVYDYAN	davidian
MYKAYL	mikael
FRANSYSYVS	frnaciscus
BAKAR	bacar
RATKS	rutks
JANG	jung
KASPRZAK	kasprzak
FVY	fui
AKSFRD	axford
ABAD	abad
AVT	ott
MARTYJN	martijn
LYVNZ	lions
BVDY	budi
VYNDVM	windom
JAKVBZ	jacobs
KLAZVRA	klazura
HAV	haw
MVNTYJV	montijo
GRYGVR	gregor
AGALY	agali
ADNAMZ	adnams
BAND	bond
DANALD	danald
ASMADJ	smadja
KVMPTVN	compton
VYLYNGZ	willing
TYNG	tyng
BYK	bik
GANTY	ganti
HAMY	hami
MAGAGNA	magagna
SVLAR	solar
DAVNYNG	downing
JVN	jun
AVYARS	oyarce
DYVNYDA	dionida
LARJA	larga
AMARAL	amaral
DYZVN	dizon
BADYN	baden
KYNGSFVRD	kingsford
VYLASKV	velasco
PRASANA	prasana
HAYDAR	haidar
HARYNKAR	harincar
AYLVARD	aylward
KAMPAGNA	campagna
AVTV	otto
FRANKVYZ	francoys
RADRAMVNY	rudramuni
ASTAKR	stoker
ALYN	olin
BVDRA	budur
GRAH	grah
AGATY	agate
SVL	sol
DANYYLS	daniels
ASTRADR	strader
BASYN	basin
ASTAKR	stoker
GAT	gat
LYSVN	lison
KANV	cano
DAVVD	dawud
ANSYH	anisa
HVDSVN	hodson
SANTV	santo
ASTRYD	astrid
AKLAND	eklund
LANG	lung
MASNA	masna
VAN	van
KLYFT	clift
LYND	lind
KAYLAS	kailas
MARAZAS	marazas
JARVALA	jarwala
LASKA	laska
AVRLYNZ	orleans
PAKALA	pakala
GARTYN	gartin
S'YDH	saida
MLBAY	melby
TAPYK	topic
BRYAN	bryan
AYSPVRT	iceport
ASTAD	stude
AYBYRVNK	ibironke
KARDAL	kardal
VAYA	vaya
DADA	dada
VYLYNGZ	willing
BRAHAM	braham
GALYZYA	galizia
NYKVLA	nicola
BYVAN	bevan
AVLD	auld
ALVARV	alvaro
ADYH	adie
ANANT	anant
BVDAR	budur
KRYSSAYNTYH	chrescyntie
KARHART	carhart
HAFS	hafs
GADBVRY	gadbury
ASPATSVVD	spotswood
SYMPLYSYTY	simplicity
DVRAZYV	dorazio
VATV	vato
GVRASPY	gorospe
HARRYG	harrig
MARYA	maria
MYNTAKAH	mintaqah
DANGYVN	dungeon
ASTYGBRG	stigberg
MVNKAR	moncur
RVSA	rosa
AYSAK	isacq
BAABAR	baabar
DVNATV	donato
MARV	marv
RYVNVLD	reinoud
AVYNZ	ewins
HYNTVN	hinton
VYNATA	vinata
MVLYNARY	molinari
BVSTVN	boston
GALY	gali
FRAYTGRSA	fritgersa
SAYDA	saida
KAMPYVTR	computer
MYTV	mito
KADV	kado
RVKSAN	roxsan
AMA	ama
DAMYNYKAS	dominicus
KLAVDYA	claudia
BAKYR	baqir
HAJYR	hagir
VYDAD	widad
VYRYANA	wiryana
LYBYD	lebed
DYSAY	desai
VYK	vik
TAY	tye
BVAY	buay
TVBVTYS	tubutis
DVYNYNG	duening
VYNKV	vinko
AYVTYK	ivetic
AZALYA	azalea
GYVVN	givon
BAKYR	baqir
SAVAN	sawan
JVBAL	jubal
PASKV	pasco
MKGAVYN	mcgavin
LVKAS	lucas
DYVAR	dewar
KRYSTYN	kristin
HAMYLTVN	hamilton
FRASTY	frosti
AYRAY	airay
RVBY	roby
NYVARK	newark
ALVF	elof
BARGVS	bargus
BRVKAV	brokaw
BALDVR	baldur
HVRYV	horio
ASTRY	stray
ANV	anu
ASPYRZ	spears
'LYA	alya
ASPYR	spear
ASPVRY	sporay
NYHALANY	nihalani
DAMVN	damon
DVA	dua
ALY	ely
VAYGL	wigle
BVNYTZ	bonitz
TYNY	tiny
VYVA	viva
MANYSKAS	maniskas
TRVMBV	trumbo
MVNTANARV	montanaro
HALM	halm
KAMALA	kamala
SYTARAM	sitaram
HANYFA	hanifa
BAABAR	baabar
GAV	gao
SAKS	saxe
GARBH	garbe
JVSVYG	joswig
KLAG	klug
ALBAHAH	albahah
KVRDAS	kordas
KRAK	kruk
PRANGS	prongs
SYRYLV	cirilo
SYLVA	silva
GYLPYN	gilpin
KAPLYNK	kaplenk
ASKY	skee
KVYYNTVN	quainton
ASTYVZ	steves
MVNRV	munro
DANHAM	dunham
ANVKVL	anukul
TAYJMN	tijmen
VARTY	varty
MARKSN	marxen
NAKASVRA	nakasora
VYDYV	video
BABAR	babar
KRAVSVN	crowson
MYKVLYK	mikolic
HVLM	holm
KASYNSKY	kosinski
BRADY	brady
GRAYYNGR	grainger
ALVYN	alwyn
MVNTALBANV	montalbano
KVANLAN	quinlan
PYNKVVYTZ	pinkowitz
LASKALA	lascala
ATV	oto
GVRAN	goran
VLADV	vlado
LYNDL	lendl
LVATS	loats
BYNVY	binoy
AVHRMN	ohrman
BVLDT	boldt
ASKAL	scull
A'LY	aali
RABVYL	raboel
MVYNYHAN	moynihan
JANSJH	jansje
DAVKYNZ	dawkins
AFTAB	aftab
BRYANT	bryant
AKYN	akin
SYMVNDS	simonds
AYLKA	ilkka
HAVK	howk
ANVKVL	anukul
ASKVLYN	scullin
DVBYNYN	dubinin
MARTY	marty
ASKYPY	skippy
VYDAL	vidal
HAVARD	havard
DVNYNY	donini
AYLR	iler
SYMSYK	simcik
VYLA	vila
ARBYD	irbid
ANJY	engi
PLYNSKYN	plinskin
ZVRYNK	zurink
AYNGL	ingle
SAGARS	sugars
FAVST	faust
SYMAL	cemal
AMAL	amal
BALBYR	balbir
ASTRYM	stream
DANKV	danko
VALDV	waldo
ZYZY	zeke
ASTARBAK	starbuck
ADMVNDS	edmonds
KVBLA	kubla
APLYN	aplin
KVSMAS	cosmas
AVRKNY	orkney
ADRYS	idris
ADMVNDZ	edmonds
NVTZ	notz
SALMVND	salmond
FAYNLY	finley
NYNV	nino
KYTAMVRA	kitamura
DABYNSKY	dubinsky
BABA	baba
PVLV	polo
ANDRYA	andrea
TAKV	taco
ARAN	eran
AMYLY	emily
ASPYRZ	spears
SASLAV	saslav
VYDAL	vidal
RVSA	rosa
ALYMA	ulima
PARDYNGTVN	pardington
ASTAKS	stocks
NVDYNG	nuding
KARABVLVT	karabulut
JYA	jia
PRASAD	prasad
SVRYN	sorin
HAFSAH	hafsah
DYAMVND	diamond
DVRMA	dorma
AYVGNH	eugene
DANG	dung
HARYHARAN	hariharan
SAKSNM	saxnem
HVLKAMB	holcomb
FLARDYNGA	flardinga
ASTYK	astik
VYDAD	widad
RAV	rov
ASTRVK	strock
KAYT	kyte
TRVN	tron
BADZYAK	budziak
ALVARV	alvaro
MAV	mau
FABRH	fabre
ADH	ade
RYGV	rigo
HVRYV	horio
LAYVLY	lively
ASTYT	stith
ASPYR	spear
MAYZ	mize
RVSV	rosu
AYRYZARY	irizarry
KRVK	krok
ANRYKV	enrico
AVVRDAL	overdal
AGVYRV	aguero
LYVYNGSTVN	livingston
DYNY	dini
ARM	arm
LYVNZ	lions
TANAK	tanak
JAHMANH	jahmane
DRYNKS	drinks
VVLTRNYNG	woltering
GANDY	gandy
BYG	big
KRVSBY	crosby
AYNS	ines
KANG	kong
DVBVYS	dubois
PALVMBV	palumbo
GADYL	gadil
GADBVYS	gadbois
AYSAKS	isaacs
BARTA	barta
VYDAL	vidal
DAG	dag
KRAYJ	craig
PANFYL	panfil
SVNJA	sonja
SYMS	sims
FARYD	farid
RYDA	rida
KVYYT	quitt
DVNG	dong
ALSVN	elson
PVYSL	poisl
ASTYNTJH	steentje
ANTVNYV	antonio
JASTYH	justje
KRYSPYJN	crispijn
BVST	bost
ARMAND	ormond
RVNDA	ronda
ALSAP	alsop
ARDYS	ardis
HALTZ	holtz
BAYRN	byrne
ASLAVMYZ	slawomir
ASKYPY	skippy
HVRYNG	hornig
TRAVAJLYA	travaglia
LVKV	loco
JANSKY	jansky
RASV	raso
LYSVN	lison
FADL	fadl
AYNS	ines
FYNK	fink
ADKYNZ	adkins
AVLYVYR	olivier
PYYRY	pieri
JAD	jud
AKYTVMV	akitomo
KRAB	krab
LANG	long
AMARAL	amaral
JVSVYG	joswig
KRVM	crom
KRYSTYJNTJH	kristijntje
JVSLYN	joslin
FRAYDMAN	friedman
PVLK	polk
BRVKSL	brooks
SYNAN	sinan
NYVMAN	newman
ANANT	anant
MKRAYH	macrae
LVK	luk
VYTVR	vitor
BLASK	blask
MADVN	madon
KAKY	kaki
FVJYTA	fujita
ASTAKY	stucki
AMYLY	emily
FAYRVZ	fairuz
ASPANGLR	spangler
YAYN	iain
DAYLVN	dillon
KLAYTVN	clayton
AFA	afa
ADGYNGTVN	edgington
FRANSYSKVS	frnaciscus
HARRYG	harrig
GVRASPY	gorospe
AVSBVRN	osborne
ASKATY	scotty
SKSTVN	sexton
MASKYAS	mascias
FYNAN	finan
SYRYLV	cirilo
VAYMN	wyman
ASPYR	speer
KAYRD	caird
ASTANGYR	stangier
YVNYZA	unaiza
KRYSVYJN	krisoijn
ASKATV	scotto
TAYSN	tyson
KAPYLA	kapila
MVNKAR	moncur
AVBYD	ubaid
BVSTRVM	bostrom
RAYSTLYN	raistlin
NYKVLYK	nikolic
ADAB	adab
ANTYLA	antila
KVAYMAN	coeyman
FVRSAYT	forsyth
ANVS	enos
LYDYA	lydia
ANDRYS	andris
MYLKV	milko
MYLVS	milos
DANG	dung
AVZMN	ozmen
AVYAN	avian
HANYFA	hanifa
ALKAN	elkan
KVHN	cohn
