RVGVZA	rogoza
PRAYVYT	private
TABVK	tabuk
NAZARYTYAN	nazaretian
BVNVMV	bonomo
TAFTZ	tufts
BVSTRAM	bostrom
KANT	kant
JAYARAM	jayaram
TAFT	toft
DAVKNYZ	dawkins
HYVVYT	hewitt
KRYSSAYNTYH	chrescyntie
FAVST	faust
KVYN	kuin
PALSKY	polsky
HAVN	hawn
JVAV	joao
SYRYL	cyril
ASNV	snow
GYBVR	gabor
MVSY	musa
ANTYLA	antila
FADYL	fadil
KANT	kant
ARBANAS	arbanas
KALPAK	kalpak
BABAR	babar
MVYR	muir
ALYA	elia
AYNANA	inanna
BAY	bai
RYDH	rida
BYANGTAY	byungtae
KLAYN	kline
VVJAK	vojak
VANSY	vance
BASYLYSK	basilisk
AMS	ems
GYLYTA	geleta
PRASANA	prasana
PVHAR	pohar
DANYDYN	dunedin
BALKA	balqa
MKMAHAN	mcmahan
DRVDYS	drudis
ADGYNGTVN	edgington
MYGVYL	miguel
JAN	jun
RYDKVYST	rydquist
YVMVRA	uemura
TVSKANV	toscano
PVLYS	polis
VYRYANA	wiryana
BASYLYSK	basilisk
FARYD	farid
HAPKRAFT	hopcraft
GASTAVVS	gustavus
RAVT	rout
HVRYNG	hornig
LAVRAY	lawrie
ANAZ	anas
ZAYNAH	zaynah
AMYTAVA	amitava
BRYANT	bryant
LVRY	lori
BLVZVM	bloxom
KRYYK	creek
LYYVVH	lieuwe
ALYVT	eliot
BALSVN	balson
GRYNHAM	grinham
AVTVLYNY	ottolini
ANJY	engi
YVRANYM	uranium
BRYVNY	bryony
MVRANDV	morando
HARKYNZ	harkins
FRAMSVN	framson
LYNGAS	lingus
GVLVMB	golomb
TVKYV	tokyo
MYLYND	milind
HARDYN	hardin
HADSVN	hodson
LVN	lon
KARDYNALY	cardinali
AVGVSTYN	augustyn
KVNYNG	koning
PVHAN	puhan
KYBV	kibo
BASYN	basin
TAYJMN	tijmen
KVSTANZA	costanza
LAV	law
GYNTVN	ginton
KAYT	kyte
AYRYZARY	irizarry
PANDZ	ponds
KADRYBYSYK	kadribasic
DAY	duy
AMVRY	amory
LABRYVLA	labriola
ASTARKY	starkey
HAMMANZ	hammans
YARVN	yaron
LAYVRYTSN	lauritsen
BABYTZ	babitz
ANYSH	anisa
HAYVKZ	hawkes
LYMN	lymn
KARMVNA	carmona
GASTYN	gostin
GRYKV	greco
AMAL	amal
ASLAN	sloan
BABAR	babar
ASKP	skep
SYTJY	sytje
AYDA	aida
MADAKS	maddux
KAMPAGNA	campagna
LAMBVRN	lamborn
AZALYA	azalea
MYLVS	milos
KANYS	canis
JVDY	judi
KADYN	kadin
BAPTYSTA	baptista
VYRYANA	wiryana
ANDAMZ	adnams
GAVYNDAN	govindan
FRYTS	frits
JVAB	joab
RANY	rony
DRVR	dror
MARKVYZA	marqueza
BALDVR	baldur
BRAYNKLR	brinkler
PVRANYK	puranik
ASTANGYR	stangier
LADASKY	ladasky
SAVYN	savin
SAVARAM	savaram
BLASYVS	blasius
AYNGLS	ingles
SYTYA	cetia
HARMZ	harms
RVKAN	rukan
MKGVYRK	mcguirk
NAYA	nina
'LYMA	ulima
ASPYDN	speden
DYYALA	diyala
AVSN	osen
SVDARMV	sudarmo
ANTRAPY	entropy
AGYL	aqil
NVRY	nuri
BRYVNY	bryony
FRANSYNTYH	francyntie
AMVRY	amory
MARGVLYN	margolin
DYVYA	divya
MANK	monk
MVRANDV	morando
VYLDYNG	wilding
JVAB	joab
MANY	mani
FYNAN	finan
ASMYLY	smyley
JYNG	jing
LASK	lusk
SYMVNA	simona
FLVDYN	flodin
ALF	elf
FVNDV	fondo
RVNDH	ronde
TYMYAN	timian
DATRY	datri
KVANG	kwang
BAYLYNGTVN	billington
S'YDH	saida
GAVYN	gavin
ALVK	alok
ANTAL	antal
KRYSTYJNTJH	kristijntje
KRYSTYJNTJH	kristijntje
DABVYS	dubois
ALVYN	alwyn
ZAPARA	zapara
'YN	ain
BAT	bat
KRAMHVRN	crumhorn
PALYDV	pulido
FATYS	fotis
SAMANTA	sumanth
LYNDZ	lynds
TYNA	tina
GVRVSAMY	gurusamy
LAL	lal
DABVYS	dubois
VYDY	vidi
ADNAMZ	adnams
AMYH	amie
LYNDAL	lindal
ABVLYN	abolin
ASTRVK	strock
TAYJMN	tijmen
LVRY	lori
DYGAN	degen
SAMANTA	sumanth
KATRYN	katrin
AYNKH	einke
PRASANA	prasana
ASTRAK	strock
RADV	radu
ANAYLYN	anilane
RVNDH	ronde
RAYBLT	rybolt
RAGNVALD	ragnvald
AVRN	orne
PRAYVYT	private
KYLBY	kilby
YAV	yaw
LASNYK	lasnik
TYTAY	tytie
HALVB	holub
BRYVNY	bryony
GVRM	gorm
ALKAN	elkan
FVLKANYS	fulconis
GVNNA	gonna
AZAD	azad
KAYL	kyle
PATVKSNT	patuxent
RVSLYN	roslyn
MYTV	mitu
KVHAN	cohan
KANAKAKVRN	kanakakorn
ALAHDVD	alhudud
GRYYN	green
VYVYANH	viviane
RABVYL	raboel
LAMBDA	lambda
KAPLAN	kaplan
DAK	doc
AYSVN	asson
PALSKY	polsky
GVRYK	gorik
JYNG	jing
VYJNAND	wijnand
KVDAMAH	qudamah
KVYYLYN	quillin
RYHANH	rihana
ANATVLY	anatoly
KVNV	kono
BVLVS	bulus
ASTN	stan
BAJVA	bajwa
BRAYS	bryce
NAKAMVRA	nakamura
KVRDAS	kordas
KASANVVA	casanova
RYJSVYJK	rijswijk
BLAVADNYK	blavatnik
LABDVN	labdon
JAST	jost
BYR	bir
BYLAL	bilal
BYSAYV	bissau
TAKV	taco
BYSYN	basin
AYDYD	aidid
BAVKAM	bawcom
LVSANTVS	losantos
AVNAYZ	unaiza
VYTVR	vitor
'LAALDYN	alaaldin
BALTAYS	baltais
BARBAS	barbas
FADVR	fodor
KLAGSTVN	clugston
ASLYMAN	slimane
SAMVN	sumon
KAPSVN	kapson
ANBAR	anbar
BVDA	buda
AVSYVN	oseven
KARY	kari
DYKAVTY	decouty
GYVZ	guse
ALF	alf
SVHAS	suhas
YVNAS	yonas
BAYRN	byrne
DVARTH	duarte
RVKSAN	roxsan
RYDH	rida
DVSKV	dusko
PRVTVS	protus
ABYAN	abyan
AYSPVRT	iceport
MVRAD	murad
HYRVTA	hirota
LYBLYT	liblit
FRAZYYR	frazier
MVNAZ	munoz
DRVDYNG	druding
VAYN	vine
SLAT	slut
AYNTJH	eyntje
MATSVDA	matsuda
NAHAM	nahum
MARKHAM	markham
JAYARAM	jayaram
KANYA	kania
KAPLYNK	kaplenk
GAYA	gaya
DAHAK	dahuk
MYMAS	mimas
ASPANGLR	spangler
DVRAN	doran
LVNAV	lunau
JHANG	jhang
BVDV	bodo
MVRANV	morano
GAT	gat
KLYFTVN	clifton
ASKALY	scally
ASTVART	stewart
ALMAS	almas
HARKYN	harkin
TANG	tong
KARLAYL	carlile
ADMVNDS	edmonds
YASYRAH	yasirah
RYVNSVN	runeson
AVLSN	olson
NAYA	nina
DABAS	dubuc
AYSAK	isacq
ANSYH	anisa
DVLAN	dolan
AYTJY	oetje
SVLV	solo
MYSRA	misra
KYVSMATV	kusumoto
ASNL	snel
MVRAVAN	moravan
ZVRYNK	zurink
NYMTZ	nimtz
BAPTYST	baptist
SANA	sana
ABH	abe
AVANZ	evans
LVRY	lory
BANYTV	bonito
TRAFTVN	trafton
DRVDYS	drudis
MADVRAY	madurai
NYKVLA	nicola
ARMAND	ormond
FYNK	fink
VALDRAM	waldram
AGYLA	aqila
LYBYD	lebed
AMYVT	amyot
JHANG	jhang
FADYL	fadil
SVHA	suha
SYMVNA	simona
FVNDV	fondo
VAJDYK	vajdic
GYLPYN	gilpin
PARDYNGTVN	pardington
ARYKA	erica
AVGVR	augor
DAV	dow
HVLM	holm
STRATVN	straton
PAYNY	payne
JAYAN	jayan
BALDYNGTVN	baldington
DYMARYP	dimaryp
BARKAY	barkai
PRANAV	pranav
ALKAN	elkan
MKGVYRK	mcguirk
GYRARD	girard
MYNTVN	minton
SVLTAN	sultan
ASTVRLYR	storleer
LANY	lani
AYSMN	isman
BVNVMV	bonomo
SANTSBRN	sansburn
'LAALDYN	alaaldin
KYTAMVRA	kitamura
ALAPATY	alapati
GALAHAD	galahad
YARLA	iarla
MS'VD	masud
MANVLY	manolo
JVHANSVN	johansen
RAST	rust
MARY	mary
ALMYNTAKVA	almintaqah
FRYTZYVS	fritzius
SYKARV	sekora
LYNDVN	lyndon
KVSTA	costa
SANG	sang
LVNZ	lunz
HART	hurt
AVRVM	avrum
AKVNA	acuna
MVZYNA	mozina
MVHAN	mohan
PANYSY	panici
AYBYRVNK	ibironke
PRAHL	prahl
ANDR	andr
YVNYZA	unaiza
BRAYD	bryde
KAMPTVN	compton
VASLV	waslo
JASTAS	justus
FRANSYSKA	francisca
ARFVRD	orford
SYKY	siqi
GVAN	guan
AMADVR	amador
AVVRDAL	overdal
ADKYNZ	adkins
BYRK	birk
BYRNH	byrne
GASKYNZ	gaskins
AGVYRV	aguero
HAHTAHA	huhtala
AVRAHAM	avraham
ANTVNYVS	antonius
DYVYDYAN	davidian
LVYYNG	luinge
JYBSVN	gibson
DAG	dog
ABVBA	aboba
RVBVZ	roboz
KRAVFVRD	crawford
KVSTA	kosta
MVRYN	morin
PARSVNS	parsons
FAGAN	fagan
MARLYN	marlin
AMARAL	amaral
FATYS	fotis
TAMZ	toms
KRAK	kruk
PARKYN	parkin
BLVNSDVN	blunsdon
KAPRAL	kapral
BAB	bob
MVNTAG	montag
JARVYS	jarvis
BAS	bas
MVN	mun
LYZARD	lizard
ADAN	adan
KRYVVNVZ	kriwonos
KLARK	clark
KAMAMA	camama
ASTARGS	sturges
LVDVVYKAS	ludovicus
BLKSVM	bloxom
MAVBY	mawby
ASLAVK	slawek
YANVVYTZ	yanowitz
JYZAN	jizan
DAKLVZ	ducloz
PRAYL	prael
SYKVRA	sikora
AYS	ace
DANSY	dancy
MAHAJAN	mahajan
MARTYZN	martijn
KARHART	carhart
KAYN	kain
ASKRYBLYNG	scribbling
TVSYNG	tusing
SVRYN	sorin
FLARDYNGA	flardinga
DYVYDYAN	davidian
TRAVAJLYA	travaglia
VYLKYNSVN	wilkinson
KALYARV	caliaro
LYZARDZ	lizards
ARLYNDH	arlidge
VARGAS	vargas
SAVARAM	savaram
GADYL	gadil
KVLYHA	koliha
DRAVN	drown
PATRYK	patric
ASKRYV	screve
RYDKVYST	rydquist
LASNYK	lasnik
ZVRYNK	zurink
RASKYN	raskin
JYNG	jing
AVTVLYNY	ottolini
AVRFYVS	orpheus
AYNKH	einke
TAT	tat
LVNAV	lunau
SYTV	seto
GVH	goh
GAV	gao
MARGVLYS	margolis
LADYVYL	ladeuil
BARLAS	barlas
GRANDASTRVM	grundstroem
VYNSVN	vinson
NARLA	narla
AVMAKY	ohmaki
MAVBY	mawby
AKY	aki
MAHA	maha
MARVYN	marvin
GVPALAN	gopalan
LYVYNGSTVN	livingston
PRVY	pruy
SANDMAN	sandman
KANG	kong
AVADYA	awadia
PYYK	peak
MAYSAL	missal
DARVN	doron
BAKSKA	bocska
HYNDRYKA	hendrica
AVYAN	avian
MATA	mata
BKS	bex
LAYRD	laird
YAMN	yumn
PVRKV	porco
MARZ	marz
FRAYTGRSA	fritgersa
KAPLYNK	kaplenk
PANAS	panas
ANAZ	anas
ABYNA	ebina
ARPYN	arpin
PVYNT	point
RADVF	radov
MALAN	malan
BRYJ	brij
NYKALAS	nicolas
VYNATA	vinata
MARVYN	marvin
BLVM	blum
AKYL	aqil
ARAM	oram
PYNTVN	pinton
LYMBVRG	limburg
AMY	ami
BADYG	budig
ADMVNDZ	edmonds
GABVR	gabor
LVYYZV	loizzo
LVDVVYKAS	ludovicus
PAYK	pike
ASTV	stew
TVMY	tomi
SANVNDV	sunondo
JAKVBS	jacobs
BVZVVA	bozuwa
DVRAN	doran
AMNA	amna
GVYYN	gwynn
RAMVLVS	romulus
LYDVYNA	lidwina
ZHRA	zara
AMYTAVA	amitava
ANRAH	unruh
DRAVN	drown
PYRANY	pirani
DYVAYN	divine
SAKSNA	saxena
BVZKART	bozkurt
KYNARD	kinard
YARVN	yaron
ASPARNDAM	spaarndam
DAN	dan
MANAMA	manama
GRVHVL	grohol
RVBYNSVN	robinson
ARAN	eran
LANGSTVN	langston
KARHART	carhart
SASLAV	saslav
ASKVLY	ascoly
AYT	ait
MVTYSV	mutiso
HALY	hale
PRAYB	pribe
SYHSVBHVN	sihsobhon
MVRAD	murad
'FAF	afaf
AKTVN	acton
FRANKV	franko
MAVBY	mawby
ALVYN	alwin
GYBVR	gabor
LYNDVN	lyndon
KVRNZ	corns
HYRAY	hirai
HAMARKVYYST	hammarquist
LAYVVY	lieuwe
KATRYN	katrin
MVNTA	monta
BANKRVFT	bancroft
LAHYJ	lahij
DYKYNZ	dykins
YVNYZA	unaiza
TAY	tye
KYNGSTVN	kingston
LKS	lax
SYMYNGTVN	symington
SANDMAN	sandman
RAMBV	rambo
MARYV	mario
KYRYL	cyril
ARAYZ	aries
ASPYDN	speden
SYTLAYV	cittlau
'FAF	afaf
DAMVN	damon
GRYGVR	gregor
AFTAB	aftab
MANRV	munro
PANT	pant
KARHART	carhart
RALF	ralf
GAY	guy
BRYSBYN	brisbin
KVYALYK	kowalik
BARYAKS	bariaux
VYDAL	vidal
ANTVNY	antony
SVHA	suha
GRYNHAM	grinham
KVYALSKY	kowalski
ANTYLA	antila
AMBRVSYVS	ambrosius
TAMATYVS	tomatius
GYNTVN	ginton
AYSRT	israt
FAVAZ	fawaz
BVRM	borm
LAP	lap
ZVRYNK	zurink
FVRSBLAM	forsblom
MAKAYVLY	macauley
MARKVYZA	marqueza
VYLHAYT	wilhite
ARMAND	ormond
MARTYNTJH	martyntje
RASV	raso
BARNABY	barnaby
AYGLV	igloo
TVMATYVS	tomatius
FVRSAYT	forsyth
RYYD	reed
FLVYD	floyd
VYKTYM	victim
BRAYS	bryce
MADYV	madeo
TAPLYN	taplin
AYDYD	aidid
ABY	ebe
AVRFYVS	orpheus
RATKS	rutks
KATALANV	catalano
DAV	dow
RAMVS	ramos
SALVMVN	solomon
ALFVRD	alford
MAYRZ	myers
ASTYT	stith
GALYLA	galila
BARNABY	barnaby
NVLAN	nolan
MAGVAYR	maguire
ASTYD	stead
BVRG	borg
RYVDT	ruudt
MAMA	mama
PRASANA	prasana
KVDAMAH	qudamah
KRYSJH	krisje
APRYL	april
HYNSVN	hinson
BRAYNKLR	brinkler
VYGTVN	wigton
JYNG	jing
RVYAL	royal
AYNKH	einke
BAPTYSTA	baptista
SVKVMAR	sukumar
ANGLAND	englund
AJAY	ajay
VAYN	vine
KAYT	kyte
PARHAM	parham
AVDRA	audra
KVBV	cobo
KANSTABARYS	constabaris
KAV	cau
KATALANV	catalano
PVLK	polk
DYVYDYAN	davidian
HYJDAN	higdon
KVYALYK	kowalik
ADKYNZ	adkins
FARKAS	farkas
LAV	lau
JVBAL	jubal
ALF	elf
GALYLH	galila
FRAYDA	frieda
KANV	cano
MADVN	madon
JVAN	juan
AKLVF	eklof
NYVMAN	newman
BARKSDYLY	barksdale
'DYL	adil
YVZR	user
BALSVN	balson
SAMVYL	samuel
FVLKANYS	fulconis
BRANSDVN	brunsdon
ASKAVN	skaven
ASTVN	stoun
BYFRAST	bifrost
MAGAGNA	magagna
MARGVLYVKS	margulieux
JAMVNA	jamuna
BRVTY	bruty
KARY	kari
PYZVLYTV	pizolato
MANY	mani
AMYNA	amina
BARY	bari
FRAYTGRSA	fritgersa
DYSANTV	desanto
BARKVLV	barculo
TATSVRV	tatsuro
MVN	mun
MYMY	mime
KAMBYY	combee
PVYV	pouw
AYK	aik
SAYKS	sikes
TVNAR	tonar
SATVR	satur
TATARY	tatari
BARY	bari
BYLYNGASLAY	billingsley
ATKYNZ	etkins
DYKYNZ	dykins
TYNG	tyng
HYNDRYKA	hendrica
KARSVN	carson
ASPVTYS	seputis
MVHAN	mohan
RABYDYAKS	robideaux
PATRYSYA	patricia
AYRL	earl
ABST	obst
ASKADZ	scudds
KVJYAS	kogias
ANAND	anand
DRAVN	drown
GALKV	galko
JAGARD	jagard
VYKAS	vikas
LVMAS	lomas
SAYKS	sikes
ATRAM	atram
LYZ	liz
KVDY	cody
'AYMN	ayman
DANKV	danko
ASTYANSN	stiansen
TVVYS	twiss
VAN	wan
FLVYD	floyd
RAMVLVS	romulus
ATYNZVN	etinzon
