BVSTRVM	bostrom
DYMA	dima
TRVN	tron
TYTMAS	titmus
MVBAY	mawby
ANVJYT	anujit
LVNAV	lunau
HALVB	holub
ADAB	adab
PVRVS	proos
ANTRVSYV	antrosio
JVNV	juno
DAGAN	dugan
GALPYN	galpin
MYNTAKAH	mintaqah
ASMYD	smead
VYLJV	viljo
KRAYJ	craig
PVKVRNY	pokorny
DYMYTRYS	dimitris
VYLJV	viljo
HARTAH	hurtah
PRAM	pram
KLAVDYA	claudia
RYNG	ring
BRANSDVN	brunsdon
HRABY	hrabi
AYALA	ayala
AYMAN	ayman
KASANVVA	casanova
SAVARAM	savaram
PRYSYNG	pricing
NARAD	narad
ALAHDVD	alhudud
AMNVN	amnon
DYVYS	divis
ASTYL	steel
AMARYT	amarit
AYTCVN	itchon
LAVRAY	lawrie
KALSYN	calsyn
KAMAL	kamal
PLATFVRM	platform
ALVA	alva
AZALYA	azalea
RADHYKA	radhika
MARTYNTJH	martyntje
'RBYL	arbil
DAVAD	dawud
ABYNA	ebina
KARYDA	karida
JVANG	juang
BYZVAS	biswas
JVHANY	juhani
GARSYA	garcia
ARYK	erik
MVRAD	murad
TAPTANY	toptani
RVBYNSVN	robinson
YVBYRA	ubiera
SYVNKA	cionca
MANV	mano
SYKY	siqi
AYLYNG	ayling
PVRTNVY	portnoy
JVRY	jory
PYRYZ	perez
ASMYRNV	smirnov
FRAMSAN	fromson
MARKHAM	markham
GRANDASTRVM	grundstroem
ASPVRY	sporay
BLVNSDVM	blunsdon
VANG	vang
AYVSV	ayuso
HYJDAN	higdon
YARVS	yaros
DYDA	rida
TAKY	taki
MARTY	marti
RAVDAH	rawdah
GRAYYV	grieve
LAYBZ	libes
PAKVAT	paquet
BYRNH	byrne
KAMPAR	kompar
HARYHARAN	hariharan
TAKV	taco
SYLVAN	sylvan
NAYKVLAS	nicolaes
MANK	monk
KAYRD	caird
RVBYN	rubin
ALFARV	alfaro
ARSKAYN	erskine
AZALYA	azalea
ALVYN	alvin
DRAP	drop
KYNGSFVRD	kingsford
DYVAYN	devine
BAZBY	buzby
FRAYTGRSA	fritgersa
ZAHYD	zahid
DYL	dil
HVRSFVRD	horsford
JYN	jin
KRH	kre
KAGBVRN	cogburn
ADMVNDS	edmonds
HYYN	hean
DVBVYS	dubois
TYYVLN	thulen
BVNYTZ	bonitz
GVRDYN	gordin
BARD	bard
YANYV	yaniv
JARVYS	jarvis
MYLASYS	milacic
NADVLNY	nadolny
LYVYS	lewis
JVSLYN	joslin
'LYA	alya
LYYVVH	lieuwe
PARKZ	parks
MANKS	monks
ADYNA	adina
LARA	lara
BVZKART	bozkurt
BRAYR	brier
AYSPVRT	iceport
DVMYNYKAS	dominicus
DYVAYN	devine
HAMPTVN	hampton
KVLASA	kolasa
AYLYN	ileen
ADNAMS	adnams
FVJY	fuji
ASKV	osku
KAMPAR	kompar
ALFVRD	elford
MARTYJNTJH	martijntje
BALYT	balit
LYVYVY	levavy
LYVYVY	levavy
PYVN	pion
AVRCARD	orchard
BLANZDVN	blunsdon
ASKVYVYL	esquivel
BARLAS	barlas
KATLYR	cutler
HADSVN	hodson
BRANT	brunt
KVMPTVN	compton
MARKV	marco
KLARK	clark
FRYNK	frink
MVNTANARV	montanaro
ALKS	alex
HARTAG	hartog
HVNG	hung
DRVDYS	drudis
RAVY	ravi
GASTAVVS	gustavus
PYNSVN	pinson
LALY	laly
ASLNGZVALD	slangsvold
HANY	hani
LAL	lal
FRYTZYVS	fritzius
ASPYR	speer
AVN	aun
AL'YN	alain
TATARY	tatari
AFAF	afaf
AYSVN	asson
HALAT	halat
ANGLASMA	engelsma
MARK	mark
SASKA	suska
NAYLZ	niles
SYTARAM	sitaram
JYVK	jiok
ANAGRAM	anagram
MYGVYL	miguel
ALVK	alok
BARTA	barta
GAMBYNV	gambino
TAMAS	tamas
PVLV	polo
HVLRVYD	holroyd
GVPALAN	gopalan
SYLVA	silva
KVKAL	kokal
SALVMVN	solomon
BRAVN	brawn
VYKTYM	victim
MAV	maw
GYVZ	guse
BRVKSL	brooks
KLBAY	kilby
SRAYNH	shryne
MYRTY	mirti
NAKASVRA	nakasora
KVYL	quel
GARMZ	garms
HADSVN	hudson
YAGLA	yagla
NAM	nam
HARYHARAN	hariharan
KRAVSVN	crowson
DAMYVN	damion
RABVYL	raboel
MVNRV	munro
KYSVN	cason
TVBYAS	tobias
LAYVRYTSN	lauritsen
MVNTANARV	montanaro
ASK	ask
MAYSAL	missal
TAYMN	tymen
AMYVT	amiot
BRAN	bron
RAFALSKY	rafalski
GVH	goh
YVNGSAP	yongsup
LAVZAK	lauzac
HYVKYNZ	hawkins
ZYGMVNT	zygmunt
BRAN	bron
PRAHL	prahl
AVRM	orem
SANTYK	santic
GVDATA	gudata
AZANA	ozuna
ASLNGZVALD	slangsvold
KVYALYK	kowalik
KRYSTYJNTJH	kristijntje
KRAMHVRN	crumhorn
BRAYR	brier
DANYYLS	daniels
NYDA	nida
YYKA	yeka
NYMTZ	nimtz
ANV	anu
AKSFRD	axford
SYNAN	sinan
RAVDAH	rawdah
RAYDN	ryden
MANYSKAS	maniskas
SAKSNM	saxnem
ASTRYDM	strydom
DYSMVND	desmond
LAMBARD	lombard
TAFTZ	tufts
AYNGLYS	english
GLVRYA	gloria
SASAKY	cacace
GALYLA	galila
PASKAL	pascal
BRVDA	broda
FLAYGYR	flygare
NYVMAN	neuman
AYVSV	ayuso
FYSK	fisk
KVYYT	quitt
TVAMA	tuama
JAYARAM	jayaram
MANVLY	manolo
VASYK	wasik
KYLG	kilg
JANA	jana
RABYJN	robijn
RVTABAGA	rutabaga
PAYTVN	payton
JVRAH	jurah
KVNV	kono
KVRNZ	corns
KVYL	coil
ZAYRA	zaira
HYTSVN	hitson
BRAYSLAV	berislav
KLARK	clark
MVNKZ	monks
AMBRVSYVS	ambrosius
MABAY	mawby
BRANSDVN	brunsdon
PYNDAR	pindar
LABKYN	lubkin
GLDASTYYN	goldsteen
AVRM	orem
BRADY	brady
VARYANTS	variants
SVRK	sorc
NAGASYVA	nagasiva
KVAYNTVN	quainton
SRAYNH	shryne
MATLV	mutlu
BAPTYSTA	baptista
AYVTYK	ivetic
AMLAK	amlak
LYBYD	lebed
AMYT	emit
PARHAM	parham
YANSVN	yanson
ARAM	oram
ANYL	anil
AMS	ems
HAPKRAFT	hopcraft
SYMVNA	simona
ARBYD	irbid
AVZBRN	osburn
AVN	aun
MVRAS	moras
VYRJYL	virgil
ANTANAYTYS	antanaitis
GRAYYV	grieve
ALVAN	alwan
ANAYZA	unaiza
LVSY	lucy
RVKSAN	roxsan
DAV	dow
GANDY	gandy
AVR	ore
LYVNARD	leonard
DATSVN	dotson
LAM	lam
MADVRAY	madurai
ANTYLA	antila
BASKAR	baskar
DVSTY	dusty
SYLVA	silva
KRAVSVN	crowson
SAMZ	sams
PALYDV	pulido
MANGAN	mangan
BASKY	bosky
BAYLZ	byles
MYLKV	milko
FLAT	flat
DYK	dik
HVRYNG	hornig
BAVKAM	bawcom
HAYD	hyde
AVLSVN	olsson
VYNTVN	winton
ABVDHABY	abudhabi
KVTLA	kotla
ALMV	elmo
ADH	ade
ASMYRNV	smirnov
DVALYBAY	dowaliby
AMA	ama
ADYT	adit
KVSMAS	cosmas
HAV	haw
SASTYK	sustik
TAHRYHA	tahirah
SANDHV	sandhu
MANY	mani
LANTZ	luntz
BRAVN	brown
RANKYN	ronkin
HAYRVNYMVS	hieronimus
FRAYDA	frieda
DVNG	dong
ASTABZ	stubbs
SVA	swa
RAKVN	rukan
SVHM	sohm
BAYLS	byles
MAYRZ	myers
LVSYTV	losito
BRYANT	bryant
AVSYVN	oseven
GNVSYS	gnosis
VYDYV	video
TRYVYTZ	truitje
LAMBDA	lambda
LYKYVRY	liquori
LAYND	linde
SAMVSKY	samosky
TYMVNYN	timonin
RVHN	rohn
KANYG	konig
LVYYZV	loizzo
GRAF	graf
BRYGVY	bryguy
MYSA	mesa
ASTVN	stoun
SANTSBRN	sansburn
MARYNV	marino
SAVLZ	sauls
BAD	bud
SAVYR	sauer
TVNGA	tunga
LYZ	liz
ASTANVL	estanol
BAYDA	bayda
GAT	gat
SVHAS	suhas
KRYSTYNA	kristina
ASKVYVYL	esquivel
AYSTYN	istian
ANRYKV	enrico
TAKSBRY	tuxbury
ASTARGYL	sturgill
KAVS	kaos
KANYG	konig
GALPYN	galpin
DANYLV	danilo
GANG	gang
FALSAM	folsom
BYANGTAY	byungtae
MASATV	masato
SYNAN	sinan
LAST	last
PALVMBV	palumbo
LAYVLY	lively
FADYL	fadil
LYPKYN	lipkin
FADL	fadl
DANY	dani
KARASV	karasu
VAYLDR	wilder
PAPLY	popli
KVMVRV	kumoro
VYRYANA	wiryana
AVRAYZ	averis
JAKVMYNTYH	jacomyntie
BAB	bob
'LAALDYN	alaaldin
AYS	ice
LABKYN	lubkin
PYRAMYD	pyramid
BYAVYS	beavis
HAYD	hyde
SANK	sunk
BRYSYNDA	brisinda
ARASMVS	erasmus
DVBYNSVN	dobinson
JAMVNA	jamuna
VYLASKV	velasco
RVNY	roni
RAFALKV	rafalko
MAVBY	mawby
RVLDAN	roldan
AMY	ami
LYNDAL	lindal
MARTYN	martyn
KRVG	krug
ABYNA	ebina
YVNAS	yonas
ASPARNDAM	spaarndam
RYVDT	ruudt
ANRAH	unruh
ALM	alm
HVLM	holm
FAVST	foust
ANTVNYS	antonis
'LAALDYN	alaaldin
TYV	tio
ASKVLY	scully
VYK	vic
SANK	sunk
AYTJY	oetje
LANKART	lonkart
YARLA	iarla
BANKS	banks
JYNTVN	ginton
HVA	hua
AKYL	aqil
KAYA	kaya
ARBANAS	arbanas
BRYSTVL	bristol
ZAZA	zaza
BRYTVN	breton
PATRYZYV	patrizio
DYNA	dyna
RVBYN	rubin
SABRAMANYAM	subramaniam
KAZY	kazi
ZVVAYTA	zuvieta
VYLADVT	viladot
GVRTVN	gorton
TRAYNTZ	tryntje
MAYR	mire
BANDZ	bonds
VYKTVR	victor
TVSV	tuso
TARVB	tarub
PVRTNVY	portnoy
PYNTVN	pinton
GVRALP	guralp
JVANG	juang
KVBSA	kobsa
ALVAN	alwan
SAMZ	sams
RYYNKS	rienks
YAMHA	yamha
MARSY	marcy
VYNZ	winz
PVYV	pouw
LVSTY	lusty
RAFALSKY	rafalski
NYVAYNGTN	newington
SVAMY	swami
GVRDYN	gordin
DYKSVN	dixson
KVNV	kono
KYNA	kina
AMARAL	amaral
RYMVN	rymon
BANKS	banks
KRYSTYN	kristin
'ADL	adel
BARTHVLVMYVS	bartholomeus
TYMYAN	timian
DAKLVZ	ducloz
DANLVP	dunlap
HAKABAY	huckaby
ASPVSTA	spousta
KVBV	kubo
ALYSYA	alicia
BANKS	banks
BANKS	banks
DABAS	dubuc
MVD	mod
SVKVL	sokol
AKGAN	akgun
MANTVR	mantor
BRANDY	brandi
SANZBVRN	sansburn
KARPLAS	karplus
GRYSVALD	griswald
ASPRVT	sproat
BALBYR	balbir
ANTVNY	antoni
BRAY	brie
GAYVN	gawne
GVPALA	gopala
TAPYK	topic
BYPYN	bipin
FLAT	flat
JAYAN	jayan
PRAPYS	prupis
ASPYDN	speden
RAM	ram
AYRD	aird
HAJ	haj
DAYR	dyer
DYL	dil
GATZ	gatz
LANGDVN	langdon
SYRAFYN	serafin
ABYNA	ebina
ALYNGTVN	alington
RADAK	radek
PADVLA	padula
JYNTVN	ginton
ASRAT	israt
ANTARAMYAN	antaramian
BALKA	balqa
HVRN	horn
RASTYN	rastin
PANDA	panda
AVTV	otto
KATLYR	cutler
PYRVZ	piroz
RYMVN	rymon
YVRANYM	uranium
ARNH	arne
VAN	wan
ALYA	elia
LYDVR	lidor
TAMY	tomi
PAY	pai
DYVYDYAN	davidian
BYAVYS	beavis
RVBYNSVN	robinson
SAKAYV	sakaue
ASTYANSN	stiansen
LAYBZ	libes
KVYST	quist
GVPALAN	gopalan
FYNAN	finan
NAPVLYTANV	napolitano
LVNAN	lonon
ASBRYNK	asbrink
BYVAN	bevan
DYVYS	divis
ADVVART	eduwart
MATSVMVTV	matsumoto
KRVSBY	crosby
NYVMAN	newman
MARAT	marat
KRYSTYAN	kristian
ASTRVK	strock
AMARYT	amarit
'BDAL'ZYZ	abdulaziz
MAHAJAN	mahajan
TAYRAY	tierie
LANG	lung
KASTA	costa
AVSBVRN	osborne
SRAYNH	shryne
ASKLVYR	sklower
FALTAK	foltak
GVRAV	gorav
FRAYTGRSA	fritgersa
GRAYYNGR	grainger
YARMAN	yarman
BAYDA	bayda
VYKTYM	victim
LYRYK	lyric
SANTVS	santos
MAMFVRD	mumford
ABAD	abad
TVNY	tony
KADV	kado
BLASYVS	blasius
DVBAY	dubay
GAYNVR	gainor
RVTZ	rotz
PVZYVS	posius
KAVH	kave
KANDV	kundu
VYLKAS	wilcox
DAMYVN	damion
BAKAYA	bakaya
KRYSVJYN	krisoijn
'BDAL'ZYR	abdulaziz
BANKRVFT	bancroft
SAVSAN	sawsan
DVRDAL	dordal
ASPATSVVD	spotswood
DVRAN	doran
HARMZ	harms
TALYBAH	talibah
DVRAN	doron
NVKS	knox
SYMPLYSYTY	simplicity
SAYTV	saito
PYVN	pion
BASMA	basma
FRANSYNTYH	francyntie
KATRYNTJH	katryntje
MYNAMV	minamo
NVKV	noko
BYVDVYN	bauduyn
HARALD	harald
ASTRYAN	stroyan
RYDKVYST	rydquist
ASTYNTJH	steentje
SVR	sor
PARSVNS	parsons
MAKARAYG	macaraeg
TYSZA	tisza
HAVKYNZ	hawkins
GRYT	grit
GARSYA	garcia
ANAY	anay
PVYSL	poisl
BAYRTYH	baertie
ANTVNYVS	antonius
KVNG	kong
KLARK	clark
ASTAG	stagg
RVY	roy
SALVMVN	solomon
DVSTY	dusty
BLYNKV	blinco
BVRM	borm
BRVKSL	brooks
HRLAYNDYZ	herlindis
BAJVA	bajwa
A'LY	aali
ASTRAK	strock
KYMVN	kimon
AYMAN	ayman
AYVRS	evers
LAVYGNH	lavigne
ZVRYSYKA	jurisica
RASKYN	raskin
DYMYTRYVS	dimitrios
BVDY	budi
GYLRVY	gilroy
BYGV	bigo
DARBY	darby
LAMASTVS	lamastus
BRVYN	bruyn
SAMGYN	sumgin
SANZBVRN	sansburn
ASMVT	smoot
LAFGRYN	lofgren
ARGAR	orgar
GRYT	grit
MYKVLYK	mikolic
RAV	rov
ASTV	stew
MKMAHVN	mcmahon
PRYYVTY	priotti
KYVZVN	quezon
ASTYSY	stacey
AYSYZAKY	ishizaki
MAHAVLT	mahault
KAY	kai
MASARA	masaru
DYNY	dini
YVRANYM	uranium
NYPTVN	napton
GVPTH	gupte
KYPLYNG	kipling
MYNKY	minqi
BRANSDVN	brunsdon
RAYDN	ryden
ASKADZ	scudds
MATAR	matar
ASTYGBRG	stigberg
MYLAM	milam
FYN	fin
MANDAR	mondor
RYBAR	ribar
MYTRVVYK	mitrovic
BASKAR	baskar
MYTV	mitu
SYKY	siqi
LVDVVYKA	ludovica
DYMYTRYS	dimitris
VYMPYJ	wimpje
ALSVN	olson
BASKY	bosky
ASPLYNTR	splinter
DAVNYNG	downing
VAYL	vail
PASKV	pasko
TVBYAS	tobias
ANANT	anant
RVMYG	romig
'AYMN	ayman
PRASANA	prasana
JYGANG	jigang
GAYNVR	gainor
BALYT	balit
RVNGV	rongo
TAMAS	tamas
SASKA	suska
DANLVP	dunlap
RYHANA	rihana
LYNDL	lendl
AVAD	oued
DYNG	ding
PYVRYNTN	purinton
ALTZ	oltz
LVMAS	lomas
ABAD	abad
AYSKANDR	iskander
MVHAN	mohan
GRAYYV	grieve
KVRY	kory
BARKAY	barkai
TRAVN	trown
MARKVPVLY	marcopoli
DRAYNH	draine
MYMAS	mimas
TVLAY	tully
SYLVAN	sylvan
ASK	ask
BRAVV	bravo
KAMBYY	combee
ANVKVL	anukul
RASTY	rusty
GAVYN	gavin
RABYDYAKS	robideaux
AMVS	amos
ASKATV	scotto
HVRST	horst
DRYV	drew
JANG	jong
SABRAMANYAM	subramaniam
SANTSBRN	sansburn
MYSA	mesa
AYDYD	aidid
VYLKYN	wilkin
RASTY	rusty
MANDAL	mandal
MVSY	musa
JVNYVR	junior
VVLTRNYNG	woltering
MVNTALBANV	montalbano
ANFANT	enfant
VYRAF	viraf
AKYL	akil
AVKYNZ	oakins
DVRAZYV	dorazio
HAYNGH	hainge
LANTZ	luntz
FARKAS	farkas
TVM	tom
ANDRYVZ	andrews
TVLYV	tulio
