KVYYLYN	quillin
ASTRYTY	steriti
MYLASYS	milacic
BABYTZ	babitz
BRAVNYNG	browning
RAJ	raj
PARSANZ	parsons
PATVKSNT	patuxent
FLYKS	felix
KVRY	kory
MKDVNALD	mcdonald
BARTVN	barton
TYNG	tyng
HANKZ	hanks
ALDYN	eldin
KLYFTVN	clifton
FRAMSVN	framson
DRAVN	drown
BADZYAK	budziak
BRAM	bram
DAMYANV	damiano
AVLVSTAD	ulvestad
TRVYYJH	truitje
ASLVN	olson
MYNTVN	minton
LVNAN	lonon
ALSAN	olson
AVSYVN	oseven
LAZARA	lazara
KRVM	crom
ARVNAH	arunah
PAYNH	payne
KVYYNTVN	quainton
ANAY	anay
BAKSKA	bocska
FYGVRA	figura
GASTAVVS	gustavus
KRANSVYYK	cranswick
AYNTJH	eyntje
ALVYN	alvin
HRLAYNDYZ	herlindis
AKMAN	akman
KALAFVT	kalafut
ASTFANV	stefano
JYM	jim
MYKVLYK	mikolic
ASTRYM	stream
HVGAN	hogan
BRYAN	bryan
AKGAN	akgun
ALVARVS	alvarus
HARARY	harari
BASTYK	bostic
KAYRD	caird
FABYANV	fabiano
KVYL	coil
DYAMANTARAS	diamantaras
MATANA	matana
ASKY	skee
DAYVYN	divine
HVLKAMB	holcomb
ASTN	stan
JAKVBY	jacoby
RAMBV	rambo
VYMPJH	wimpje
DVRA	dora
GRAYYV	grieve
ASLVN	olson
AVGVRY	aogori
ALYN	olin
PRAYL	prael
LANTZ	luntz
AVHALVRAN	ohalloran
BVDLA	bodla
HAVVLA	havola
JAST	jost
GYVYN	gavin
ANALVG	analog
GRYST	grist
KASTRYKAM	castricum
JVRY	jory
DNVKS	denux
LAYND	linde
NVRA	nuri
BLANSDAN	blunsdon
YAP	yap
LANG	lung
SAVYR	sauer
BARVA	barua
DAMYVN	damion
DART	dart
LKS	lax
BVKSY	buxey
BADYG	budig
HYVVYT	hewitt
LYZARD	lizard
PVPAT	popat
MARGARYTA	margretha
FYDALGV	fidalgo
HRLAYNDYZ	herlindis
'BVDHABY	abudhabi
ASTVARD	steward
VATV	vato
ASTVART	stewart
VYVLA	viola
HALVB	holub
FAYNLY	finley
ANTVNY	antony
DVDAMANY	dodamani
GAMAL	gamal
FRAZYYR	frazier
KARYAGA	cariaga
AKYLAH	akilah
RVKAN	rukan
AKGAN	akgun
AYRAY	airay
PAYTR	pitre
GARSYA	garcia
KANYS	canis
KAYNY	caine
SVRAB	sorab
SVTV	soto
KRVB	krob
LAMBDA	lambda
BAVKVS	baukus
SVZALYS	susalis
HYN	hin
KYNYVN	kinyon
ADYH	adie
BAYLS	byles
FARAT	furat
KVBSA	kobsa
HVLM	holm
KASVN	kasun
RAV	rao
DAVVD	dawud
DAG	dag
AYVGNH	eugene
FRANKV	franco
ANVPAM	anupam
HVRGAN	horgan
FALKV	falco
VARTY	varty
KARY	kari
AMYTAVA	amitava
PATYL	patil
KVYSMAN	coisman
ARMATV	armato
RAV	rao
BARKVLV	barculo
RAY	rai
BYPYN	bipin
NAKAMVRA	nakamura
MARYTJY	maritje
S'YD	said
AKYLA	aqila
S'YD	said
ASBRYNK	asbrink
VARYANTZ	variants
VYLYNGZ	willing
PRABST	probst
ASTYVNSVN	stevenson
DANZ	danz
DVGAN	dogan
AVAN	awan
SYMYNGTVN	symington
HAFS	hafs
DYLAN	dilan
HAPSVN	hopson
LKS	lax
VYGJYN	wiggin
ANVKVL	anukul
KALHYNH	culhane
LYVYS	lewis
JYBSVN	gibson
PARKYN	parkin
TVNGA	tunga
TYHAN	tehan
TAY	tai
BAP	bop
KARN	karn
HAVN	hawn
KYNT	kint
KYNA	kina
ANVPAM	anupam
AYNGYJD	engaged
ADNAMZ	adnams
YVRK	york
MVRAS	moras
YANG	yang
ALVYN	alvin
RADRAMVNY	rudramuni
KYLG	kilg
SADYKVYH	saddique
ARAN	eran
LYVYVY	levavy
LANDYS	landis
LVSANTVS	losantos
VAST	wust
KYRK	kirk
RAKYKVT	racicot
ASKATV	scotto
ANAS	anas
ANAND	anand
GRABNAR	grabnar
VYNZ	winz
AVNSTY	onesty
KARMVNA	carmona
MADYSVN	madison
ADAN	adan
SAP	sup
LVDVVYKA	ludovica
BARK	bark
GAPTA	gupta
PYNV	pino
ALMYNTAKVA	almintaqah
KVSTA	costa
DANAVAN	donovan
SVLV	solo
BASTARD	bastard
PVGA	puga
RVHAN	rohan
AYGV	igoe
MYRMAK	mirmak
LVFASV	lofaso
LAHYJ	lahij
ARSY	arce
TYN	tin
FAYRBANK	fairbank
KVBV	kubo
ANDRA	andra
HANT	hunt
FYN	fin
KAYN	kain
TAMARA	tomura
AKVSTA	acosta
MVNK	monk
HABVRA	habura
AYSAK	isaac
FLVDYN	flodin
RVYAL	royal
BAV	bao
KASTRV	castro
AYSAK	isacq
BVSA	busa
DAYAN	dione
ANAZ	anas
JASTAS	justus
BAKVS	bakos
BRABANT	brabant
PANT	pant
PABLV	pablo
MVNK	monk
MARAT	marat
AYLSA	ailsa
VYRJYNYA	virginia
SVTV	soto
RYDA	rida
DYAMANTARAS	diamantaras
KRYSTA	krista
JYRMASKA	germuska
KVBYLAH	qubilah
VAYLDR	wilder
ANFANT	enfant
ASTAG	stagg
SYMYN	simin
GAYA	gaya
NARDY	nardi
PANKRAS	pancras
GRANVYN	granvin
SALMVND	salmond
LANGSTVN	langston
KVYYTZ	kewitz
HASK	husk
BASYL	basil
BVDY	budi
AYSPVRT	iceport
DVDA	duda
FLYVRY	fleury
LYN	lyn
PYNKY	pinky
BYGV	bigo
ZALAN	zalan
DYNGSVR	dingsor
NYHALANY	nihalani
AVZBRN	osburn
SVLD	sold
HYGARTY	hegarty
FYN	fin
GAMBYNV	gambino
ARFANAKYS	orfanakis
FRANSYSKA	francisca
MYLAM	milam
BVLVS	bulus
GASKYN	gaskin
LYDAL	lidal
DYNG	ding
AKSFRD	axford
AKL	akl
BARNAS	barnas
RVLFH	rolfe
NYVYSVN	nevison
MYNTZ	mintz
MANGYN	mangin
PANGBVRN	pangborn
KVRBYN	corbin
MATSVDA	matsuda
DYVAKARVNY	divakaruni
LYNDZ	lynds
RAMVS	ramos
HAMAH	hamah
DAGAN	dagan
LYNKVYS	linkous
PANDA	panda
RVHM	rohm
ASKAVN	skaven
MAYR	mayr
ASTNFVRD	stanford
MARGVLYN	margolin
ABYL	abel
JVNV	juno
SARMA	sarma
SVAMY	swami
VAYBY	wiebe
ADYNA	adina
HVDSVN	hodson
NAPTVN	napton
ASMAL	small
GYNKZ	genks
VAST	vost
NYNJA	ninja
PYNZ	pins
SAKAMVTV	sakamoto
KRH	kre
RAHY	rahi
HAYNGH	hainge
AYNKH	einke
VAYMN	wyman
DAK	doc
SABRAMANYAN	subramanian
BARKASFYLD	barksfield
AVLYVYR	olivier
JYNTVN	ginton
ABRAHYM	ebrahim
DAYR	dayr
PVRTNVY	portnoy
AYVTYK	ivetic
MARANY	marani
GYL	gil
KVYN	quin
DYVAYN	devine
MYNYARD	minyard
TATSVRV	tatsuro
MVNTANV	montano
MYNARYK	minarik
AYMAN	ayman
PANYKV	panico
MVNRV	munro
DANSY	dancy
ZYGMVNT	zygmunt
GAJNH	gagne
AZALYA	azalea
AYLVR	aylor
'ADL	adel
LANTZ	luntz
KVRKAM	corkum
KVBYLAH	qubilah
KYVNG	cuong
ALFARV	alfaro
BRVYNYNG	bruening
LABKYN	lubkin
MARKHAM	markham
BVSTRAM	bostrom
VYLASKV	velasco
SVLVMVN	solomon
KASANVVA	casanova
ALYLYVNAS	alelyunas
BRADY	brady
ZYTV	zito
BARNARD	barnard
AVLD	auld
SVKVMAR	sukumar
FVNYVK	foniok
ANVS	enos
RAFALKV	rafalko
DYKYNZ	dykins
AYNGRM	ingram
KVYNRYDVS	coenradus
VARGV	vargo
KVNG	kong
DARBY	darby
HARKYNZ	harkins
ASNYL	snail
BVST	bost
SASZY	sasze
RVTABAGA	rutabaga
FRANSYNTYH	francyntie
BYKSLR	bixler
ARMATV	armato
GVNNA	gonna
ALVKAL	alukal
MARSTVN	marston
KLATZ	klotz
ASNV	snow
NYKY	niki
AYNKH	einke
ASPVTYS	seputis
LAMYKYN	lamykin
LYNDGARD	lindgard
BRAN	bron
JYAN	jian
YAGLA	yagla
LAYKZ	likes
DYRKS	dirks
NYGRA	nigra
AVAN	awan
KASANVVA	casanova
DVLMAN	dolman
ASPYR	speer
DYAMVND	diamond
PAL	pal
AVKRAYN	ukraine
SYSK	sisk
HAVARD	havard
BYAVYS	beavis
KAMPYVTR	computer
DAYANYSYS	dionisios
LAYN	lynn
BRYAN	bryan
KARASA	karaca
SANTYK	santic
ATKYNZ	etkins
BALYGA	baliga
PVSV	poso
MAYLN	milne
KARP	karp
PRAM	pram
HARDYSVN	hardison
SYR	cyr
KVNVPKA	konopka
'LYMA	ulima
KVYYMAN	coeyman
JAYANT	jayant
LYN	lin
AYNMN	inman
DAK	duk
GVNNA	gonna
SYMYN	simin
KANA	kana
SANANDV	sunando
KAMB	kamb
MARANY	marani
PYATJY	pietje
BRYYTVN	britton
GRAFT	graft
JVANYTA	juanita
GRASKYN	gruskin
MANDAL	mandal
BRAVN	brown
AVRCARD	orchard
DVRAPT	durupt
ZARYH	zaria
ASTVARD	steward
RYTYSGRT	ritsgert
ZVVAYTA	zuvieta
GRYSVALD	griswald
LYDVR	lidor
ANTAL	antal
HARVLD	harold
KVSMAS	cosmas
PATVKSNT	patuxent
GVRALAVALA	goralwalla
JVHANY	juhani
ANGLAND	englund
ANTVNYV	antonio
NYN	nin
KARMVDY	carmody
NYVYSVN	nevison
TANG	tong
PVGVSYAN	pogosyan
DANG	dung
GVYKARYS	geocaris
DYKSN	dixon
ASKRYBLYNG	scribbling
GYPJH	gepje
ABVBA	aboba
ANZALVNY	anzalone
HANSVN	hanson
NAGASYVA	nagasiva
APVNTH	aponte
SVRAB	sorab
VAH	wah
QVASYM	quasim
HYVM	hume
SVYFT	swift
PVYNT	point
TVNY	tony
BRYDY	brady
GRAHAM	graham
LVN	lon
NAKAGAKY	nakagaki
ASTRYTY	steriti
SANA	sana
GVRAPARTAP	gurupartap
MAHALY	mahaly
HAVVLA	havola
AVGVR	augor
BAZBY	buzby
DYMYTRYVS	dimitrios
ADYH	adie
PRAYL	prael
HANTYNGTVN	huntington
LVDVVYKAS	ludovicus
ADARA	edara
AVSBVRN	osborne
RAMY	rami
JAYAN	jayan
DVBVYS	dubois
AMYRA	amira
TYMBVL	timbol
JYGANG	jigang
ALYN	olin
PANDA	panda
AVVRDAL	overdal
JYAN	jian
BANYTA	bonita
AVRV	orue
FRNASYSKAS	frnaciscus
AVYNG	ewing
GASPAR	gaspar
VYMAL	vimal
ASTN	stan
LVKAS	lucas
KASPRZAK	kasprzak
FABRV	fabro
SAVARAM	savaram
ASTYVNSVN	stevenson
LVDVRF	ludorf
HAVKYN	hawkin
TAPTANY	toptani
MVYR	muir
BALYT	balit
MAGVAYR	maguire
ARMAND	ormond
KAM	kam
ASTRAK	strock
GVDATA	gudata
GAYDRY	guidry
HADSVN	hudson
HVRKAN	horkan
ALTMAN	altman
AYLVT	eliot
MARV	marv
AMYTAVA	amitava
LYNDAN	lyndon
ADVVART	eduwart
VYNSN	wincn
ALSAP	alsop
ASTAYNMN	stineman
ASPARZA	esparza
VAYLDR	wilder
BANTVN	banton
NAJYA	najya
ZARVS	xaros
DRAGANYS	draganis
BRYSYNDA	brisinda
DVNALD	donald
MATAKV	matako
AVRVM	avrum
D'A	dua
ANRYKV	enrico
MVRYN	morin
HVGV	hugo
JVZA	juza
GADBVRY	gadbury
MARTYNZ	martens
GVSTAV	gustav
AMS	ems
LYN	lyn
JAKVBJH	jacobje
FAYK	fike
MVNDFRANS	mondfrans
ARYKSVN	ericson
AVGVST	august
AYSVN	ayson
SYMVNA	simona
VYSPY	vispi
'LYA	alia
ALYLYVNAS	alelyunas
KLVB	club
GRAYYV	grieve
MVNTA	monta
HYNSVN	hinson
RATKS	rutks
DVBYNYN	dubinin
KANZY	kanze
PAPLY	popli
AVSYZ	oseas
HANSVN	hanson
SANDAR	sundar
KAMPAGNA	campagna
SVRVALY	sorvali
HVRVAT	horvat
KANA	kana
LAMARK	lamark
VYDY	vidi
DAMYVN	damion
KATRYN	katrin
ASTRND	strand
TALBVYZ	talboys
DAVVD	dawud
ASTVN	stoun
ABRAHYM	ibrahim
JAKVBJH	jacobje
JVHANY	juhani
BADZYAK	budziak
TVVYS	twiss
FRANKVYS	francoys
MARSY	marcy
SVNG	sung
DYAB	diab
RADV	radu
LAGVMVRVF	lagomorph
NYDH	nida
KARYDA	karida
AVLSN	olsen
BRYNK	brink
ANDRYVZ	andrews
PYYK	peak
GYVZ	guse
ANTVNYS	antonis
BAS	bas
BARKVLV	barculo
KRAK	kruk
AYDS	eads
RATKS	rutks
JARVALA	jarwala
KVDY	cody
KLBAY	kilby
HAYNZ	hynes
ALYASVN	eliason
FRAMSVN	framson
ASPYTZR	spitzer
SAKSNA	saxena
PVRKV	porco
ANANT	anant
VYRYANA	wiryana
'QYLA	aqila
VASYK	wasik
ASLATR	slater
ZYTV	zito
DAGZ	dogs
KYPLYNG	kipling
SVKVMAR	sukumar
KYVNG	keong
YAMN	yumn
PYVN	pion
HAMARKVYYST	hammarquist
AVBRTAS	obertas
LAPYDARY	lapidary
VYLHAYT	wilhite
FAYZA	faiza
LYYVVH	lieuwe
MYNA	mina
MARGVLYS	margolis
ASTARKY	starkey
SANA	sana
AVDVN	audun
PAYNH	payne
GYVVN	givon
GRVHVL	grohol
AYDY	eady
FYN	fin
MANJYT	manjit
RAY	rai
DVRAND	durand
MKGVYRK	mcguirk
PRYTZ	pritz
SAKS	saxe
MYSTRY	mistry
GVDAT	gudat
ASCVYLAR	schuyler
NVDYNG	nuding
MVTVR	motor
'FYF	afif
ALMYNTAGAH	almintaqah
AYK	aik
SVLVMVN	solomon
LAN	lon
FALTAK	foltak
TAYTY	tytie
DYGAN	degen
KAVYTA	kavita
MYSRA	misra
RAN	ron
ADMYRALZ	admirals
TAKSBRY	tuxbury
ALSVN	elson
MANYKS	mannix
GRAV	grau
GRANDASTRVM	grundstroem
SANG	sung
FABYANV	fabiano
ALTMAN	altman
TVMATYVS	tomatius
VYGSTVN	wigston
PANDA	panda
ALTZ	oltz
TAYLV	thilo
ASKYLS	skiles
JVAN	joan
ANGLASMA	engelsma
SVZV	sozo
MAMA	mama
MADYV	madeo
BARTHVLVMYVS	bartholomeus
AFYF	afif
RAYDN	ryden
ASPLYNTR	splinter
VYVYAN	vivian
LASTRA	lastra
ANYJMA	enigma
BALDVR	baldur
VYZNAND	wijnand
MYLKS	milks
PVMA	puma
KALDYS	kaldis
RAV	rau
JAYARAM	jayaram
RVYMATA	roimata
KAYNY	caine
HASYK	husik
PYYK	peak
KVBYLAH	qubilah
VYLKYNSVN	wilkinson
PAKS	paks
ASKRNTVN	scranton
GVNVT	gonot
DAVD	daud
PVLYS	polis
BVRAD	borud
KLAZVRA	klazura
AMYHAY	amihai
MVD	mod
LYZARD	lizard
AYRDV	airdo
BARTVK	bartok
AGATY	agate
LYVYV	liviu
ANRAH	unruh
AYDS	eads
ZAGAR	zagar
KARASA	karaca
DAVT	dout
ADMVNDS	edmonds
BARKAY	barkai
KVNVPKA	konopka
AYFJ	ifje
LAN	lan
SVRAJ	suraj
KRYYK	creek
MANYKS	mannix
KVSMAS	cosmas
GVDYVYN	godewyn
NYDA	nida
AVANZ	evans
HAYNLY	hinely
RASPYNY	ruspini
MANKVS	mancus
SAKAYV	sakaue
RVHM	rohm
RADVF	radov
DYPAK	dipak
HADVBA	hudoba
AYRD	aird
ASTYNTJH	steentje
BRAY	brie
JAYANT	jayant
PRAYM	prime
ALYASVN	eliason
DRVR	dror
DVGAN	dogan
ASPVTYS	seputis
MARLA	marla
BAD	bud
PADVA	padua
GAVYN	gavin
BRANT	brunt
PRAYVYT	private
YANVVYTZ	yanowitz
DVZYYR	dozier
FRANSYNTAY	francyntie
ASTVK	stock
AVRV	orue
'BVDHABY	abudhabi
GARSYA	garcia
JYRARDYN	gerardin
JASTJY	justje
DAVSVN	dawson
ZVLD	zold
BAVM	baum
VYRYANA	wiryana
KAMHVLZ	kamholz
DAK	doc
KVYYT	quitt
LAVYGNH	lavigne
SVDARMV	sudarmo
GRAYYV	grieve
BARVN	baron
ANVPAM	anupam
DAYS	dais
PLYSKYN	pliskin
HAVDVN	hawdon
SVNDARAM	sundaram
MANV	muno
PATRYK	patric
SVDYPTV	sudipto
LAND	lund
PVLYNG	poling
KVYYNLN	quinlan
AYGLV	igloo
RASTRAM	rostrom
KYSVN	cason
FAYRVZ	fairuz
DYL	dil
SVKVL	sokol
TANAK	tanak
MKMAHAN	mcmahan
KVSVGH	kosuge
PVKVRNY	pokorny
ASTRVSTRAP	stroustrup
SVSYA	sucia
HADSVN	hodson
LYVNARDV	leonardo
ASTYT	stith
KYRBY	kirby
PRYVR	pryor
BLYNKV	blinco
DVLMAN	dolman
ANTVNYV	antonio
ALYNGTVN	alington
HARVNY	haruni
FABRV	fabro
KYMVN	kimon
DAGZ	dogs
RASV	raso
KRVK	krok
FAVST	faust
JYRMASKA	germuska
JANSJH	jansje
MAVPYN	maupin
DAMVN	damon
PAYNTVN	paynton
TAKA	taka
ADAB	adab
ASTYVNSVN	stevenson
LAYBZ	libes
NAVYA	navia
SYRAFYN	serafin
DAYLVN	dillon
DANKY	dunki
GALYLH	galila
MAHA	maha
LVND	lund
ALGYNGTVN	elkington
KAY	kai
ANTANAYTYS	antanaitis
MVKASA	mukasa
AYNKH	einke
ARLYNG	arling
TAV	tow
ALYMA	ulima
TVYT	toit
RAFY	rafi
SYVNKA	cionca
TALBVYZ	talboys
LYSTVN	liston
STRATVN	straton
MAYK	mike
ADAM	adam
HAMARKVYYST	hammarquist
AVGVST	august
VAYD	wide
ASKRYBNR	scribner
BARTVNYKV	bartonico
SABYNY	sabini
BADZYAK	budziak
ASPRVT	sproat
HYYN	hean
MVMFVRD	mumford
VYNSTVN	winston
BARTVN	barton
FARYHA	fariha
MATSVMVTV	matsumoto
VYZNAND	wijnand
GAS	gus
HALTZ	holtz
DVARTH	duarte
PRASANA	prasana
JVSVYG	joswig
HADSVN	hudson
PADVA	padua
ASTNFVRT	stenfort
PLATFVRM	platform
HARATZ	haratz
GVRAL	gural
SANANDV	sunando
MYNTVN	minton
KATALANV	catalano
ATA	ota
DRVDYS	drudis
GVSTAV	gustav
'QYLA	aqila
GARMZ	garms
MARYH	murie
KAYN	cain
NAHAM	nahum
JASTJH	justje
BRAN	bron
KYALASA	kailasa
NAGASAKY	nagasaki
SYLVYV	silvio
MYLT	milt
ARHARD	erhard
ASPARZA	esparza
GALKV	galko
AKYN	akin
ASCVYLAR	schuyler
JAN	jan
AMYR	amir
DVSTALYK	dostalik
NAVYA	navia
KALPANA	kalpana
SYMYN	simin
NABYL	nabil
DYL	dil
HADVBA	hudoba
JVZA	juza
ASTVRLYR	storleer
'BDAL'ZYR	abdulaziz
PATRVKLVS	patroclus
TYV	tio
ASLAN	sloan
KARBALA	karbala
MVRLAN	morlan
FVNKY	funky
BYSYN	basin
TAM	tom
VAL	wal
RVLDAN	roldan
KVYL	coil
KARLTVN	carlton
DVVAYKYNK	duickinck
FAYNRTY	finerty
MARGVLYVKS	margulieux
ADYNA	adina
ALMVDYVAR	almudevar
PANAS	panas
KRAVFVRD	crawford
NAYKVLAS	nicolaes
JYN	jin
ANJYLYNY	angelini
KARPLAS	karplus
MVBAY	mawby
ASPYDN	speden
SYKY	siqi
MANV	manu
GVPTA	gupta
GRYT	grit
DVRYS	doris
MVN	mun
GVGVAN	goguen
MAHAJAN	mahajan
SAMANTA	sumanth
KVLYHA	koliha
DAVKYNZ	dawkins
'BVDHABY	abudhabi
MATAR	matar
HALAT	halat
AYM	aim
KRYSJH	krisje
KRYSVYJN	krisoijn
AVRN	orne
AYNC	inch
BRAYSLAV	berislav
KYNGSFVRD	kingsford
QVASYM	quasim
KVY	coy
AVTJH	oetje
BRANSDVN	brunsdon
AYNGMAR	ingemar
KAV	cau
JAKVBY	jacoby
KRYSPYJN	crispijn
NAN	nan
ARYKSVN	ericson
BVNAR	bonar
KANT	kant
BANTVN	banton
TVMANY	tomany
