DVRAZYV	dorazio
GASLYNG	gosling
LAMARK	lamark
RYHANH	rihana
TYYVLN	thulen
KRYYK	creek
ATVSY	atusi
RVRY	rory
SYMYNGTVN	symington
DAMYNYKAS	dominicus
AYRD	aird
ANVKVL	anukul
DYNY	dini
VALTVN	walton
SAMVSKY	samosky
KRVB	krob
BVSTRVM	bostrom
GVDATA	gudata
ASTARBAK	starbuck
AYSAN	eason
LYVYVS	livius
TRYVLV	triolo
SYMYNGTVN	symington
MVNTYJV	montijo
AYVA	iowa
SALYAN	salian
SYRVYZ	sirois
AYNGMAR	ingemar
KARLAYL	carlile
KYRK	kirk
PANGBVRN	pangborn
BRAY	brie
NAGY	nagy
BALV	balu
SAKSNA	saxena
LAYN	lynn
ALF	elf
GLASYYR	glacier
MARYNV	marino
BASYLYSK	basilisk
LVYYZV	loizzo
AVALD	ewald
LAGVMVRVF	lagomorph
HAPSVN	hopson
VYDY	vidi
VYDY	vidi
HVLM	holm
MKGVYRK	mcguirk
JALA	jala
RVYS	ruiz
RVSLYN	roslyn
AFZAL	afzal
BARBVRAK	barborak
TVYN	twin
LAP	lap
AKSLY	oxley
VALDV	waldo
KVYNTANA	quintana
BRAYNKLR	brinkler
ASPATSVVD	spotswood
KAY	kai
MYLVARD	milward
MAYT	myth
BALYN	balin
AYN	ain
NVDA	noda
MVRNYNG	morning
PALSKY	polsky
NARLA	narla
AMBRVSYVS	ambrosius
ZALAN	zalan
AKVSTA	acosta
ASTVRR	storer
SVZALYS	susalis
TVSYNG	tusing
VYLYNGZ	willing
RAHVL	rahul
KATVPYS	katopis
DANHAM	dunham
RVSV	rosu
ABRAHYM	ibrahim
LVDVRF	ludorf
BYKSLR	bixler
DRYDJY	dridge
DVRYNDA	dorinda
MATA	mata
FYGARD	figard
DAK	doc
GRANVYN	granvin
AYLVT	eliot
HVGAN	hogan
AVZMN	ozmen
DVBRYZ	dubris
HYNTVN	hinton
TAPYV	tapio
ASKALY	scally
DVAN	duan
MARTYZN	martijn
VARMA	varma
ZYZY	zeke
MARKVYZA	marqueza
VASLV	waslo
DVRMA	dorma
DRVR	dror
KRYSPYJN	crispijn
DANGYVN	dungeon
TAMY	tomi
ADMVNDZ	edmonds
MYNYARD	minyard
NYNJA	ninja
AYNGALZ	ingalls
JARVALA	jarwala
AYRP	earp
SVNJA	sonja
ANV	anu
BAKSKA	bocska
DANG	dung
KATVALA	katwala
BASYLYVS	basilius
VYLKAS	wilcox
HVA	hua
PARSVNS	parsons
KARN	karn
ANYSH	anisa
AVDVN	audun
PRYVR	pryor
CAYLDZ	childs
KANZY	kanze
SYMAL	cemal
ATVSY	atusi
GYNTVN	ginton
KAPRAL	kapral
GRYGVR	gregor
PALSKY	polsky
FRAYTGRSA	fritgersa
GVGVAN	goguen
BABYTZ	babitz
HAV	hao
RAFALKV	rafalko
AVGVSTV	augusto
BAYRTAY	baertie
FARYD	farid
AVRAHAM	avraham
ASTAYNMN	stineman
LADVYG	ladwig
PYRAN	piran
LYZARD	lizard
MANJYT	manjit
MVRANDV	morando
HAVKYN	hawkin
GYNKZ	genks
BVDRA	budur
ALZ	elz
KVAST	kwast
AYVSV	ayuso
TRAYNVR	traynor
MVBAY	mawby
NYNVYS	ninoys
ASTAPLYC	stuplich
KYSLV	kislo
SALYAN	salian
BRYVNY	bryony
RVSA	rosa
AMYRA	amira
DAVKNYZ	dawkins
MARKVYZA	marqueza
RAJ	raj
PYAK	paik
AVRKNY	orkney
AZALYA	azalea
KRAYG	craig
ANALVG	analog
GASLYNG	gosling
RYVDT	ruudt
YAMAHA	yamaha
GYNKZ	genks
HARKYNZ	harkins
RVTZ	rotz
ALFARV	alfaro
GAMBYNV	gambino
JVSYP	josip
FVNDAL	fundal
DVGAN	dogan
AYRP	earp
FARYD	farid
BLASY	blasi
AYSPVRT	iceport
ARVYNG	irving
AMBRVSYVS	ambrosius
ASKRNTVN	scranton
AVKYNZ	oakins
LANDYN	landin
BAJVA	bajwa
ZARA	zara
SAMANTA	sumanta
KVARTZYTH	quartzite
ASTYVZ	steves
BYVAN	bevan
BANDZ	bonds
GVRV	guru
VYLKYNSVN	wilkinson
LASTRY	lustri
KASVN	kasun
GNVSYS	gnosis
ASTRVSTRAP	stroustrup
'LAALDYN	alaaldin
LASKARY	lascari
AYRLAYNZ	airlines
KARHART	carhart
ASTVARD	steward
DAVKNYZ	dawkins
KAPRAL	kapral
HALVB	holub
LYMBVRG	limburg
HALM	halm
BRYSYNDA	brisinda
FRANKV	franco
BADZYAK	budziak
KAPYLA	kapila
FYRMA	firma
AYGRTVN	egerton
'LYA	alya
HVNG	hung
RAYDN	ryden
BAYLYNGTVN	billington
MANVLY	manoli
BLASK	blask
LARA	lara
PRASANA	prasana
GANSVN	gunson
DARHAM	durham
FYGVRA	figura
BADZYAK	budziak
DVBRYZ	dubris
TYNG	ting
HAYVKZ	hawkes
YANYV	yaniv
NYNSTAR	ninstar
SYMYNG	siming
AMBRVSYV	ambrosio
SABRAMANYAN	subramanian
GVRYS	goris
YANVVYTZ	yanowitz
ASLAN	slone
DAVNYNG	downing
RAFALSKY	rafalski
ALYVT	eliot
FAGAN	fagan
FYNK	fink
SRAYNH	shryne
PANDVLFYNV	pandolfino
AYSLT	iselt
ALDYN	eldin
DVBVYS	dubois
TYTMAS	titmus
ABYNA	ebina
SVLTAN	sultan
DVPALM	depalm
ARAN	eran
TVMYTYVS	tomatius
BAGDAN	bogdon
'ADL	adel
TALMY	talmy
MAVPYN	maupin
AYVGNH	eugene
RAHY	rahi
GVNY	gony
BATRA	batra
VANSY	vance
KVHAN	cohan
NAZARYTYAN	nazaretian
JASTJY	justje
MYNTVN	minton
ANTVNY	antony
HAVK	hawk
MKKAVN	mccown
TYVNYS	teunis
GARTYN	gartin
CAYLDZ	childs
ARSKAYN	erskine
RAKYKVT	racicot
BABYTZ	babitz
SVAMY	swami
FADYLA	fadila
BASYLYKA	basilica
KVARTZYTH	quartzite
KAGBVRN	cogburn
DADGYVN	dudgeon
MAYNR	miner
TVLAY	tully
NYN	nin
NAPTVN	napton
HADRAMAVT	hadramawt
PAVLYK	pavlik
VASLV	waslo
ANDRYS	andres
GVNY	gony
BARKSDYLY	barksdale
ALTZ	oltz
KASTRYKAM	castricum
DYSAY	desai
DVNATV	donato
KANTARA	cantara
FAGAN	fagan
MVTVR	motor
AYRD	aird
RVBY	roby
ALYVT	eliot
MANKS	monks
PYATJY	pietje
DVLMAN	dolman
SYLVAN	sylvan
MARTY	marty
VYNTVN	winton
JVHANY	juhani
MVRALT	muralt
GYBVR	gabor
BAYLYNGTVN	billington
ASNV	snow
AYVRS	evers
LANSYNG	lancing
YAGLA	yagla
TRYVLV	triolo
DAYVYN	divine
BLAZ	blaz
'FYF	afif
DYMYTRY	dimitri
ASK	ask
BANYTV	bonito
AVGVSTYN	augustyn
SAMAH	samah
SVMA	soma
AYS	ice
PAYVLTJ	paultje
JAYNVR	gainor
KARYAGA	cariaga
AYLKA	ilkka
BYSYN	basin
YAMYNAH	yaminah
ZAYRA	zaira
ASLVP	slope
RAV	rao
ASTYSY	stacey
HVGARTY	hogarty
BADYG	budig
TYVNYS	teunis
MVNAZ	munoz
SYLK	silk
ALAHDVD	alhudud
DANYS	danis
HYSLAP	hyslop
AYS	ace
RAYDN	ryden
BYRA	byra
VYRYANA	wiryana
SYLVYA	sylvia
BASMA	basma
SYMVNDS	simonds
PYNYAN	pinyan
BVLDT	boldt
MVNKAR	moncur
BLVHM	blohm
FAYZA	faiza
ASTANGYR	stangier
MYLARA	melara
MVTVR	motor
SAMANTA	sumanth
BAR	bar
KALSYN	calsyn
DAYR	dyer
LANGDVN	langdon
LADYVYL	ladeuil
KAMPVS	campos
BAVKVS	baukus
FYN	fin
GVSTAV	gustav
AYNGMAR	ingemar
NADYG	nadig
TAKV	taco
MYRMAK	mirmak
JANKYNSVN	jenkinson
ALSVP	alsop
DABYNSKY	dubinsky
TVLY	tuli
APVNTH	aponte
SYTYA	cetia
FVRJY	forgy
KVTRVNYV	cotroneo
GRYSVALD	griswald
AYMRY	emery
'FAF	afaf
ASPYTZR	spitzer
HARDYNG	harding
HYJDAN	higdon
TATARY	tatari
BRAYSLAV	berislav
PARDY	pardi
SYTA	sita
NYVAYNGTN	newington
BYPYN	bipin
BYVKRAFT	biocroft
ALSAN	olson
GANDY	gandy
PATVKSNT	patuxent
AYSKANDR	iskander
LANGV	lungu
KASTVRY	kasturi
SYNAN	sinan
AYNGLD	ingold
BVTARY	botari
MAKAYVLY	macauley
AYALA	ayala
KVSTANZA	costanza
BARY	bari
GVRV	guru
KVAST	kwast
RYYAD	riyad
AYDA	aida
LYMN	lymn
KVYL	quel
KARP	karp
LVK	lok
ASTAG	stagg
GANAVAN	gunawan
LASKALA	lascala
ADRYS	idris
KAMPAGNA	campagna
ASKYN	skean
TAM	tom
TAY	tye
MVRAY	moray
KALYAN	kalyan
TYPAL	tipul
NARAD	narad
ZHRA	zara
BASYLYSK	basilisk
PANDA	panda
AQBAL	ikbal
MVRALT	muralt
YARVS	yaros
HANKH	hanke
BAN	bon
GAYVN	gawne
GAN	gan
SYRAFYN	serafin
BLAVADNYK	blavatnik
PVRVS	proos
FANGVS	fungus
DANGTAY	dongtai
RANY	rony
BAYDA	bayda
LAHYJ	lahij
RVSLYN	roslyn
AYSYZAKY	ishizaki
ALVARV	alvaro
DAV	dow
LYVANDVN	lewendon
GAVYN	gavin
TAYLR	tyler
JVAN	juan
DATSVN	dotson
JVN	jun
BADZYAK	budziak
KRVPYK	kropik
TVFTH	tufte
MYLGRAM	milgram
FARYD	farid
ZYZY	zeke
FAVST	faust
ASTABZ	stubbs
JAKVBSVN	jacobson
FRANKVYS	francoys
RAFAYLY	rafaeli
KANYVN	canyon
ASKVLY	scully
BRYSTVL	bristol
DYK	dik
ASPVRY	sporay
BANDZ	bonds
KAMBS	combs
DANA	dana
SYVA	siva
HYNDRYKA	hendrica
GASLYNG	gosling
ANASTASYA	anastacia
'FYF	afif
SYN	sin
HADSVN	hudson
FRYNK	frink
NVKV	noko
HARPVLD	harpold
HANKZ	hanks
SVRYN	sorin
TAYV	thao
TATARY	tatari
MVNTAGV	montagu
GASTA	gosta
MYLYND	milind
HADVBA	hudoba
FLVDYN	flodin
HAMYLTVN	hamilton
STRATVN	straton
LYSTVN	liston
RAVYNDRAN	ravindran
ALYSYA	alicia
GYRARD	girard
MARTYNZ	martins
SVA	swa
KAGBVRN	cogburn
GVNZALV	gonzalo
TVM	tom
ADNAMS	adnams
ARPYN	arpin
FRYTS	frits
VAYD	wide
KATLYR	cutler
MYLKV	milko
VAST	wust
TAKY	taki
LARVKVYH	larocque
MYNTVN	minton
AVALD	ewald
RYVDT	ruudt
VYDAD	widad
TVLAY	tully
MYRVT	mirut
AYNMN	inman
LAPASV	lapaso
JYA	jia
VASYT	wasit
KALAHAN	calahan
ALMV	elmo
GRYST	grist
'LYMA	ulima
ABA	aba
BABA	baba
AYALA	ayala
AYRYS	ariss
GVRKY	gorki
ASKVLYNG	scowling
PVTYT	petit
HYVM	hume
AMLAK	amlak
ANVVY	envoy
NYVMAN	newman
KALSYN	calsyn
LAHYJ	lahij
ALFVRD	alford
BLASYVS	blasius
ASKATV	scotto
GABVR	gabor
CAYLD	child
NYPTVN	napton
KANYG	konig
ALF	elf
PABLV	pablo
AYLYNG	ayling
MYZYRA	mizera
PYNTVN	pinton
MAKARAYG	macaraeg
GANG	gang
GYL	gil
KARDYNALY	cardinali
MYLAD	milad
SABRAMANYAM	subramaniam
ALMV	elmo
ADYK	adik
TALBVYZ	talboys
VYLKYNSVN	wilkinson
KALVYN	calvin
BAYLZ	byles
ASKADZ	scudds
DANALD	danald
DYDA	rida
ARM	arm
ANBV	anbu
HARTAH	hurtah
BALMA	balma
'LYMA	ulima
ASTRYNJR	stringer
S'YD	said
ARM	arm
PRVMVNTVRY	promontory
ANYART	enyart
DYTVTALA	ditutala
BAV	bao
ARLYNDH	arlidge
ABYAB	abiab
MAHAVLT	mahault
MYMAS	mimas
HANKZ	hanks
DAMVN	damon
SAND	sand
LYN	lyn
DANSYNG	dancing
TANAK	tanak
HARTAG	hartog
'QYL	aqil
NVLAN	nolan
KANAKAKVRN	kanakakorn
LANTZ	luntz
AYM	aim
GARBH	garbe
LAZARD	lazard
KAZY	kazi
'LYA	alya
HAMARKVYYST	hammarquist
ASLAVMYZ	slawomir
MATSVMVTV	matsumoto
RABVYL	raboel
LYZARD	lizard
SVHAS	suhas
KASYNSKY	kosinski
RVBVZ	roboz
DAYBALA	dyballa
PRAMVD	pramod
HYVM	hume
SVYFT	swift
ANGLASMA	engelsma
AVYRSA	aversa
APVNTH	aponte
LYZA	lisa
KYRYL	cyril
PVRKV	porco
ADARA	edara
SVLVMVN	solomon
AYZAK	isacq
LARSVN	larson
DRVDYNG	druding
SYLVYA	sylvia
KAMPVS	campos
HYNTVN	hinton
KYM	kim
YVNGSAP	yongsup
MYLAD	milad
ARNH	arne
VYKTYM	victim
DAGAN	dagan
ALVF	elof
KRAYJ	craig
TVDAR	tudor
MAYLN	milne
LAKY	lucy
BARVA	barua
KANTH	conte
ALKS	alex
KVKAL	kokal
ASTYN	stian
VAYLDR	wilder
HALST	holst
HYTZ	hitz
JYZAN	jizan
MAYRS	myers
KANDV	kundu
ALYA	alya
BVS	bos
SYMVNDS	simonds
BRYANT	bryant
LAYRD	laird
KASAT	kasat
RALF	ralf
JYM	jim
DVRYS	doris
ASNV	snow
HALAT	halat
RADV	radu
ASPVLARYX	spolarich
SVNA	suna
KRVK	krok
AKYL	akil
LAPYDARY	lapidary
LANKTVN	lankton
LVYYZV	loizzo
JARVALA	jarwala
KVNYNG	koning
RYVARD	rivard
KVYALSKY	kowalski
AVYAN	avian
HAYNGH	hainge
TAMAS	tamas
KARDAL	kardal
MARK	marc
ARDYS	ardis
FATYMA	fatima
RAYDAH	raidah
PYNA	pina
KRYSP	crisp
SAVSAN	sawsan
TAYJMN	tijmen
ALF	elf
LAMBARDV	lombardo
MVRAVAN	moravan
HARMZ	harms
GRANT	grant
MYLASYS	milacic
ALFANSV	alfonso
PVYV	pouw
ADGYNGTVN	edgington
GRAV	grau
AVBYD	ubaid
ASLYV	slave
ALDZ	olds
VYSPY	vispi
AYNDAYRSN	indiresan
FAGANS	fagans
AVMGA	omega
JAKVBY	jacoby
AYCYRV	ichiro
BASYLYKA	basilica
PANKRAS	pancras
AYDVAYSVZ	ludovicus
SATKAS	sutkus
AYSAN	eason
ALSVN	elson
DYMA	dema
PVRTNVY	portnoy
KVSVGH	kosuge
ANRAH	unruh
AHLAND	ohlund
NVYA	noya
KAM	kam
BARTVLYNY	bartolini
JYVVYL	jewell
LVKV	loco
GVADA	gouda
KALMAN	kalman
VYLHAYT	wilhite
PARDYNGTVN	pardington
FVRSAYT	forsyth
FARKAS	farkas
ANJY	engi
PRYVR	pryor
KALHYNH	culhane
BLVZVM	bloxom
AVLSN	olson
KANBVY	conboy
LYVYNGSTVN	livingston
KAMPTVN	compton
LANGDVN	langdon
JAKVBJH	jacobje
RVNY	roni
BAVDYN	baudin
PYRAN	piran
LAP	lap
FLVR	flor
HAN	han
JVDAS	judas
LAYVRYTSN	lauritsen
KAYLAS	kailas
BVNYFASYVS	bonifacius
VYSPY	vispi
ASTYRN	stearn
BVNGARD	bongard
BASTYK	bostic
RVSYALA	rotiala
PVNA	puna
ASKVRR	scorer
RYGV	rigo
ALVYN	elwin
JAVYD	javed
FAYZA	faiza
KLYFTVN	clifton
GVDYVYN	godewyn
LAMARK	lamark
AVADYA	awadia
HARTAG	hartog
TRA	tra
NVRDBVRG	nordborg
NAZARYV	nazario
NAVYA	navia
VYSPY	vispi
LYNK	link
LYANG	liang
LYVNARD	leonard
KVMVRV	kumoro
KVDVGNV	codogno
LAVTVN	lawton
DATSVN	dotson
AYNC	inch
JAGV	jago
DANALD	danald
ASTYVN	steven
JYNTVN	ginton
AYLVARD	aylward
ARHARD	erhard
SAYVYR	sawyer
DAVKNYZ	dawkins
PRASANA	prasana
MAHA	maha
TYRZA	tirza
LVSTY	lusty
MAK	mak
AYDMN	eidam
RYSAVY	rysavy
PYNA	pina
ADYNA	adina
LYVAYN	levine
AVBAJA	obadja
KVDY	cody
BVNYN	bonin
ASTNKAMB	stancomb
BALDVR	baldur
ARYKA	erica
KVSKYMAKY	koskimaki
ANTRVSYV	antrosio
PRANGS	prongs
HASBY	husby
PLASTYNV	plastino
MAYNR	miner
SYTJY	sytje
HAYNLY	hinely
RYVARD	rivard
AVGVSTYN	augustyn
NVRDT	nordt
KAYA	kaya
BVLTAN	bolton
ALF	alf
NAVAR	nawar
SVSA	susa
AVBR	ober
ANGLAND	englund
DAYR	dayr
BALSARA	bulsara
VYLAS	vilas
DAGZ	dogs
AGRAVALA	agrawala
ASTVK	stock
KAYT	kyte
BRAY	brie
SAND	sand
GRYKV	greco
AVFYNGTVN	uffington
PYVRYNTN	purinton
HARVLD	harold
ABRYNY	ibrini
BRY	bri
FADYLA	fadila
ASMVT	smoot
NAGASYVA	nagasiva
LAHYJ	lahij
NVYA	noya
RALF	ralf
ALVYN	elwin
BLASY	blasi
GVRAV	gorav
AYRP	earp
ASFAR	sphar
GARTYN	gartin
BASMA	basma
DVDAMANY	dodamani
ASCVYLAR	schuyler
ANYL	anil
HVLRVYD	holroyd
TAY	tai
ATRAM	atram
KARBAJAL	carbajal
FARKAS	farkas
ASKY	skee
KAMPAGNA	campagna
HARARY	harari
AYRD	aird
VAL	wal
ALY	ely
KYSVN	cason
VYLAS	vilas
SVZY	suzy
ZAPARA	zapara
BALYT	balit
AVLSVN	olsson
LVN	lon
RVBYN	rubin
SAMAH	samah
DAPAY	dupuy
MYAYNDRT	meindert
VVLTRNYNG	woltering
AVLD	auld
DVBRYZ	dubris
RYYAD	riyad
MARTYNZ	martins
KVRY	kory
GRYST	grist
AYNGRYSVL	ingresole
ASKVLY	ascoly
HYN	hin
AVFYNGTVN	uffington
SVDAN	sudan
KVRDAS	kordas
SYVN	sune
MANVLY	manoli
DAV	dov
BAYLS	byles
LAV	law
HAJ	haj
NVNYS	nunis
FVRSAYT	forsyth
PYNV	pino
GRVYN	gruen
MLBAY	melby
KVLASA	kolasa
TYNY	tiny
ASPR	spur
GAPTA	gupta
ALVARVS	alvarus
KATLYR	cutler
FVRLANG	furlong
SADYKVYH	saddique
LYVNZ	lions
MARKVS	marcus
MVHAN	mohan
LVRA	lora
BALSARA	bulsara
LVRJYV	lorgio
VYTVR	vitor
ZYGMVNT	zygmunt
RADAK	radek
GVPTA	gupta
SYSLV	sislo
ASTRYD	astrid
DANKAN	duncan
JVN	jun
ASPYDN	speden
DAVNYNG	dawning
LVRY	lory
RAFAYL	rafael
SAGARS	sugars
ALZ	elz
ANJY	engi
ASTARGYL	sturgill
DHAMAR	dhamar
KVAN	kwan
BVLDT	boldt
AKMAN	ekman
ANTARAMYAN	antaramian
HVRGAN	horgan
DRYV	drew
LVS	los
RYVNSVN	runeson
SVNJA	sonja
TYNG	ting
AGVYV	agoyo
AYRYK	eirik
JHANG	jhang
HVRKAN	horkan
ASMYTZ	smiths
TAMZ	toms
ASLYNY	slaney
VYLDYNG	wilding
ANPYNGKV	unpingco
ASTRYTY	steriti
LYVYNGSTVN	livingston
KANSTABARYS	constabaris
RALF	ralf
NYKVLAS	nicolas
BYANGTAY	byungtae
HAMMANZ	hammans
BLAL	blal
RAVDAH	rawdah
TVMY	tomi
MVNTA	monta
NVDA	noda
MAYRS	myers
AMNVN	amnon
HANTYNGTVN	huntington
RVY	roy
VAN	van
ASMA	asma
MASAHYRV	masahiro
AVYVA	aviva
SAFT	soft
DVGAN	dogan
ALYN	elin
DAY	duy
KRAY	cray
SYMS	sims
KVSYRA	kucera
NADVLNY	nadolny
MANGAN	mangan
DANG	dung
ASTRYTY	steriti
VYVYANH	viviane
SANJAY	sanjay
RADHYKA	radhika
SYVN	sune
SANTSBRN	sansburn
LANDRVM	landrum
BRAHAM	braham
AYCYRV	ichiro
SANJAY	sanjay
TALYBAH	talibah
GVRV	guru
VYRYANA	wiryana
'BVDHABY	abudhabi
VYLDKAT	wildcat
PANDYT	pandit
ASTYRN	stearn
SVHAS	suhas
LAP	lap
VYLKYNZ	wilkins
VAYN	vine
KANYG	konig
