MYNTZ	mintz
AYLKA	ilkka
PAYNTVN	paynton
MYNA	mina
GRANT	grant
YVNGSAP	yongsup
MALTYN	maltin
MYSA	mesa
LAMBARDV	lombardo
YVNAL	uenal
GVANYAV	guanyao
MARYTJY	maritje
LYA	lea
NAGY	nagy
VYMAN	wyman
VAJDYK	vajdic
AVNSTY	onesty
'RBYL	arbil
LASKALA	lascala
JANSKY	jansky
VAYNTH	wyntje
BARNARD	barnard
BDYRA	bdira
PALSKY	polsky
KAZY	kazi
DYN	din
ANTVNYVS	antonius
KAPSVN	kapson
ADKYNZ	adkins
ALVYN	alwin
MVHAN	mohan
ANDRYA	andrea
ARGAR	orgar
LYTVYN	litvin
TVNG	tung
ARMSTRANG	armstrong
ALTMAN	altman
GRVYN	gruen
HYNZ	hinz
JASTJY	justje
BASTYK	bostic
BARG	burg
GRABNAR	grabnar
KRANSVYYK	cranswick
PANJABY	punjabi
KYVMR	kumar
DYVAN	dewan
SANZ	sanz
KANG	kang
NAGASYVA	nagasiva
'LYA	alia
SAYRY	sayre
TRVYYJH	truitje
TAT	tat
LASNYK	lasnik
ALMVDYVAR	almudevar
BAKAR	bacar
JALA	jala
TAMY	tomi
JASTYH	justje
MAHALY	mahaly
TRVKS	truex
TRAVN	trown
PYNZ	pins
ASTAR	starr
AKYL	akil
BALYGA	baliga
DAMYAN	damian
AYSVN	ayson
SAKAYV	sakaue
JYNAKYRAMAN	janakiraman
ASMYTZ	smiths
DYAZ	diaz
LYKYVRY	liquori
DYMYTRYS	dimitris
ABVLYN	abolin
MVNK	monk
ADRY	adri
ZAHYD	zahid
TARYK	tariq
PARSVNZ	parsons
TALMY	talmy
ABRAPT	abrupt
FARYHA	fariha
ZYTV	zito
PLANK	plunk
MYLASYS	milacic
ARYN	erin
AVN	aun
LALYT	lalit
MYTVN	maton
JAHMANH	jahmane
AYDA	aida
ANJLYSYA	anglesea
BYTZ	bitz
BALV	balu
VYLKYNZ	wilkins
PAL	pal
FRANKVYZ	francoys
LAPYDARY	lapidary
KAVS	kaos
MARZ	marz
LYNDVN	lyndon
MVN	mun
MAYNR	miner
ASTARBAK	starbuck
PVSV	poso
MARAZAS	marazas
SAGA	suga
SAYDA	saida
GRAG	grog
SAN	son
MVRNYNG	morning
AYMAN	aiman
AVYRSA	aversa
AYNGLYS	english
ADKYNZ	adkins
FVNKY	funky
JYAN	jian
BARTA	barta
FRANSYSKVS	frnaciscus
MAMFVRD	mumford
HASYK	husik
BRADY	brady
ASPYTZR	spitzer
LVRD	lord
VAH	wah
PANGBVRN	pangborn
BALTAYS	baltais
BRVTY	bruty
AVLA	olah
BADVYYN	bauduyn
BRYGVY	bryguy
MVRANDV	morando
MAYR	mire
GLDASTYYN	goldsteen
ASTYVN	steven
HAYVL	houle
ARNVT	arnot
ZARYA	zaria
ADMYSTVN	edmiston
NYPTVN	napton
TAM	tom
ASPR	spur
DANA	dana
MANGYN	mangin
LAPASV	lapaso
YANSVN	yanson
FRAST	frost
FAVAZ	fawaz
AYSTMVS	isthmus
KRVB	krob
KRVG	krug
TVFTH	tufte
SYR	cyr
BLVM	blum
KVKAL	kokal
ABYL	abel
VYNTJH	wyntje
KYKVMA	kikuma
SYSLV	sislo
KANAKAKVRN	kanakakorn
AFA	afa
TYMBVL	timbol
ASTNSRAD	stensrud
ASPYDN	speden
KRYSTYJNTJH	kristijntje
GVPALAN	gopalan
DYKV	dico
LVN	lon
ALVARV	alvaro
KALDYS	kaldis
KVYALYK	kowalik
BYSYN	basin
BARKVLV	barculo
DANSYNG	dancing
PVTZ	putz
BRAN	bran
KALBYDA	kulbida
SYANV	siano
GVLAND	goland
GVRTVN	gorton
TAKSBRY	tuxbury
VYJNAND	wijnand
DYNY	dini
SYMYNGTVN	symington
PATRYK	patric
LVSANTVS	losantos
RYMVN	rymon
AVRAYZ	averis
FVRSBLAM	forsblom
ANJLYSYA	anglesea
FAVZY	fawzi
DYAMANTARAS	diamantaras
AYLR	iler
GALYZYA	galizia
NAGASAKY	nagasaki
ANAND	anand
HAYNS	hines
ALYNGTVN	alington
MYSTRY	mistry
KASYNSKY	kosinski
HYVM	hume
ARNVT	arnot
PARDY	pardi
MAYZ	mize
DVHH	duha
KAZVHYRV	kazuhiro
NYKVLAS	nicolas
JAYNVR	gainor
TVMY	tomi
VAYD	wide
ALFVRD	elford
ALVAN	alwan
TYMYAN	timian
KVANG	kwong
SATVR	satur
PRYSYNG	pricing
BAYLS	byles
JAYAN	jayan
SVDYPTV	sudipto
ASTRY	stray
MATAR	matar
AYTCVN	itchon
NVDA	noda
ADKYNZ	adkins
ASK	ask
MVMFVRD	mumford
ASMAYT	smythe
DYPAK	dipak
RADRAMVNY	rudramuni
FATYS	fotis
PYNZ	pins
SANRANG	sunrong
MYNA	mina
AYZMN	isman
YVNAL	uenal
NAYKVLAS	nicolaes
DYVYLDH	dewilde
KAYRD	caird
HAV	haw
LAS	las
MVRYTA	morita
VAYL	vail
KVNV	kono
DAHVK	dahuk
AYSPVRT	iceport
KAYAK	kayak
ASPAT	spath
MAY	may
DYVYDSVN	davidson
NARDY	nardi
BARG	burg
MVRNYNG	morning
AVAN	awan
VALVR	valur
ANYART	enyart
'BDAL'ZYR	abdulaziz
NAZARYTYAN	nazaretian
LVTYNZ	lutins
BRABANT	brabant
AZALYA	azalea
AYNA	inna
MAYRZ	myers
LAVYGNH	lavigne
HYJDAN	higdon
GYRARD	girard
ALFVRD	alford
LYVNZ	lions
DYVYDSVN	davidson
FAVAZ	fawaz
MARYN	marin
FLARDYNGA	flardinga
SVAMY	swami
HAPSVN	hopson
PVTZ	putz
FRANSYNTAY	francyntie
LALY	laly
LVZANV	lozano
PRYSTVN	preston
ATRY	atri
GANTY	ganti
DVRDAL	dordal
BRAN	bron
PANT	pant
FYN	fin
HAYZ	hise
KRYSTAL	crystal
DVRAPT	durupt
LAMYKYN	lamykin
FYNK	fink
BANYTA	bonita
DANG	dung
NYGRA	nigra
AVMAKY	ohmaki
RAYSL	risel
JAKVMYNTAY	jacomyntie
GVPTH	gupte
BRAVNYNG	browning
LAN	lan
FAYNK	finke
MAYRYK	myrick
LAMBVRN	lamborn
RASKYN	raskin
BARNARD	barnard
NVNYS	nunis
KYNGSTVN	kingston
KANYG	konig
KAMBZ	combs
MVRANV	morano
HALPYN	halpin
MARYANA	mariano
SANYL	sunil
TVYYG	twigg
KYV	kao
PAYTVN	payton
TYNG	ting
FABRH	fabre
AGRAVALA	agrawala
ASTYVN	steven
SASTYK	sustik
MYNKY	minqi
LYVYNGSTVN	livingston
AYSY	ayse
TALYBAH	talibah
NYN	nin
PANDA	panda
DVRFMAN	dorfman
HADYL	hadil
HASK	husk
MYLASYS	milacic
LAYVRYTSN	lauritsen
ARNH	arne
KYAT	kiat
RVNDH	ronde
PAPLY	popli
ADYT	adit
BALYN	balin
AMYRA	amira
LAVZAK	lauzac
KYSVN	cason
ABYAB	abiab
ASTVART	stewart
NAGY	nagy
KARABVLVT	karabulut
PAN	pan
DAK	doc
AVTJH	oetje
BAYARD	bayard
DAYBALA	dyballa
ARGAR	orgar
LARJA	larga
AFA	afa
TRVMBV	trumbo
SYDVR	sidor
FAYRBANK	fairbank
LYNDVN	lyndon
NVDYNG	nuding
HRABY	hrabi
KRYSTYNA	kristina
JANSJH	jansje
JAKVBS	jacobs
SYLVAN	sylvan
KRYVVNVZ	kriwonos
FABRYS	fabris
AFTAB	aftab
VALDRAM	waldram
AMYVT	amiot
LYSY	lacy
TYMYAN	timian
NYHALANY	nihalani
ALYA	alya
'RRYFA	arrifa
MYLMAN	melman
VYND	wind
DAYVVN	dauwen
DAV	dow
BARNARD	barnard
AYNGALZ	ingalls
AYRDV	airdo
SANTYK	santic
KVNV	kono
BYG	big
ANRAH	unruh
SYR	cyr
DYANA	diana
RASTRAM	rostrom
VYDYV	video
DYLYP	dilip
AMYVT	amiot
MYRMAK	mirmak
LADASKY	ladasky
DAN	dan
BARGVS	bargus
HVRSFVRD	horsford
DRYNKS	drinks
SYVA	siva
VYKTYM	victim
LAS	las
AVLVSTAD	ulvestad
BALYT	balit
SVAGATV	swagato
VYBVVV	wibowo
VYDAL	vidal
ALMVDYVAR	almudevar
BLANZDVN	blunsdon
PALVMBV	palumbo
LANTZ	lantz
AYALA	ayala
ASTRYM	stream
AVSTRANDR	ostrander
ASTANGYR	stangier
MAYR	mayr
GVPTH	gupte
KVJYAS	kogias
VYLYNGZ	willing
AYSRT	israt
VYNKV	vinko
GRVHVL	grohol
BARY	bari
LYANG	liang
ARYN	erin
AYS	ice
KANA	kana
PAYTVN	payton
DVVAYKYNK	duickinck
MAGVAYR	maguire
AVR	ore
GRAF	graf
LAS	las
BAYFYLD	byfield
ASKVLYNG	scowling
ABA	aba
KALA	cala
RVTABAGA	rutabaga
LAYVRYTSN	lauritsen
JAST	jost
AMYH	amie
BARTHVLVMYVS	bartholomeus
KARLKVYST	karlquist
LADVYG	ladwig
TYVNYS	teunis
YVRMV	yermo
NYVKVYST	newquist
JVANYTA	juanita
VYNTJY	wyntje
SANTVS	santos
FRAYDMAN	friedman
MARSY	marcy
LAYMAK	limace
ASKLTVN	skelton
RAZDAN	razdan
KVYN	quin
RANY	rony
GARMZ	garms
MYRVT	mirut
BVZKART	bozkurt
VYNSTVN	winston
NYVAYNGTN	newington
JYSVZ	jesus
KALTVN	colton
KVRP	korp
SABRAMANYAN	subramanian
LAYBZ	libes
ATKA	atka
ASPAT	spath
ASTYN	steen
KYNA	kina
ASTAKY	stucki
DABAS	dubuc
ALYA	elia
RAFAYLY	rafaeli
TYN	tin
GRAV	grau
LYA	lea
MKMAHAN	mcmahan
PRASAD	prasad
AYVRSVN	iverson
ASPARNDAM	spaarndam
AVBRTAS	obertas
AYVJNH	eugene
ARKTYKY	arktiki
NAHAM	nahum
'LAALDYN	alaaldin
PRAYL	prael
HALVB	holub
VLADAN	vladan
JVNYVR	junior
SYLVAN	sylvan
RADAK	radek
ANDRYS	andres
DYVYD	david
KALDYS	kaldis
BARFVRD	barford
VYK	vic
SAMVSKY	samosky
LANGV	lungu
ADMYRALZ	admirals
VASLV	waslo
ANDRYS	andres
MARGVLYVKS	margulieux
TYNY	tiny
AFA	afa
PANDA	panda
DAVNYNG	downing
TVYN	twin
AGYLA	aqila
KVNVPKA	konopka
TYMYAN	timian
GATZ	gatz
AMARYT	amarit
KVRBYN	corbin
KAVASYN	cavasin
BVYKV	boyko
KYLG	kilg
KYRK	kirk
MYRMAK	mirmak
BYLYNSKY	bilinsky
KLAZVRA	klazura
HAMMANZ	hammans
LYSY	lacy
DVALYBAY	dowaliby
AVR	ore
AKLVF	eklof
LYANG	liang
MAGAGNA	magagna
DYZVN	dizon
ADYH	adie
HASBY	husby
MANV	muno
MVGANTY	moganti
KALPYN	culpin
JAKVBY	jacoby
GVRAN	goran
KAV	kao
DYANA	diana
PVZYVS	posius
DVBYNSVN	dobinson
DAVN	down
YANSVN	yanson
NAZARYTYAN	nazaretian
JYVK	jiok
HYN	hin
BANKRVFT	bancroft
GRAFT	graft
BYAVYS	beavis
MYSA	mesa
GAYDA	gayda
GVSTAV	gustav
PAYK	pike
MYLMAN	melman
YVMN	yumn
BRYVN	bryon
VYMPJY	wimpje
AGBVRN	ogborn
ANDRYVZ	andrews
VYGTVN	wigton
VYLDKAT	wildcat
TVBYAS	tobias
DVHH	duha
NYDH	nida
ATKYNSVN	atkinson
YVMVRA	uemura
MAY	may
FVRJY	forgy
TRAYNVR	traynor
HADYL	hadil
MANDA	manda
AYNGMAR	ingemar
ASTRYAN	stroyan
GAYDRY	guidry
DVGAN	dugan
LASK	lusk
DADGYVN	dudgeon
GANG	gung
KYRYL	cyril
NYN	nin
GVRKY	gorki
RAN	ron
ATKYNZ	atkins
GRANT	grant
FVRSBLAM	forsblom
TVRYN	turin
APRYL	april
DVNHAM	dunham
RYHANA	rihana
LAPVTA	laputa
FABRYS	fabris
BRABANT	brabant
TRAYNTZ	tryntje
DVLYN	dolin
SYMVNZ	simons
ABDVN	ebdon
HYKARV	hikaru
VARYANTZ	variants
MYNA	mina
AMYHAY	amihai
ASKAVN	skaven
LYDYA	lydea
ANYSA	anisa
ZHRA	zara
MAKAYVLY	macauley
S'YD	said
DAVKNYZ	dawkins
BYLAL	bilal
LAMBRVS	lambros
LANGV	lungu
KVYNRYDVS	coenradus
VYNSN	wincn
TAMPAS	tampas
SYGMVND	sigmund
HARARY	harari
JVAN	joan
ANTVNYV	antonio
DYLAN	dilan
DAVNYNG	downing
GANAVAN	gunawan
FRANSYSKA	francisca
DVRVYN	dorwin
GANTY	ganti
PLYSKYN	pliskin
RYZVY	rizvi
DVY	doi
BVYZY	boisy
SASKA	suska
BALTAKS	baltaxe
DYMYTRY	dimitri
AMBRVSYV	ambrosio
PYRYZ	perez
DAK	doc
BVRST	borst
RAMA	rama
HALPYN	halpin
ALKSY	alexy
KVA	kwa
DANYLV	danilo
AYN	ain
SVKVMAR	sukumar
LANKTVN	lankton
JAVYKA	jovica
BVTARY	botari
KALYSYAK	kalisiak
KRVG	krug
GAVYND	govind
NARDY	nardi
LYVYS	lewis
BARTVLYNY	bartolini
YASYN	yasin
GADYL	gadil
GYBVR	gabor
AVYS	avis
SYMAL	cemal
ANALVG	analog
KAV	cau
AYRYK	eirik
SAVYR	sauer
PABLV	pablo
SVNG	sung
KALB	kalb
FRANSYSKA	francisca
ASTK	stec
HYDAJAT	hidajat
KARDAL	kardal
PALSKY	polsky
LAVTVN	lawton
HYTZ	hitz
VALDV	waldo
GVRAPARTAP	gurupartap
DYAB	diab
HVYYSKN	huisken
MYRTY	mirti
KLAYN	kline
PAPAY	papay
ZAZA	zaza
LASTRA	lastra
LANDRY	landry
HAVN	hawn
DVA	dua
HYRVTA	hirota
MAY	may
GAVYNDAN	govindan
SVPRATYK	supratic
HALST	holst
LAMYKYN	lamykin
FARYD	farid
PAYTR	pitre
VYVYANH	viviane
TALMY	talmy
FARAGV	farago
GALAHAD	galahad
MVYNYHAN	moynihan
BVYRKVYL	boerkoel
TAMATYVS	tomatius
TRAVN	trown
LAN	lan
HARVNY	haruni
SYNDRH	sindre
VYLDYNG	wilding
HAPKARFT	hopcraft
LYVYVS	livius
MARTYNZ	martins
ABYAN	abyan
GRVHVL	grohol
LANKA	lanka
SARMA	sarma
JYVK	jiok
VYVYK	vivek
ANZALVNY	anzalone
LYTV	leto
ANRAH	unruh
HYN	hin
PASYFYK	pacific
DYSAY	desai
AZAD	azad
PAYTR	pitre
LYNDAN	lyndon
GNVSYS	gnosis
HYDAJAT	hidajat
ADRY	adri
ASPYDN	speden
LANA	lana
ASTYK	astik
AYDS	eads
BVDLA	bodla
FYNSTAD	finstad
LYRYK	lyric
ARGAN	organ
FRANSYSKA	fransiska
KASTRYKAM	castricum
DJAMYLA	djamila
GRASKYN	gruskin
ALSAP	alsop
AVTA	otha
KARHART	carhart
'LY	ali
AYZAK	isacq
SARMA	sarma
ASBRYNK	asbrink
HARVARD	harvard
BRAYSLAV	berislav
AYLVR	aylor
BARTVK	bartok
MANRV	munro
NAVAS	navas
KVYYNTVN	quainton
NYKVLAS	nicolas
DAVNYNG	dawning
ASTRYD	astrid
AKYL	akil
BALYT	balit
TVMYTYVS	tomatius
KAMALA	kamala
NADYG	nadig
AVRM	orem
SASTYK	sustik
KRANSVYYK	cranswick
ZVLD	zold
DARVN	doron
BRAVN	brawn
NYYVTN	newton
'AYMN	ayman
ADVVART	eduwart
BARVNYA	baronia
LVTYNZ	lutins
KVNYNG	koning
SAMVN	sumon
PASKV	pasco
VYNTJH	wyntje
LANDGRYN	lundgren
BASYLYVS	basilius
RYGV	rigo
MADYV	madeo
RASTYN	rastin
BYG	big
BANYTV	bonito
MANGLANY	manglani
BLVHM	blohm
BRATYNA	bratina
BYLHAR	bilhar
RVBYNSVN	robinson
LYVN	leon
ALVA	alva
VYMPYJ	wimpje
DAYR	dyer
NVYA	noya
KARA	kara
MVRLAN	morlan
JYSVZ	jesus
AYSMN	isman
AYLR	iler
AYVTYK	ivetic
LVSY	lucy
ASPYRZ	spears
GRYST	grist
ALFVRD	elford
SYMVNDS	simonds
SASLAV	saslav
ASPYDN	speden
AYNGLS	ingles
KVRZAYN	corzine
FRANSYNTAY	francyntie
TAPLYN	taplin
AYVTYK	ivetic
ATYNZVN	etinzon
AMS	ems
FRANSYSKA	francisca
LVYYZV	loizzo
HAYN	hine
AVRVM	avrum
BASTYK	bostic
ALMYNTAKAH	almintaqah
HAYNGH	hainge
ASLYNY	slaney
LYDVR	lidor
GANATRA	ganatra
KRAYDR	crider
RVRY	rory
MARANY	marani
HALAN	hulan
AVGVST	august
PVLK	polk
FRNASYSKAS	frnaciscus
VYSKA	visca
VYRJYL	virgil
ARBY	orbi
VYLKYN	wilkin
BRABANT	brabant
MVRAVAN	moravan
HARDYN	hardin
PVLYYAM	pulliam
SYLA	sela
VYVKS	vieux
LYPKYN	lipkin
RVSV	rosu
AVVLYV	avolio
ZARA	zara
BALDVR	baldur
NYD	nid
PYRANY	pirani
DRAMATYS	dramatis
FLAT	flat
VARGAS	vargas
JAHMANH	jahmane
JVHANSVN	johansen
ASLAVK	slawek
AMANV	amano
LALKYN	lulkin
AYSKANDR	iskander
VYKAS	vikas
KALB	kalb
ALGYNGTVN	elkington
AYSKANDR	iskander
DAGAN	dugan
MVNKAR	moncur
AYVRS	evers
PARKYN	parkin
HALTZ	holtz
BAPTYSTA	baptista
VYRYANA	wiryana
FVRSBLAM	forsblom
ARVYNG	irving
BRYSTVL	bristol
RADRAMVNY	rudramuni
ASTRAK	strock
ADGYNGTVN	edgington
SAYTZ	sites
GVNY	gony
MALTYN	maltin
'RRYFA	arrifa
BASYL	basil
KAYN	kain
FARYHA	fariha
TVSV	tuso
DVZAT	duzat
RVSA	rosa
KVRBYN	corbin
VYLADVT	viladot
ALKSY	alexy
MVRAVAN	moravan
SAGA	suga
DYKV	dico
HADSVN	hodson
DAMYTRV	dumitru
HASKYNZ	hoskins
RASTY	rusty
AVSYVN	oseven
ALVA	alva
MALAN	malan
LYRYKAL	lyrical
FRANSYSKA	francisca
RAHVL	rahul
PVGVSYAN	pogosyan
FALTAK	foltak
AQBAL	ikbal
HAYRVNYMVS	hieronimus
ALVYN	alwin
LADYK	ladic
SVDARMV	sudarmo
NAYA	nina
DYVYS	divis
FVNDAL	fundal
MYLARA	melara
AKVNA	acuna
SYT	sit
ASPVTYS	seputis
LANTZ	luntz
GVY	gui
PYNKY	pinky
RAFA	rafa
PAYNY	payne
MAYR	mire
KVBSA	kobsa
JASTJY	justje
YAMYNAH	yaminah
ALMV	elmo
RABYNSVN	robinson
SVSYA	sucia
BAN	bon
SYMVNZ	simons
HASAKAH	hasakah
SAKAYV	sakaue
KLAYTVN	clayton
SARVATH	sarwate
BARNAM	barnum
HVGARTY	hogarty
BVLDT	boldt
DYVYDSVN	davidson
KAVH	kave
RYJSVYJK	rijswijk
AYSAK	isaac
AMVRVSV	amoroso
GVRDYN	gordin
AYNTLSAT	intelsat
AVNSTY	onesty
RABYV	rubio
BARLAS	barlas
LANKART	lonkart
KVAYMAN	coeyman
KRVK	krok
AMYKVS	amicus
'LAALDYN	alaaldin
TVLYV	tulio
GAVYNDAN	govindan
KARLKVYST	karlquist
RAYMVND	raymond
HARDYN	hardin
BALDVR	baldur
ANATVLY	anatoly
HARATZ	haratz
DAMYVN	damion
ASMYRNV	smirnov
BLASY	blasi
TYRZA	tirza
MKMANYS	mcmanis
HYVVYT	hewitt
AMYH	amie
PARSVNZ	parsons
MAMA	mama
ABVDHABY	abudhabi
SYLK	silk
GVRKY	gorki
KADRYBYSYK	kadribasic
MARSY	marcy
MVTVR	motor
DAPAY	dupuy
KAPLYNK	kaplenk
ASTAD	stude
TARYK	tariq
BALHAM	balham
SYLVA	silva
AYRLAYNZ	airlines
HVRYV	horio
PVLVVYN	polowin
AYDS	eads
GANAVAN	gunawan
DVHA	duha
NYTYN	nitin
NVRHA	norha
LAYHV	laiho
AYMAN	ayman
RYTA	rita
GYVZ	guse
LAY	lai
JYBSVN	gibson
BAABAR	baabar
LYDVR	lidor
BAND	bond
DANA	dana
NAYA	nina
VYLJV	viljo
KYVNG	kiong
GRAG	grog
KANG	kong
MVRLAN	morlan
AZANA	ozuna
PAKALA	pakala
FRANSYSKA	fransiska
ASLAVMYZ	slawomir
GVRGANZ	gorgons
DAKV	daco
