BALYGA	baliga
PANGBVRN	pangborn
ASTV	stew
GVAN	guan
BRAYSLAV	berislav
NYLS	nils
TYRZA	tirza
DAYRKTVR	director
VYRJYNYA	virginia
ANFANT	enfant
DRAVN	drown
HAN	han
KANTARA	cantara
ABVDHABY	abudhabi
SYNK	cinq
MYNA	mina
KVLYHA	koliha
HAYN	hain
NYVKVYST	newquist
MADABA	madaba
GVRALP	guralp
KLBAY	kilby
ASTARGS	sturges
JVSLYN	joslin
MVNTALBANV	montalbano
AFTAB	aftab
DRAMATYS	dramatis
MKMANYS	mcmanis
FYSK	fisk
MYTVN	maton
DANG	dong
ANFANT	enfant
'FAF	afaf
BRVTY	bruty
DARHAM	durham
ASTAKS	stocks
GAYVN	gawne
TYMYAN	timian
PRVTVS	protus
ASTYVN	steven
KANTARA	cantara
PRAYVN	priven
LASTRA	lastra
SVHA	suha
SYVNKA	cionca
GVAN	guan
AKA	aka
RVTZ	rotz
HAPSVN	hopson
RYTYSGRT	ritsgert
AVLSN	olson
PVHAN	puhan
DRYV	drew
AFYF	afif
VARN	warn
PRYYVTY	priotti
PVRTNVY	portnoy
YANGY	yangi
AYNTJH	eyntje
LAYL	lyle
KRVG	krug
PYNTVN	pinton
ALYAS	alias
DYVAYN	devine
BRVKAV	brokaw
PVLV	polo
PRAHL	prahl
ASKYN	skean
PYPVNY	piponi
SYMS	sims
ALFARV	alfaro
MYRMAK	mirmak
SABYNY	sabini
PVLYYAM	pulliam
VYDY	vidi
VYN	vin
JYA	jia
MVNTAGV	montagu
GLATZ	glatz
LVRY	lori
ASMVT	smoot
AMYH	amie
TVYT	toit
ASPYRZ	spiers
GVY	gui
KAV	cao
VYLJV	viljo
SYLVAN	sylvan
TYMVR	timur
BKS	bex
DASYVK	doseok
HVA	hua
BLKSVM	bloxom
HAV	haw
ASVALAP	aswalap
HARYHARAN	hariharan
HAV	hao
ZYZY	zeke
KVYL	quel
NVDA	noda
JYA	jia
SLYM	slim
BVSTRVM	bostrom
PAVLYK	pavlik
HAYM	hime
ANASTASYA	anastacia
RVTABAGA	rutabaga
ABYL	abel
SYMPLYSYTY	simplicity
AYSAKS	isaacs
SYMVN	simon
LAGVMVRVF	lagomorph
FLARDYNGA	flardinga
DYVYLDH	dewilde
VYGJYN	wiggin
DABAS	dubuc
ANAYZA	unaiza
PARSVNZ	parsons
AVRCARD	orchard
GVRALP	guralp
ATYYA	atiya
MAHAVLT	mahault
JVRY	jory
PATYL	patil
AKY	aki
TVVYS	twiss
ASPYR	spear
RAYDJ	ridge
CAYLDZ	childs
DANAVAN	donovan
JYAN	jian
KVASYM	quasim
LAMBVRN	lamborn
MVRAN	moran
ALSVN	olson
ALVYN	alwin
ASTVRR	storer
SYMVN	simon
PVZYVS	posius
ARNVLD	arnold
GATLYN	gatlin
HASTYNGZ	hastings
JVZY	josi
GVRAV	gorav
KRYST	crest
DVZYYR	dozier
BAYRN	byrne
NADYG	nadig
DVDAMANY	dodamani
HARBVD	harbud
MANGLANY	manglani
DVNG	dong
SALMVND	salmond
MARTYNV	martino
LALY	laly
RVKSAN	roxsan
SAMYT	sumit
FANGVS	fungus
PASYFYK	pacific
RAMYRV	ramiro
LVFSTRVM	lofstrom
ASPLYD	spleid
MYLARA	melara
AYVA	iowa
ANTANAYTYS	antanaitis
KVASYM	quasim
SVRVALY	sorvali
FADL	fadl
ALMVDYVAR	almudevar
SYNAN	sinan
DYNT	dint
KYRBY	kirby
KLAVDYA	claudia
DVBAY	dubay
ALVYN	alwyn
DVRAN	doran
SYLVYA	silvia
ANTARAMYAN	antaramian
MAYR	mire
KAYT	kyte
MARKVYZA	marqueza
KAYNY	caine
RAYSL	risel
JYM	jim
ARSKAYN	erskine
MANAMA	manama
BRYYTVN	britton
RYSLYNG	rysling
KRAMHVRN	crumhorn
MVNKZ	monks
ASTYL	still
KVRT	cort
LYYVVH	lieuwe
AYRLAYNZ	airlines
ASTYRN	stearn
JAGARD	jagard
SVLYTAS	sotilas
KASAT	kasat
PANYKV	panico
KALAFATAS	kalafatas
LVRJYV	lorgio
KAKY	kaki
GADBVYS	gadbois
FVRLANG	furlong
KVHAN	cohan
MAKAYVLY	macauley
AKVNA	acuna
MYTV	mitu
BYLYNGASLAY	billingsley
AYRLAYNZ	airlines
KRYSP	crisp
RAVDAH	rawdah
NYVAYNGTN	newington
MVNAKV	monaco
AYSVN	ayson
RAFALSKY	rafalski
TAY	tye
AVHALVRAN	ohalloran
TRVYYJH	truitje
HAYZ	hise
SAKLAD	saklad
HALAT	halat
BANKRVFT	bancroft
ASKVLYNG	scowling
AKYTVMV	akitomo
ZHRA	zara
NVKS	knox
LYVNARDV	leonardo
JANARDHAN	janardhan
NVVYK	novik
HANSVN	hanson
KATY	kati
MVNAGAN	monagan
SYLVYV	silvio
KLYFT	clift
DAHVK	dahuk
RAVDA	radwa
GASKVYYN	gascoyne
VYJDAN	wijdan
JYRARDYN	gerardin
VAVDRY	vawdry
RYSLYNG	rysling
KAV	cau
AVANZ	evans
GASLYNG	gosling
ARYKSVN	ericson
KALDYS	kaldis
RAYBLT	rybolt
JAD	jud
PYYRY	pieri
PVHL	pohl
BAPTYSTA	baptista
HASTYNGZ	hastings
RVNALD	ronald
LYNK	link
BASKAR	baskar
LANG	lung
FRAMSAN	fromson
DADGYVN	dudgeon
AKYHYKV	akihiko
KVAST	kwast
AZANA	ozuna
FVJY	fuji
ALKSY	alexy
KARL	karl
GANZAK	ganzak
MVMFVRD	mumford
KARY	kari
DVBYNYN	dubinin
HYVNGAN	hiongun
'QYL	aqil
MANAMA	manama
FVJY	fuji
TAYV	thao
RYTYSGRT	ritsgert
ASPLYNTR	splinter
TANTVN	tanton
TVMATYVS	tomatius
BVD	bud
BAYRTAY	baertie
MANGYN	mangin
FRANSYNTAY	francyntie
KRAVFVRD	crawford
FYLYAS	filias
ALMVMAN	elmoman
KVAAYNTN	quainton
KAV	cau
BYFRAST	bifrost
BANKRAFT	bancroft
KAV	cau
SYLVYA	silvia
SASAKY	cacace
HALTZ	holtz
BAGDAN	bogdon
HADSVN	hudson
HYRD	hird
CAYLDZ	childs
HYSLVP	hyslop
ADAN	adan
JYVVYL	jewell
VYDY	vidi
VYN	vin
ANDRYA	andrea
ANSYH	anisa
NYMRAD	nimrod
KRAVFVRD	crawford
AYRLAYNZ	airlines
DVRYS	doris
NYYVTN	newton
KVRDAS	kordas
HYNDRYKA	hendrica
SASLAV	saslav
HYYN	hean
LAND	land
TVLANY	tolani
AYGLV	igloo
DVRYS	doris
HVRGAN	horgan
NYVARK	newark
BLAVADNYK	blavatnik
ATARAS	ataras
RYYD	reed
ASTVARD	steward
KALYA	kalia
KVDY	cody
BALTAYS	baltais
'ADL	adel
JVAN	joan
LVS	los
SVL	sol
FRNASYSKAS	frnaciscus
HASAKAH	hasakah
GAYNVR	gainor
ANATVLY	anatoly
ALANA	alana
BYKVN	bacon
APRYL	april
KNVFYNKH	knufinke
KVSVGH	kosuge
KAYN	cain
ANGVLV	angulo
HAYN	hine
KYV	kao
ARLYNG	arling
PYRAMYD	pyramid
LADVVYKVS	ludovicus
LVYD	loyd
PAVLYK	pavlik
DAYLVN	dillon
ZARYA	zaria
ALMVDYVAR	almudevar
VARN	warn
FVRJY	forgy
KALB	kalb
BASYN	basin
RADVA	radwa
PAKALA	pakala
AVSTYN	austin
ASTYN	steen
BAYARD	bayard
GASTAVVS	gustavus
MAHTV	mahto
KARTYS	curtis
VYLYNGZ	willing
SAN	son
TVLA	tula
ASTK	stec
HVAR	hoar
RAKYKVT	racicot
RATKS	rutks
KAYL	kyle
SYLA	sela
VASLV	waslo
BVDA	buda
NAGY	nagy
NAGY	nagy
PRYVR	pryor
ASPARZA	esparza
ANRYKV	enrico
AVBRTAS	obertas
NVDA	noda
ANVKVL	anukul
KRYSPYJN	crispijn
LAND	lund
KVNV	kono
DAG	dag
MVRABYTV	morabito
TARYK	tariq
NAGY	nagy
KVHN	cohn
JANA	jana
LYMYNG	liming
KLARK	clark
DVBYNYN	dubinin
AMAL	amal
BARNABY	barnaby
KVBYLAH	qubilah
KANYA	kania
FYRMA	firma
SYKVLV	sicolo
KVYALYK	kowalik
BVKSY	buxey
MVRA	mura
GAMAL	gamal
BAVDYN	baudin
KRYSTYN	kristin
MYKVLYK	mikolic
VYZNAND	wijnand
ASTYLZ	stiles
TYNY	tiny
TVDAR	tudor
BVDV	bodo
GVYYLYM	gwillim
BLANSDAN	blunsdon
ANSKAMB	anscomb
TVSKANV	toscano
MVTYSV	mutiso
JANG	jung
LYBYD	lebed
HYRAY	hirai
VVLTRNYNG	woltering
AYSVN	ayson
TVYYG	twigg
MVK	mok
TVBYN	tobin
KVRBYN	corbin
PYNYAN	pinyan
DVVAYKYNK	duickinck
ASMAYT	smythe
LVSYTV	losito
DANKAN	duncan
ASTYSY	stacey
HAYNLY	hinely
ZAZA	zaza
JVSLYN	joslin
BRAYS	brice
HVYYSKN	huisken
HALPYN	halpin
LAHYJ	lahij
NAZARYTYAN	nazaretian
ALSAP	alsop
HANSVN	hanson
KLAGSTVN	clugston
VAH	wah
BRYGVY	bryguy
VYKAS	vikas
AMNVN	amnon
ALTANYN	eltanin
ANANT	anant
RAFALKV	rafalko
YYKA	yeka
GAT	gat
ALZ	elz
GYLRVY	gilroy
BARBAS	barbas
MVNTANV	montano
BANYTA	bonita
JVDY	judy
BRAYS	brice
FRANKLYN	franklin
YVNAL	uenal
KVGVMA	kogoma
BLAHA	blaha
FADVR	fodor
GNVSYS	gnosis
ALVARVS	alvarus
TALBVYZ	talboys
PATRVKLVS	patroclus
DANGYVN	dungeon
KYMVRA	kimura
LVRA	lora
SVLTAN	sultan
NYN	nin
GYPJH	gepje
GRYTZ	gritz
ZYZY	zeke
ABA	aba
MANYJA	manija
DYSANTV	desanto
ARDYS	ardis
AL'YN	alain
SABRAMANYAM	subramaniam
GASLYNG	gosling
PAPLASKAS	paplaskas
HADYL	hadil
AYS	ace
RYTA	rita
AKL	akl
PYVRYNTN	purinton
ALMV	elmo
JANK	junk
KASVN	kasun
GVY	gui
RYJSVYJK	rijswijk
ALYVA	oliva
ALMAR	elmar
NVRA	nuri
MANGLANY	manglani
GADFRVYD	godfroid
JYZAN	jizan
TAMPAS	tampas
SYRYL	cyril
RAFAYLY	rafaeli
SYNYBALDY	sinibaldi
BVAY	buay
SANTVS	santos
AVANZ	evans
GADYL	gadil
SANTSBRN	sansburn
FALTAK	foltak
VANSY	vance
BYNG	bing
SAYRY	sayre
TYNA	tina
KART	kurt
LAVYGNH	lavigne
VYTVR	vitor
ASCVYLAR	schuyler
LAMBARD	lombard
KARLYN	carlin
ANJYLYNY	angelini
ASPRVT	sproat
BRYSBYN	brisbin
DVRAN	doran
LVNZ	lunz
BASKY	bosky
TRVN	tron
ZHRA	zara
DVGAN	dogan
AYS	ice
GRAHAM	graham
VYNSTVN	winston
BRANT	brunt
ALYAS	alias
AYN	ain
BAGZ	bugs
LYTV	leto
ADAN	adan
AGALY	agali
SVRK	sorc
DAVT	dout
TAPYV	tapio
MKKARTY	mccarty
HVRSFVRD	horsford
DVRMA	dorma
DVRMA	dorma
BARKVLV	barculo
KAYL	kyle
GYVVN	givon
LVYYZV	loizzo
JYM	jim
SALVMVN	solomon
MAYSAL	missal
KAVASYN	cavasin
ATKYNZ	etkins
GVDSVN	godson
GADFRVYD	godfroid
JVSLYN	joslin
MARYV	mario
JVDAS	judas
PADVLA	padula
ASTAFVRD	stafford
JAKVBS	jacobs
KALAFATAS	kalafatas
KRASBY	crosby
ANVN	anon
VVN	wun
KVAN	kwan
SYDVR	sidor
GVANYAV	guanyao
ASFAR	sphar
TAPTANY	toptani
KAMALA	kamala
MVK	mok
AMBRVSYVS	ambrosius
MAVN	maun
DYSAY	desai
KARTY	karty
ASTVRR	storer
KVASYM	quasim
GASKYN	gaskin
BARNAS	barnas
BVNYN	bonin
ANTVNYVS	antonius
GLVRYA	gloria
BRAHYM	brahim
VYZNAND	wijnand
LYM	lim
ARVAL	orval
BVSTRAM	bostrom
ALFVRD	alford
TKS	tex
JANA	jana
ASPLYD	spleid
AVGVST	august
GVYYLYM	gwillim
LYTVYN	litvin
AYLVT	eliot
GVY	gui
ASTVRY	storey
MARY	mury
AKSV	aksu
RAST	rust
FVRK	fork
MAVBY	mawby
ALMAR	elmar
ALSVN	olson
MARGARYTA	margretha
MARTYNTJH	martyntje
ALAYN	alain
GADBVYS	gadbois
LYNDZ	lynds
LAYBZ	libes
LVFASV	lofaso
MVNDFRANS	mondfrans
ADVVART	eduwart
HANYFA	hanifa
NANSY	nancy
BYANGTAY	byungtae
KAVASYN	cavasin
SVR	sor
SVLY	soli
BVS	bos
HADYL	hadil
LYTLY	lytle
HARRYG	harrig
HARYV	horio
AVTA	otha
VASYT	wasit
MASATV	masato
VALKA	walka
SYDVR	sidor
HVRKAN	horkan
TAYTY	tytie
ARBVR	arbur
AYLVARD	aylward
ASTAKR	stoker
KATVPYS	katopis
KALPAK	kalpak
TVMYTYVS	tomatius
MANDAL	mandal
KVYALYK	kowalik
DAVD	daud
HALST	holst
RVTZ	rotz
DRAGANYS	draganis
BRAHAM	braham
KRYSTYJNTJH	kristijntje
SKSTVN	sexton
RYDA	rida
ASK	ask
KVAYNTVN	quainton
AVRLYNZ	orleans
HAGAN	hagan
LYMYNG	liming
GABARA	gabara
AYVA	iowa
MARALY	murali
ASNV	snow
PRAYVN	priven
BARY	bari
MANGLANY	manglani
PAYTVN	payton
MVZYNA	mozina
HVYYSKN	huisken
BVZKART	bozkurt
HVRYNG	hornig
PANDZ	ponds
KARTYK	kartik
ASKVRR	scorer
TALBVYZ	talboys
ASTRVSTRAP	stroustrup
GABVR	gabor
MARKSN	marxen
AMNVN	amnon
SVNG	sung
TAPYK	topic
ARFVRD	orford
FRYTZYVS	fritzius
LYVYS	lewis
GVRAV	gorav
AMY	ami
MASATAKA	masataka
NARV	naro
ARNVLD	arnold
ALKSANDRVZ	alexandros
ALAYS	elyse
SANDAR	sundar
ANYL	anil
BVLDT	boldt
HRABY	hrabi
BRAVN	brawn
MVTYSV	mutiso
ALKS	alex
KVAAYNTN	quainton
ANDRYVZ	andrews
FVJYVKA	fujioka
SYGMVND	sigmund
ABHAY	abhay
BYLYNGASLAY	billingsley
GVYYN	gwynn
KVLASA	kolasa
LVK	luk
NVLF	nolf
LADYK	ladic
LVYYSALY	loiselle
MARTY	marti
ANTAL	antal
KALVYN	calvin
TAYV	thao
MARV	marv
TVMANY	tomany
BRAYSLAV	berislav
HARDYN	hardin
SYNK	cinq
BALTAKS	baltaxe
ANTVNY	antony
TRYVYTZ	truitje
MANDA	manda
SARDV	sardo
SYNYBALDY	sinibaldi
BYANGTAY	byungtae
KRYYK	creek
ANYL	anil
BAR	bar
ADRYS	idris
NYMTZ	nimtz
KANDV	kundu
MANV	manu
LYDYA	lydia
ANTVNYVS	antonius
TRVYYJH	truitje
AVRM	orem
TRAYNTZ	tryntje
ADAN	adan
GVDAT	gudat
YAGLA	yagla
VAYLDR	wilder
AKY	aki
NVRA	nuri
HADVBA	hudoba
NYVAN	neuen
ATRY	atri
KAMBYY	combee
KAVLYNG	cowling
KYRBY	kirby
GRAG	grog
MARVYN	marvin
ANGVLV	angulo
ANAYLYN	anilane
MYLV	milo
DANDAS	dundas
SYMPLYSYTY	simplicity
TAY	tye
PVRYNTVN	purinton
YANGY	yangi
SVZV	sozo
LYAM	liam
KNVB	knob
AYVRS	evers
KYM	kim
ABRYNY	ibrini
DVGAN	dugan
LVN	lon
LANGSTVN	langston
KAPRAL	kapral
RVYAL	royal
BATRA	batra
ASTYRNZ	stearns
AVRAM	avram
ASPVSYTV	esposito
MYTV	mitu
DATRY	datri
TARVB	tarub
DAG	dag
BVDVR	budur
AKSFRD	axford
HVDAYDAH	hudaydah
DVLMAN	dolman
JANVTJH	janotje
PYSTVN	pistun
TAMATYVS	tomatius
'BDAL'ZYR	abdulaziz
KAYLAS	kailas
MAKARAYG	macaraeg
LVN	lon
RYDKVYST	rydquist
LANGDVN	langdon
JVDAS	judas
VYVYK	vivek
ANRYK	enric
LAN	lan
SYTRAH	sitrah
BRAN	bron
MAYR	mayr
LVRTVN	lorton
HAPKRAFT	hopcraft
AYZDY	izadi
YVRMV	yermo
KADV	kado
NVLF	nolf
ADARA	edara
PALYDV	pulido
GLVRYA	gloria
DYKAVTY	decouty
TAD	tad
BLYNKV	blinco
RADHA	radha
SLYM	slim
MVRABYTV	morabito
SYNK	cinq
HYSAN	hisan
ADAN	adan
PANAS	panas
LYVNARD	leonard
GANATRA	ganatra
ASLATR	slater
ASKAYT	eskite
TVNAR	tonar
KALPYN	culpin
HASLVM	haslum
MVYR	muir
VYLYNGZ	willing
KVAST	kwast
AMARAL	amaral
RAFAL	rafal
NYKVLAS	nicolas
TAMAS	tamas
ARM	arm
JAYANT	jayant
JVDY	judy
RASV	raso
RVNDA	ronda
RASTRAM	rostrom
PAYTR	pitre
GAYDRY	guidry
HVLRVYD	holroyd
MVNAKV	monaco
DVBSVN	dobson
BASMA	basma
BAKAYA	bakaya
MVNK	monk
LVPATKYN	lupatkin
ANVJYT	anujit
AKYLAH	akilah
MVD	mod
YARVS	yaros
DYRKS	dirks
ASMAYT	smythe
AVLA	olah
KRAVFVRD	crawford
MAYRYK	myrick
AMYH	amie
PAYVLTJ	paultje
VYZNAND	wijnand
ASKALY	scally
HVDSVN	hodson
RAMA	rama
GATZ	gatz
ASTRYTY	steriti
AYNS	ines
BRAYN	brien
GADBVRY	gadbury
AYSLYK	icelic
YVRANYM	uranium
JASTJY	justje
ANSYH	anisa
AMYNA	amina
LAKY	lucy
LVMBARDV	lombardo
AVR	ore
KYN	kin
SAKS	saxe
BARTA	barta
ASTABRT	stobert
ARVYVLA	arviola
MYLVS	milos
MYRTY	mirti
GVDSVN	godson
SADYKVYH	saddique
FRAYDA	frieda
SVRAB	sorab
BARVA	barua
KRAYJ	craig
DVLAN	dolan
MVRAY	moray
VAST	vost
MVTYSV	mutiso
RAHY	rahi
AMBRVSYVS	ambrosius
MARKV	marco
PYNA	pina
AYNTLSAT	intelsat
DANDAS	dundas
BRYTA	brita
ANGLASMA	engelsma
KVANRADVS	coenradus
BARTVN	barton
FYNK	fink
PRABST	probst
AYVLYN	evelyn
BLAM	blum
AGALY	agali
BRYTA	brita
ALMYNTAKVA	almintaqah
VYLKAS	wilcox
MVKASA	mukasa
JAYARAM	jayaram
ANYJMA	enigma
VYMPJH	wimpje
TVSV	tuso
BVNYN	bonin
LVRY	lori
GRYGVR	gregor
ASMYD	smead
ZVRYSYKA	jurisica
AMNVN	amnon
SAND	sand
SYMVN	simon
JVANYTA	juanita
SYTJY	sytje
MS'VD	masud
PADVLA	padula
TRYSY	tracy
PRAM	pram
DRAP	drop
ANDRYAS	andreas
NAV	nau
BALTAYS	baltais
FAYRBANK	fairbank
PYRANY	pirani
ABDVN	ebdon
HAYM	hime
GRAD	grad
ASPYR	speer
PVLYYAM	pulliam
PVLK	polk
MVTVR	motor
VAYZ	wise
LVSYH	lucie
KVDY	cody
TALMY	talmy
DANA	dana
ABYAD	abiad
GYVZ	guse
ANANDA	ananda
KANYTZ	cunitz
MARGARYTA	margretha
KYMVRA	kimura
SYMYN	simin
DHAMAR	dhamar
KARLKVYST	karlquist
PVLYNG	poling
MYLGRAM	milgram
TVMATYVS	tomatius
BYLYNSKY	bilinsky
JABJH	jobje
BYAN	bian
GVRAPARTAP	gurupartap
JVNYN	jonin
MVRYSVN	morison
SYVN	sune
NYVARK	newark
GVYDV	guido
NARDV	nardo
LYVNZ	lions
KVRDAS	kordas
ANRYK	enric
LYMYNG	liming
DVBRYZ	dubris
SVNG	sung
ASKARS	scarce
BRATYNA	bratina
VAYMN	wyman
PATRYK	patric
DAV	dov
KVRAM	coram
BLVNSDVN	blunsdon
BRVYN	bruyn
TANG	tong
DYKSTRA	dikstra
GRVHVL	grohol
MVNTAGV	montagu
TVNY	tony
DRAM	drum
DAMYTRV	dumitru
ASTYPLZ	staples
VYVA	viva
HAPKARFT	hopcraft
BLVZVM	bloxom
DYPAK	dipak
BANKRVFT	bancroft
KARTYK	kartik
VALTVN	walton
AGVSTYNY	agostini
RVRY	rory
ANVPAM	anupam
AYZDY	izadi
ARNH	arne
KVJYAS	kogias
