ASPVLARYX	spolarich
LYTLY	lytle
JAKVMYNTAY	jacomyntie
HAMAH	hamah
TVLY	tuli
LVRA	lora
YAN	yan
ABY	ebe
PVRYNTVN	purinton
KANYTZ	cunitz
KVRKAM	corkum
MVRALT	muralt
MYAV	miao
KVARTZYTH	quartzite
LYA	lea
HVRKAN	horkan
BABYTZ	babitz
GABARA	gabara
HYNTVN	hinton
SASZH	sasze
LVRD	lord
BAGAY	bugay
ALYA	elia
LAND	lund
RAST	rust
GALYZYA	galizia
DRVDYNG	druding
HARBVR	harbor
TRYVLV	triolo
AYKAM	eckam
GVSTAVVS	gustavus
KVN	kon
ASTRND	strand
AVRBN	orban
BALBYR	balbir
KYNYVN	kinyon
TRYSY	tracy
LYDYA	lydia
AVNSTY	onesty
VYBVVV	wibowo
JVANA	juana
SAYDA	saida
ASTAKS	stocks
FABRH	fabre
AVSBVRN	osborne
DANZ	danz
ZARYH	zaria
KART	kurt
JYZAN	jizan
SAYRY	sayre
ARDYS	ardis
PYZYALY	piziali
MASNA	masna
BRYVNY	bryony
ALKSANDRVZ	alexandros
MASKYAS	mascias
JAN	jun
LAZARD	lazard
BABV	babu
HAFSAH	hafsah
GRANT	grant
AVT	ott
ATRAM	atram
ZYZY	zeke
SAMVYL	samuel
GVGVAN	goguen
NVKV	noko
GAV	gao
AYRP	earp
ASKVYVYL	esquivel
JASTAS	justus
PARHAM	parham
VYJBRAND	wijbrand
PAKS	paks
AMYLY	emily
BYVDVYN	bauduyn
FAYZ	faiz
VYDAD	widad
KLAG	klug
JAKVMYNTYH	jacomyntie
BRYSBYN	brisbin
ASTARKY	starkey
MVRA	mura
DANGYVN	dungeon
BRAYD	bryde
KYRBY	kirby
ASKRYBNR	scribner
HAYN	hain
KATRYN	katrin
LARJA	larga
ARVYVLA	arviola
TVNGA	tunga
BRAYS	brice
ASTARTLD	startled
TRYM	trim
TVLY	tuli
KADV	kado
DVMYNYKAS	dominicus
NARDY	nardi
AYVRY	ivery
AVMGA	omega
MARANY	marani
MAY	mai
MAV	mao
ASNL	snel
KAMSKAYA	kamskaya
KALYLA	kalila
MYR	mir
KATVPYS	katopis
HARMANVS	harmanus
MVRAN	moran
RYBAR	ribar
BRAHAM	braham
AGALY	agali
VAYZ	wise
MKRAYH	macrae
DAMYTRV	dumitru
DATSVN	dotson
TAY	tai
DVSTALYK	dostalik
VYLAS	vilas
LAYVRYTSN	lauritsen
BRYTA	brita
MVRA	mura
LYNDAN	lyndon
TAFT	toft
SANZ	sanz
ANDRYS	andris
SVZALYS	susalis
PYRARD	pirard
KVRY	kory
'QYLA	aqila
BRABANT	brabant
SVBVTKA	sobotka
ASTVN	stoun
DAYVVN	dauwen
DAYLVN	dillon
SYRKVYS	cirques
LAVYGNH	lavigne
HADSVN	hodson
LAYRD	laird
AZANA	ozuna
KAV	cao
GVYDV	guido
AYALA	ayala
RVHN	rohn
VLADV	vlado
AMPTH	ampte
TAMATYVS	tomatius
VAYZ	wise
ALKS	alex
MASARA	masaru
SARDV	sardo
FLYMYNG	fleming
TABVK	tabuk
ASPAT	spath
TAPLYN	taplin
LAY	lai
FYN	fin
AMYTAVA	amitava
DYVNYDA	dionida
DYRKS	dirks
SVLV	solo
ARPYN	arpin
AVMGA	omega
MVBAY	mawby
KAZDAN	kazdan
RASV	raso
SAGA	suga
LADVYG	ladwig
VAYD	wide
KRYSSAYNTYH	chrescyntie
BYR	bir
SYTYA	cetia
DVRAN	doron
AYDA	aida
MYNTAKAH	mintaqah
JVAY	juay
VYLAS	vilas
MYNKY	minqi
YAGLA	yagla
MVBAY	mawby
SANYL	sunil
ASTRYDM	strydom
FABRH	fabre
PAGLYA	paglia
GYPJH	gepje
KATLYR	cutler
GRYYNVALD	greenwald
LALYT	lalit
VYVKS	vieux
VYKRAM	vikram
JASTYN	gustin
SYNKLARY	sinclair
ADMVNDS	edmonds
TRVN	tron
ABYL	abel
AYDVAYSVZ	ludovicus
MANKA	manca
HAHTAHA	huhtala
MAYZ	mize
LAYHV	laiho
MAYSAL	missal
RABYV	rubio
FRASTY	frosti
KAVH	kave
LASKVS	laskos
KASTVRY	kasturi
RVMYG	romig
BALV	balu
RYVNSVN	runeson
MARK	mark
LYZ	liz
SAVYR	sauer
PYZYALY	piziali
BYRK	birk
NYNSTAR	ninstar
BARVA	barua
BASTYK	bostic
KVHAN	cohan
MAYNR	miner
SAFT	soft
MVKASA	mukasa
MVNTANV	montano
ASKV	osku
VLADV	vlado
VYLKYNZ	wilkins
AMBAR	embar
TAKY	taki
SYMVNH	simone
BALBYR	balbir
LYDYA	lydia
RASTY	rusty
HASBY	husby
RABYNSVN	robinson
DRAGANYS	draganis
SVRAB	sorab
PVLYYAM	pulliam
SVZY	suzy
VYN	vin
GVNZALV	gonzalo
LYBYD	lebed
ANAND	anand
AVLVSTAD	ulvestad
VYLKYNZ	wilkins
MKRAYH	macrae
LANGV	lungu
ARY	ari
SANZ	sanz
GAS	gus
RASV	raso
TVYDA	toida
KARLTVN	carlton
BRVHL	brohl
SYLA	sela
KARTYS	curtis
PRAYL	prael
FRANSYSKA	fransiska
MYLVARD	milward
LANGSTVN	langston
DANYYLS	daniels
TARVB	tarub
FLAT	flat
LYTV	leto
LYANG	liang
ASKATY	scotty
ASTYNTJH	steentje
AYVA	iowa
ALMVDYVAR	almudevar
SABHANY	subhani
ASTAR	starr
KALYSYAK	kalisiak
KRYST	crest
TAMBRVS	tombros
AVRAHAM	avraham
PARTVS	partos
GAYVN	gawne
TAGLV	tuglu
HYSLVP	hyslop
RAMA	rama
KAMPVS	campos
KALYAN	kalyan
PVPAT	popat
DVBYNYN	dubinin
ARNAT	arnot
ALKAN	elkan
LYA	lea
MYLVS	milos
SYMYN	simin
MYSA	mesa
FRANSYNTYH	francyntie
NYTYN	nitin
TVBYAS	tobias
JVRAH	jurah
GVRM	gorm
AVMGA	omega
KVNYNG	koning
ALVYN	alwyn
BARBVRAK	barborak
GRAYSLDYZ	griseldis
MALTYN	maltin
GVRKY	gorki
NYMRAD	nimrod
TYRZA	tirza
KVDAMAH	qudamah
ATYYA	atiya
SYNA	cena
MVRA	mura
AVZBRN	osburn
FVTYNVS	fotinos
JAN	jan
PAYPR	piper
FAYZA	faiza
SYMVNH	simone
NAN	nan
ABST	obst
VYTV	vito
KVSTYS	kostis
BRYAN	bryan
VANK	vonk
AVMAKY	ohmaki
HADVBA	hudoba
RAKYKVT	racicot
RYJSVYJK	rijswijk
LAGVMVRVF	lagomorph
NYYVTN	newton
GANG	gang
SYRYL	cyril
APRYL	april
ALVARV	alvaro
GRYT	grit
HARVHYSA	haruhisa
GVADA	gouda
KARLAYL	carlile
DAYS	dais
SAMZ	sams
LANG	lung
KATRYJN	catrijn
ALANA	alana
MVRYN	morin
FARAG	farag
AMYRA	amira
VYLKAS	wilcox
BRAY	brie
YVRMV	yermo
ASTNKAMB	stancomb
RYGAN	ragan
SYMVNH	simone
KAV	cau
RASKYN	raskin
ASTVVAL	stovall
VYK	vik
NYKVLA	nicola
BRADY	brady
AYNGLF	ingolf
KALYA	kalia
BVDA	buda
DADGYVN	dudgeon
KVSYRA	kucera
GANYSAN	ganesan
MANDAR	mondor
ASTAD	stude
MARVYN	marvin
KALHYNH	culhane
ANVS	enos
ALAPATY	alapati
SYMYNG	siming
SVRAB	sorab
BVRAD	borud
LYNKVLN	lincoln
HAVYS	howes
BLAL	blal
DAGAN	dugan
AHLAND	ohlund
BYAN	bian
MARKVYZA	marqueza
BAYLA	bayla
ARDYS	ardis
ADYH	adie
PVTYT	petit
AVHALVRAN	ohalloran
PVLYNG	poling
BLVZVM	bloxom
BANKRVFT	bancroft
PVLYYAM	pulliam
YARLA	iarla
RAYMVND	raymond
SASZY	sasze
FLYVRY	fleury
GNAGY	gnagy
BRATYNA	bratina
BVDAR	budur
ARBYD	irbid
KNVFYNKH	knufinke
MASATV	masato
PRVY	pruy
NAYMAH	naimah
MARY	mury
SYMYNG	siming
HARMANVS	harmanus
DVNALD	donald
AKMAN	akman
ASLNGZVALD	slangsvold
KVMVRV	kumoro
KARVSV	caruso
HARRYG	harrig
LAYNG	laing
KRYSJH	krisje
KVRNZ	corns
KAPLAN	kaplan
AGVSTYNY	agostini
KARLVS	carlos
BARTVN	barton
TVMATYVS	tomatius
LAVTVN	lawton
RAFALKV	rafalko
TRVN	tron
DVVAYKYNK	duickinck
VAH	wah
DVBYNSVN	dobinson
DRVNY	drune
KAGBVRN	cogburn
ALVYN	alwyn
PRAMVD	pramod
PYNYAN	pinyan
HVNG	hung
AKLVF	eklof
'AYMN	ayman
TVM	tom
DYAMANTARAS	diamantaras
DVBRYZ	dubris
BVLTAN	bolton
AYSPVRT	iceport
ASTRYTY	steriti
NYVMAN	neuman
ANYL	anil
DVA	dua
AYVSV	ayuso
DVRAN	doran
LAYKZ	likes
HYJDAN	higdon
HAJYR	hagir
ZAYRA	zaira
'BDVL	abdul
FARYHA	fariha
MVD	mod
RAYMVND	raymond
ASPARNDAM	spaarndam
BYRNH	byrne
MVNTVYA	montoya
JVAN	joan
JAKVBSVN	jacobson
SVDYPTV	sudipto
MYLYND	milind
DRAM	drum
ATVL	atul
PVALMA	puelma
VYLDYNG	wilding
ARTYZ	ortiz
MVNTALBANV	montalbano
AKYN	akin
YANVVYTZ	yanowitz
KAZDAN	kazdan
DAMYNY	dominy
DVBAY	dubay
DYLAN	dilan
PVPAT	popat
FRANSYSKA	fransiska
KVYNRYDVS	coenradus
PAPLY	popli
PRAMVD	pramod
NYMTZ	nimtz
ALAYN	alain
ASTVRLYR	storleer
PRAYVYT	private
PVHL	pohl
KVBV	kubo
DVRMA	dorma
MARKVM	marcum
AYLVR	aylor
HARRYG	harrig
MVRLAN	morlan
JARVALA	jarwala
HYLSVN	hilson
MANAMA	manama
BRYND	brind
MARYTJY	maritje
BRVZ	broz
BYZVAS	biswas
BVLDT	boldt
BVNGARD	bongard
KVSVGH	kosuge
KVDAMAH	qudamah
VYK	vik
NYLS	nils
BYLYNSKY	bilinsky
YVK	yok
SANVNDV	sunondo
HABVRA	habura
PARDY	pardi
VAYMN	wyman
ALTZ	oltz
HARYNKAR	harincar
ALDZ	olds
LYVNZ	lions
PYL	pil
AYNG	inge
GVNY	gony
AYBAC	ebach
LYVNARD	leonard
ANV	eno
LAYBZ	libes
SYNKLARY	sinclair
SAMVYL	samuel
FAVZY	fawzi
MYSRA	misra
AVFYNGTVN	uffington
ALYSYA	alicia
AYNTJH	eyntje
GAYDA	gayda
PRVY	pruy
JANG	jang
LAK	loc
GADY	gadi
ASPYR	speer
KALHYNH	culhane
JAKVBSVN	jacobson
RVSTAD	rostad
NAHAM	nahum
AVLSVN	olsson
VYLAS	vilas
AVL	owl
SAYM	syme
LADVVYKA	ludovica
AVGVSTYN	augustyn
HAVDVN	hawdon
LVPATKYN	lupatkin
FLAT	flat
DYMARYP	dimaryp
MVNTAGV	montagu
ABA	aba
BRYTA	brita
VYRT	wirt
BASYLYKA	basilica
SYTLAYV	cittlau
'LYMA	ulima
NAVAR	nawar
MAYTAG	maytag
MABAY	mawby
PRYSYNG	pricing
DAG	dag
PVGA	puga
KVYNT	quint
DVVAYKYNK	duickinck
HYN	hin
AL'YN	alain
FRANSYNTAY	francyntie
AYDY	eady
AMY	ami
JVANYTA	juanita
AVYRSA	aversa
DYKYNZ	dykins
DYN	din
KVLYHA	koliha
ARLYNDH	arlidge
RYHANH	rihana
RAST	rust
ASPRVT	sproat
KRASBY	crosby
MVRLAN	morlan
FVJYTA	fujita
GVRASPY	gorospe
JANSJH	jansje
YVNAL	uenal
KALYARV	caliaro
TYNG	tyng
LANDGRYN	lundgren
BRYNK	brink
LANSYNG	lancing
ADYSAK	adisak
AMBAR	embar
KATY	kati
LANG	long
FAYZA	faiza
HYN	hin
FVRTS	forts
RAGNVALD	ragnvald
ASTALKH	stolcke
DANKY	dunki
AYRP	earp
NVRA	nuri
KAVH	kave
ASPYRZ	spiers
BLANSDAN	blunsdon
JANG	jang
ASPVLARYX	spolarich
BASYLYVS	basilius
LAYVSAY	livesay
TRAFTVN	trafton
AVSTYN	austin
KVA	kwa
SYMVNDS	simonds
MVNTA	monta
TAGLV	tuglu
VLADV	vlado
HALVB	holub
ARM	arm
LAMBRVS	lambros
NARDV	nardo
DYAB	diab
AGYL	aqil
NYKV	nico
BARTHVLVMYVS	bartholomeus
TVLANY	tolani
KVARTZYTH	quartzite
AYVRSVN	iverson
AZAD	azad
ASLNGZVALD	slangsvold
LYZA	lisa
KVYN	quin
RVGALSKY	rogalsky
FYDVR	fedor
JAKVBY	jacoby
ALYSYA	alicia
BABA	baba
SVHAS	suhas
FANGVS	fungus
TVLYV	tulio
BRYGVY	bryguy
YVMN	yumn
BYLYNGASLAY	billingsley
AKYTVMV	akitomo
ASPYR	speer
BAKSKA	bocska
KALA	cala
KAZVHYRV	kazuhiro
AYVLYN	evelyn
AMAND	amand
BASTYK	bostic
ALVARV	alvaro
SASZY	sasze
MYLYND	milind
ASTRAP	strope
RYHANH	rihana
GAY	guy
ASTANGYR	stangier
TAYRAY	tierie
ALMKVYST	almqvist
KANTARA	cantara
BVD	bud
VYLKYNSVN	wilkinson
KAYRD	caird
SASZY	sasze
AYNZ	inez
KLAYN	klein
DYNY	dini
DAYS	dais
AVSN	osen
FRANSYNTAY	francyntie
KVANRADVS	coenradus
FAVZY	fawzi
SVA	swa
AMNVN	amnon
KATRYNTJH	katryntje
LAKY	lucy
BRAY	brie
SLYM	slim
TAHRYHA	tahirah
LAMBARDV	lombardo
RADVA	radwa
VALTVN	walton
KVAST	kwast
LAL	lal
KVSYRA	kucera
KAPLAN	kaplan
BAVA	bawa
BARGVS	bargus
AMAND	amand
AVKYNZ	oakins
SVL	sol
ANDRYS	andres
LATZ	lutz
VYJNAND	wijnand
AYN	ayn
TAMAY	tamai
BVNAR	bonar
SAMZ	sams
RVLDAN	roldan
KARYDA	karida
BLAZ	blaz
FYN	fin
AQBAL	ikbal
PARSVNZ	parsons
DAL	dal
DYNG	ding
KVAYMAN	coeyman
ABA	aba
AGRAVALA	agrawala
ADYNA	adina
DYMARS	demars
AYNS	ines
TVLANY	tolani
AVRHV	aurho
GVRTVN	gorton
RYZVY	rizvi
KRYVVNVZ	kriwonos
VAYA	vaya
ANDRYVZ	andrews
JVNYVR	junior
JASTYH	justje
FRANKVYZ	francoys
KVSVGH	kosuge
JYRARDYN	gerardin
LASKALA	lascala
AYALA	ayala
AYNTLSAT	intelsat
MYKVLYK	mikolic
LABYN	lubin
DALYNAR	dolinar
YVZR	user
BARTVN	barton
GRYLK	grilk
NVKS	knox
GVH	goh
TRYVYTZ	truitje
HVLKAMB	holcomb
AYZV	izzo
SYKARV	sekora
HAYNS	hines
MVNDFRANS	mondfrans
MARGVLYS	margolis
ADYT	adit
SAP	sup
BRVNYYV	bruneau
KAMHVLZ	kamholz
DATRY	datri
ASTFANV	stefano
MVBAY	mawby
SAMVYL	samuel
ANVN	anon
KVSTYS	kostis
BRADY	brady
BVSTAK	bostak
AVYAN	avian
LVFASV	lofaso
MARK	marc
SVHA	soha
LAYKZ	likes
RAYSTLYN	raistlin
RVBVZ	roboz
KANTH	conte
DAHAK	dahuk
KALPANA	kalpana
ASLVP	slope
JAKVMYNTAY	jacomyntie
SVHA	suha
KYMVN	kimon
KVLYHA	koliha
VARGV	vargo
GANG	gang
TVRYN	turin
LAYVVY	lieuwe
MARGARYTA	margretha
FAYZA	faiza
KARMVDY	carmody
AYRLAYNZ	airlines
ALVF	elof
KARTYK	kartik
KASAT	kasat
VYN	vin
AYSLT	iselt
DVBRYZ	dubris
ARGAN	organ
LYLA	lila
GATLYN	gatlin
GALV	galo
DANA	dana
BLVZVM	bloxom
ADMYSTVN	edmiston
BAB	bob
KVDAMAH	qudamah
HANT	hunt
NYK	nic
LVRA	lora
FALK	falk
ALYAS	alias
TALMY	talmy
GRYT	grit
NAGASAKY	nagasaki
LAMYKYN	lamykin
ARFYVS	orfeus
BVZVVA	bozuwa
LAP	lap
GABA	gaba
VALTVN	walton
AVYVA	aviva
RAMYRV	ramiro
YANVVYTZ	yanowitz
GVGVAN	goguen
TATARY	tatari
SYMVNH	simone
FARAGV	farago
JYNTVN	ginton
FALSAM	folsom
SYRVYZ	sirois
FYDVR	fedor
KAMHVLZ	kamholz
LAYND	linde
ASPYRZ	spears
AVYVA	aviva
SYKY	siqi
ADYK	adik
MKMAHVN	mcmahon
JYMZ	gems
RAVYNDRAN	ravindran
ALBAHAH	albahah
FARYHA	fariha
ALAPATY	alapati
ASTRAP	strope
NAYA	nina
FAYRVZ	fairuz
SYRVYZ	sirois
KRAB	krab
LASKALA	lascala
PATRVKLVS	patroclus
GYVYN	gavin
BABAR	babar
PVRANYK	puranik
SVHAS	suhas
ARVYNG	irving
KALTVN	colton
ADMVNDS	edmonds
DAMYNYKAS	dominicus
BAYARD	bayard
HALAN	hulan
RYDKVYST	rydquist
MAMA	mama
HVRKAN	horkan
LAMBARDV	lombardo
AMBAR	embar
ANDRYS	andres
FRAYDMAN	friedman
NABYL	nabil
VYNATA	vinata
VYNSVN	vinson
ASTAKR	stoker
LANDYS	landis
LASK	lusk
BASYLYVS	basilius
SASKA	suska
AMYTAVA	amitava
SVLTAN	sultan
ZARA	zara
ARYKA	erika
VYDAD	widad
ALKSANDRVZ	alexandros
BVSTRAM	bostrom
ANDR	andr
GADBVRY	gadbury
AMNVN	amnon
VLADV	vlado
YVRK	york
DAVNYNG	downing
DAY	day
HASYK	husik
ABVDHABY	abudhabi
BRYGVY	bryguy
HRABY	hrabi
KASTY	casti
SVANK	swank
AYVTYK	ivetic
RAGATZ	ragatz
ASTYVNSVN	stevenson
ATRAM	atram
TYSZA	tisza
KADYN	kadin
LAYN	lynn
JVZY	josi
KRASYK	krasic
BRANDY	brandi
FRANSYSKVS	frnaciscus
MABANAG	mabanag
LABKYN	lubkin
KYNYVN	kinyon
MVRAS	moras
KVJYAS	kogias
BARVNYA	baronia
ABRAHYM	ibrahim
MARVYT	marvit
KAMPAGNA	campagna
ALMVDYVAR	almudevar
ADVARD	edvard
ALF	elf
KVN	kon
BYR	bir
AYSTYN	istian
SAMANTA	sumanth
RAST	rust
KASYNSKY	kosinski
AVYS	avis
RYMVN	rymon
SALYAN	salian
VYMAL	vimal
KAYA	kaya
LALKYN	lulkin
VARGV	vargo
LATALA	latala
MADYS	madis
SVHAS	suhas
FYGVRA	figura
ANAND	anand
MANVLY	manoli
DYSAY	desai
GADFRVYD	godfroid
TRYVYTZ	truitje
FYLYAS	filias
RADAK	radek
ASTAKS	stocks
TAKY	taki
FRNASYSKAS	frnaciscus
ANZALVNY	anzalone
GAV	gao
MAY	mai
RVSYALA	rotiala
LAMBVRN	lamborn
DVRYS	doris
TYHAN	tehan
NVVYK	novik
RAYSTLYN	raistlin
SAMANTA	sumanth
AVRN	orne
KRVPYK	kropik
LYDVR	lidor
AFTAB	aftab
LYNK	link
ANDAMZ	adnams
TRYVLV	triolo
MVBAY	mawby
DAVT	dout
PRADV	prado
ASTRYTY	steriti
YANG	yang
DABVYS	dubois
SAKARY	sakari
HALPYN	halpin
LADVYG	ladwig
TYTAY	tytie
PVRTNVY	portnoy
ALVARV	alvaro
ANATVLY	anatoly
FADYLA	fadila
'AYMN	ayman
BYLHAR	bilhar
MVNAZ	munoz
GALYLA	galila
PYATJY	pietje
HAPKYNZ	hopkins
PARMAR	parmar
JAHMANH	jahmane
KADYN	kadin
FVRDHAM	fordham
ARYKA	erica
GVANYAV	guanyao
AVRV	orue
LYVYVY	levavy
MARK	marc
DVRA	dora
SAYKV	psyko
AVCZ	ochs
ANGLASMA	engelsma
ASLVN	sloan
FRAYTGRSA	fritgersa
GAYDRY	guidry
HANSVN	hanson
MVRTAN	morton
KAKYVR	kakure
DRYV	drew
RVHAN	rohan
AYRAY	airay
HARRYG	harrig
LVFSTRVM	lofstrom
VAVDRY	vawdry
RVNALD	ronald
MANAMA	manama
RYZVY	rizvi
TRANYTSA	turnitsa
YAKVB	yacob
NARV	naro
ASTANGYR	stangier
TVBVTYS	tubutis
ANTRVSYV	antrosio
DAVNYNG	downing
AKY	aki
PANT	pant
MAMA	mama
ASPVLARYX	spolarich
BVSTAK	bostak
KATRYN	katrin
JVAV	joao
MYLVT	milut
