DABYNSKY	dubinsky
DVRVYN	dorwin
ANAZ	anas
BYSAYV	bissau
DANYS	danis
SVLV	solo
VYMPYJ	wimpje
DVRFMAN	dorfman
ASTRY	stray
TAMPKYNZ	tompkins
PALVMBV	palumbo
TVRMALA	tormala
BRAVN	brown
SANG	sung
SARVATH	sarwate
ASTRAP	strope
PARSVNZ	parsons
BRYVN	bryon
SANRAYZ	sunrise
DANA	dana
ALKYNGTVN	elkington
ADYH	adie
BABV	babu
BYANGTAY	byungtae
SVDYPTV	sudipto
DANG	dung
TANYS	tanis
TAMPKYNZ	tompkins
VYNSTRVM	winstrom
FATYS	fotis
RAMVS	ramos
ASPARZA	esparza
JYMZ	gems
PAGLYA	paglia
ALMYNTAGAH	almintaqah
RYMVN	rymon
SAVYR	sauer
MARTY	marty
DVHA	duha
MANY	mani
HALVB	holub
KRVSBY	crosby
LYVNARD	leonard
BRAVN	brawn
ANYSH	anisa
SVNY	sony
KAV	kao
VVN	wun
LVAYNJ	luinge
RABY'H	rabiah
HASLVM	haslum
ALSVP	alsop
BRABANT	brabant
GRABNAR	grabnar
R'NA	rana
MARKVS	marcus
ALVARVS	alvarus
ABA	aba
AYSMN	isman
BARVN	baron
BLAM	blum
PVLVVYN	polowin
MARTYN	martyn
BASTARD	bastard
LAMBDA	lambda
MARYA	maria
JAKVMYNTYH	jacomyntie
MVRNYNG	morning
JVDY	judy
MYKAYL	mikael
LAND	lund
MAYT	myth
ARSKAYN	erskine
ALTANYN	eltanin
PAYVLTJ	paultje
SYVN	sune
LARA	lara
HARALD	harald
MANDAR	mondor
MARY	mary
KVZV	kozo
TAPTANY	toptani
DART	dart
TYV	tio
RASTRAM	rostrom
YASYN	yasin
GRAD	grad
DAK	duc
KVSVGH	kosuge
SVRAB	sorab
HALVB	holub
RANA	rana
ASPARNDAM	spaarndam
HVRYV	horio
LYDAL	lidal
AYDMN	eidam
AVHALVRAN	ohalloran
ASPVTYS	seputis
BRAVN	brown
AYSAN	eason
DYAMVND	diamond
PADVA	padua
SVL	sol
BRAVV	bravo
SASAKY	cacace
ANDAMZ	adnams
AYVTYK	ivetic
TAFT	toft
RAY	rai
AVFYNGTVN	uffington
LAZARA	lazara
KLYFTVN	clifton
HAYD	hyde
ALVYN	alvin
LADASKY	ladasky
AMVRY	amory
GAVYN	gavin
TYNA	tina
RYGV	rigo
GASTYN	gostin
SAMVN	sumon
JASTYN	justin
AVRCARD	orchard
BRYSBYN	brisbin
AVRYVLY	aureole
AYDS	eads
DAV	dow
RVNALD	ronald
BRAVN	brawn
JALA	jala
'ADL	adel
DANAVAN	donovan
LANDRVM	landrum
PYRAMYD	pyramid
HYNSVN	hinson
MANGAN	mangan
PAKALA	pakala
LYZARD	lizard
NAYLZ	niles
MYLGRAM	milgram
AVYVA	aviva
KAV	kao
MASKARY	mascari
DYKYNZ	dykins
HAV	hau
BRYND	brind
NYNVYS	ninoys
MVRANDV	morando
BVZKART	bozkurt
SABHANY	subhani
DVRMA	dorma
BYATLYNG	beutling
ASTV	stew
MANTVR	mantor
SAGARS	sugars
RYDKVYST	rydquist
DVY	doi
PRAYL	prael
PARSVNZ	parsons
ABDVN	ebdon
ANBV	anbu
KAKY	kaki
KLAG	klug
MARGVLYVKS	margulieux
ADVARD	edvard
ALFVRD	elford
BVSTVN	boston
KANYVN	canyon
TANAK	tanak
RYBAR	ribar
ALFVRD	alford
TVSV	tuso
LYNDVN	lyndon
PVRKV	porco
AVYRSA	aversa
ANVJYT	anujit
VYVYK	vivek
PYSTVN	pistun
LYMYNG	liming
ALAPATY	alapati
BLANSDAN	blunsdon
RYV	ryu
TAMBRVS	tombros
KALYSYAK	kalisiak
ASKALY	scally
DYVYA	divya
JAHMANH	jahmane
DRVNY	drune
AYSTYN	istian
BALYT	balit
ANYJMA	enigma
ANVN	anon
YAGLA	yagla
VYJBRAND	wijbrand
ASMA	asma
FLYVRY	fleury
GADY	gadi
ANAGRAM	anagram
PRYVR	pryor
PRAMVD	pramod
DABAS	dubuc
TRYM	trim
PANDYAN	pandian
VLADV	vlado
SYANG	siang
LYVYV	liviu
HARVHYSA	haruhisa
JYNAKYRAMAN	janakiraman
ASKP	skep
VAYGL	wigle
AVKSVL	oxwell
AFZAL	afzal
AVSBVRN	osborne
MAV	mao
HVRKAN	horkan
FYLYAS	filias
SAYM	syme
FALKV	falco
KAMBZ	combs
MASNA	masna
HARYV	horio
ASFAR	sphar
SVRAJ	suraj
GVPALA	gopala
RVLFH	rolfe
MARTYJN	martijn
KAYK	kauk
DVRFMAN	dorfman
ANDRYAS	andreas
SYMVNDS	simonds
DAVKYNZ	dawkins
AYN	ain
ALYSYA	alicia
ASLVN	olson
JARBVT	jarbot
MS'VD	masud
AVDRA	audra
VAYNTH	wyntje
ASMYTSVN	smithson
ADARA	edara
PARDY	pardi
ANDRYS	andris
KLAGSTVN	clugston
NAGY	nagy
PRASANA	prasana
LYVYVS	livius
KAMBS	combs
AYNGYJD	engaged
TATSVRV	tatsuro
DVHA	duha
ASLYMAN	slimane
LAV	lau
RVBYNSVN	robinson
DAYR	dyer
DYNT	dint
JAVYKA	jovica
FVRJY	forgy
AYT	ait
SYPRYANV	sipriano
ASKLVYR	sklower
MYNTZ	mintz
VYNSN	wincn
ASK	ask
MYKAYL	mikael
GLASYYR	glacier
MADVN	madon
VARYANTZ	variants
GVH	goh
FLARDYNGA	flardinga
DADA	dada
RABYDYAKS	robideaux
AYNANA	inanna
BRAN	bran
TVRMALA	tormala
KAY	kai
ALKAN	elkan
FRNASYSKAS	frnaciscus
MVLYNARY	molinari
SABRAMANYAN	subramanian
TAKV	taco
GASTAVVS	gustavus
AVR	ore
MAYTAG	maytag
ASTYN	stian
BVNVMV	bonomo
HYVKYNZ	hawkins
HARARY	harari
PRYSTVN	preston
DAL	dal
BVDAR	budur
HARVHYSA	haruhisa
TVVYS	twiss
HARBVD	harbud
MVTVRZ	motors
TVFTH	tufte
ASTARKY	starkey
BYZVAS	biswas
FANGVS	fungus
TAD	tad
DYMYTRYVS	dimitrios
SARNA	sarna
PANAS	panas
PARKYN	parkin
ASTYL	steel
LYN	lin
GVRAL	gural
ASTYNBRG	stenberg
PANJABY	punjabi
VYVLA	viola
MARTYZN	martijn
ASTDYNA	stedina
ASTRYDR	strider
DAK	duk
GAYDA	gayda
ASMA	asma
TAMPKYNZ	tompkins
MYNTAKAH	mintaqah
BARTHVLVMYVS	bartholomeus
PALYDV	pulido
'BDAL'ZYR	abdulaziz
GALYLH	galila
RAM	ram
ANSKAMB	anscomb
HAYRVNYMVS	hieronimus
GADBVRY	gadbury
GASKYN	gaskin
LYZA	lisa
BVLTAN	bolton
MARYV	mario
ASTAKS	stocks
BVLTAN	bolton
ASLYNY	slaney
LYNDRVTS	lindroth
KAMPVS	campos
KYKVMA	kikuma
ALAYS	elyse
JAVYD	javed
ABY	ebe
TRYVLV	triolo
ANAS	anas
FAVZY	fawzi
MAYSAL	missal
GASKVYYN	gascoyne
SAMBVLYK	sambolec
FVRSAYT	forsyth
LAYND	linde
RYYNKS	rienks
ANTANAYTYS	antanaitis
DART	dart
ASPVLARYC	spolarich
MARTY	marty
MVRYSVN	morison
KRYS	kris
KASAMA	kasama
DAY	day
DYNA	dina
LAZARA	lazara
KLAGSTVN	clugston
GVYL	goel
TAPLYN	taplin
NYNJA	ninja
QVASYM	quasim
JVDY	judi
ANANT	anant
KVRVYN	corwin
GASYK	gasic
ANAZ	anas
GRAV	grau
MVRTAN	morton
DAV	dow
LVNZ	lunz
DANGTAY	dongtai
YVZR	user
NADVLNY	nadolny
MYTVN	maton
GAVYNDAN	govindan
VASLV	waslo
HARALD	harald
ANJY	engi
ASTYVZ	steves
JHANG	jhang
KARABVLVT	karabulut
ASPANGLR	spangler
BARBVRAK	barborak
JALA	jala
KVYL	quel
KVSVGH	kosuge
BASYLYKA	basilica
KRVG	krug
DVHA	duha
RAYDAH	raidah
ZVRYNK	zurink
ALVA	alva
FARAT	furat
LYNK	link
'RBYL	arbil
DVSTALYK	dostalik
SAGA	suga
SYTLAYV	cittlau
FADVR	fodor
PVRYNTVN	purinton
BRAYR	brier
ATKYNZ	etkins
BRANSDVN	brunsdon
SYMVNDS	simonds
MKKARTY	mccarty
SVNA	suna
LADVVYKA	ludovica
KAVYTA	kavita
NYLS	nils
DNVKS	denux
AGYL	aqil
ADVARD	edward
HVGAN	hogan
ALVK	alok
PAYNY	payne
ARYKA	erica
KVRAM	coram
PAYNY	payne
SAYKV	psyko
BRAYNKLR	brinkler
ARBY	orbi
KATY	kati
MVRAY	moray
KASAMA	kasama
KVARTZYTH	quartzite
MARGARYTA	margretha
PVGVSYAN	pogosyan
JABJH	jobje
ALKYNGTVN	elkington
RAMVLVS	romulus
LAMPY	lampi
AMANV	amano
JVDY	judy
SANDHV	sandhu
GRANVYN	granvin
DVNATV	donato
'ALY	aali
AVLD	auld
VYRJYNYA	virginia
HARTAH	hurtah
SVHAS	suhas
RAVY	ravi
AYGV	igoe
GAYNVR	gaynor
KNVFYNKH	knufinke
MYLARA	melara
BYKVN	bacon
ADARA	edara
DYANA	diana
FYDVR	fedor
LYNDAL	lindal
ANTARAMYAN	antaramian
BAVDVYYN	baudouin
ASTAG	stagg
FRANSYNTYH	francyntie
LAND	lund
ANYART	enyart
YASAR	yasar
GYLPYN	gilpin
KARNYA	carina
DYB	dib
SVLAR	solar
HAFSAH	hafsah
MASAHYRV	masahiro
VYLDKAT	wildcat
GYBSVN	gibson
ALF	elf
HYSLAP	hyslop
ASTNSRAD	stensrud
ASTAKY	stucki
RAYSL	risel
KALTVN	colton
KYVNG	cuong
PASYFYK	pacific
ANRYKV	enrico
MVNKAR	moncur
VYVYANH	viviane
TAYJMN	tijmen
LANSYNG	lancing
MAKAYVLY	macauley
AYNVN	eynon
LVSY	lucy
BARVNYA	baronia
YVNAL	uenal
HADRAMAVT	hadramawt
SVLYS	solis
PRYVR	pryor
TATARY	tatari
HARTAH	hurtah
ASPARNDAM	spaarndam
TAPTANY	toptani
SYMYNGTVN	symington
GVYN	gwin
NAZARYV	nazario
MASATAKA	masataka
MVHAN	mohan
LYDAL	lidal
DANGYVN	dungeon
GANG	gang
SVRAB	sorab
HAYD	hyde
KVHAN	cohan
RAV	rau
DVHA	duha
RADV	radu
LYNDGARD	lindgard
RAZDAN	razdan
DAVNYNG	dawning
FVLKANYS	fulconis
KVLYN	colin
AVYAN	avian
AKDAG	akdag
HANTYNGTVN	huntington
ASLVMN	sloman
FALTVN	fulton
AFA	afa
DYNA	dina
GALY	gali
VYNZ	winz
MVRANV	morano
NVLF	nolf
NYPTVN	napton
DANKY	dunki
MATSVDA	matsuda
ANDAMZ	adnams
HYVKYNZ	hawkins
SYTYA	cetia
R'NA	rana
MVRNYNG	morning
ADMYRALZ	admirals
TVBYAS	tobias
LYVYV	liviu
LVDVVYKAS	ludovicus
ALYVT	eliot
AVMGA	omega
ABST	obst
LYSKANV	liscano
VYKLVND	wiklund
LAVRAY	lawrie
RASV	raso
VYDYV	video
ASTRYD	astrid
AYDVAYSVZ	ludovicus
ANAND	anand
ASKVLYN	scullin
BAKAYA	bakaya
HAYNZ	hynes
KVHAN	cohan
BAJVA	bajwa
KLAZVRA	klazura
SANJAY	sanjay
VYGTVN	wigton
AYVGNH	eugene
FVTYNVS	fotinos
KRYSSAYNTYH	chrescyntie
ANTVNYS	antonis
TVDAR	tudor
ABRAMSVN	abramson
KRANSVYYK	cranswick
BLASYVS	blasius
NYVKVYST	newquist
HALAN	hulan
TVNG	tung
AVKYNZ	oakins
VYNSN	wincn
LKS	lax
ARYN	erin
KAVASYN	cavasin
AVYS	avis
KVNV	kono
BRYNK	brink
ALVARVS	alvarus
KNVB	knob
'LYMA	alima
ANVS	enos
ARYKA	erika
SATVR	satur
ABHAY	abhay
GASPAR	gaspar
ASLAN	sloan
LVND	lund
JVAV	joao
BAVA	bawa
KVDVGNV	codogno
DVNATV	donato
ALZ	elz
'LYA	alya
BLAHA	blaha
JAKVMYNTAY	jacomyntie
LANKART	lonkart
HAYN	hain
TAMZ	toms
TYYVLN	thulen
HAVYS	howes
GANSVN	gunson
BAKSKA	bocska
TAMAS	tamas
BYVAN	bevan
ABY	ebe
BVNVMV	bonomo
SAVYR	sauer
PALFVRD	pulford
SASTYK	sustik
LYN	lin
DRAYNH	draine
HALAN	hulan
'RRYFA	arrifa
DABYNSVN	dobinson
ASTARBAK	starbuck
MATLV	mutlu
TAYMN	tymen
BADYG	budig
RAYMVND	raymond
TRA	tra
JVN	jun
GARMZ	garms
FRANKLYN	franklin
KYMVRA	kimura
PVRVS	proos
SANTVS	santos
VARMA	varma
LANDYS	landis
LANDRY	landry
KASANVVA	casanova
ASTAMPR	stamper
APLYN	aplin
LYZARDZ	lizards
DVYNYNG	duening
KVTLA	kotla
TAMAY	tamai
TVLY	tuli
KASTANV	castano
CAYLDZ	childs
SYANV	siano
SAN	son
BVZVVA	bozuwa
PANYKV	panico
TAYSN	tyson
LVS	los
LYNK	link
FAGANS	fagans
LYVNVRA	leonora
SLYM	slim
ASTRVK	strock
ALF	elf
HARKYN	harkin
AYZAK	isacq
ASTVART	stewart
TRYVYTZ	truitje
HAKSL	haxel
PABLV	pablo
KRYSTYNA	kristina
SYNDRH	sindre
ANJY	engi
ASKLVYR	sklower
KAYK	kauk
KRVB	krob
NARDV	nardo
AYNGLD	ingold
DRAP	drop
ASPAT	spath
MANVLY	manoli
JYN	jin
MVNDFRANS	mondfrans
PRANAV	pranav
BARBAS	barbas
S'YDH	saida
JARBVT	jarbot
ASPARZA	esparza
ASTAKS	stocks
PYNV	pino
HADSVN	hudson
TANAK	tanak
DAYVVN	dauwen
FAYF	fife
FRANSYSKVS	frnaciscus
PRAKTYKVM	praktikum
MALTYN	maltin
MVNKZ	monks
ALFANSV	alfonso
KATRYJN	catrijn
PVGVSYAN	pogosyan
KRAVFVRD	crawford
PRAYB	pribe
AMYR	amir
MVRTAN	morton
ANDRYS	andres
ANVAR	anwar
NAV	nau
KANAKAKVRN	kanakakorn
AMYHAY	amihai
YAGLA	yagla
HALM	halm
DVDA	duda
ADYH	adie
GAYNVR	gaynor
JVSYP	josip
NYTYN	nitin
ARLYNG	arling
MYRVT	mirut
LAN	lon
PVRKV	porco
VAYA	vaya
AMBRVSYVS	ambrosius
YVNAL	uenal
DRVR	dror
PRAYM	prime
GYZAV	gizaw
MADYV	madeo
LYSKANV	liscano
ZAGAR	zagar
TRYM	trim
LYNDVN	lyndon
VYBVVV	wibowo
AMYLY	emily
JAYAN	jayan
SYLK	silk
VYLHAYT	wilhite
KVSYRA	kucera
BVD	bud
KRAYG	craig
MYLKS	milks
GAYDA	gayda
KALPYN	culpin
ARASMVS	erasmus
HAVYS	howes
KAMBYY	combee
SYANG	siang
SAYTJ	sytje
DRVDYS	drudis
HAPKARFT	hopcraft
GARYTV	garito
JASTYN	justin
MANY	mani
AMVRY	amory
FRAYDA	frieda
KLAVDYA	claudia
LAST	last
HAPSVN	hopson
MAHAJAN	mahajan
TVSYNG	tusing
PRANAV	pranav
BASTYK	bostic
JYVRDANV	giordano
NAS	nas
BYNVD	binod
TVBYAS	tobias
MYTV	mito
DYVNYDA	dionida
JYSVZ	jesus
HAVVLA	havola
BRYTV	brito
DVRMA	dorma
'LYA	alia
AYLYNG	ayling
TAPTANY	toptani
HLAVYN	hlavin
SAGA	suga
PALSKY	polsky
SYRAFYN	serafin
MYNTAKVA	mintaqah
VYMPJH	wimpje
DVNATY	donati
LAVTVN	lawton
ANBV	anbu
TAMPKYNZ	tompkins
HARYNKAR	harincar
SAMBVLYK	sambolec
ALFVRD	alford
ASTYNSN	stinson
MKDVNALD	mcdonald
KAKY	kaki
AVTV	otto
DART	dart
ALKSY	alexy
LYSTVN	liston
ASKVRR	scorer
MVBAY	mawby
ASMYTZ	smiths
TARYK	tariq
AMPTH	ampte
PAYVLTJ	paultje
KAYA	kaya
FARAG	farag
JYAN	jian
BYKSLR	bixler
VAYD	wide
PABLV	pablo
LAMPY	lampi
GASYK	gasic
DAY	die
AVLA	olah
KYBV	kibo
BVDVR	budur
KASTRV	castro
NYMRAD	nimrod
TALYBAH	talibah
JVDY	judy
HANKZ	hanks
ASKAYT	eskite
DANG	dong
JHANG	jhang
KAMAR	kumar
GRYT	grit
SYLVYA	sylvia
ABYAB	abiab
LYNDAN	lyndon
AVRV	orue
GRYKV	greco
BALSAM	balsam
FRAYDA	frieda
TALBVYZ	talboys
KYNSVN	kinson
GRANDASTRVM	grundstroem
RABYJN	robijn
AFA	afa
ALVAN	alwan
MARTYNV	martino
MAHAVLT	mahault
SVPRATYK	supratic
BAKSKA	bocska
'BDAL'ZYZ	abdulaziz
MAY	mai
RVSYALA	rotiala
ASPVLARYC	spolarich
HASYK	husik
MVTVR	motor
SAMYT	sumit
ATV	oto
MANV	muno
BLVNSDVM	blunsdon
LARVKVYH	larocque
RADVF	radov
VASLV	waslo
AVRKNY	orkney
BVDAPATY	bodapati
FYDVR	fedor
MAKARAYG	macaraeg
KLAGSTVN	clugston
ABHAY	abhay
BYLHAR	bilhar
MYSRA	misra
MANAMA	manama
BAKAR	bacar
ARLYNDH	arlidge
DAVD	daud
VYJDAN	wijdan
AMY	amy
MADYSVN	madison
AMAND	amand
SYLVAN	sylvan
MYNARD	menard
KYNSVN	kinson
MVRYTA	morita
LAFGRYN	lofgren
RAJ	raj
ASPYN	spine
MAYR	myer
HAVDVN	hawdon
ASTVN	stoun
MAMA	mama
FRANGAKYS	frangakis
PYPVNY	piponi
DRVR	dror
NAVYA	navia
KYNGSFVRD	kingsford
AVLYVYR	olivier
ALMYNTAGAH	almintaqah
HADVBA	hudoba
JYVRDANV	giordano
NARDV	nardo
BALBYR	balbir
AKMAN	akman
ANDRYVZ	andrews
SRAYNH	shryne
SVRVALY	sorvali
ASPANGLR	spangler
PASKV	pasco
AFZAL	afzal
MADVRAY	madurai
ASKYPY	skippy
AVRKNY	orkney
HAVK	hawk
MANRV	munro
HARDYN	hardin
ASPATSVVD	spotswood
NYVMAN	newman
AYNS	ines
MVKASA	mukasa
BRYND	brind
LYTV	leto
GLASYYR	glacier
ASTRYDM	strydom
GARDYNR	gardner
AMANV	amano
AYNDAYRSN	indiresan
ASTK	stec
TAHRYHA	tahirah
BRAVV	bravo
VAYMN	wyman
TRAYNTZ	tryntje
DVMBA	domba
MATAR	matar
ASLYV	slave
DYK	dik
YVZR	user
KVBSA	kobsa
GVRAV	gorav
FRAMSAN	fromson
MVZYNA	mozina
RAN	ron
KATVALA	katwala
AVGVSTYN	augustyn
ALFVRD	alford
MANV	manu
HVRST	horst
BANKS	banks
MVNTVYA	montoya
DVA	dua
ANAND	anand
HARALD	harald
AVLY	olli
KATALANV	catalano
SAHASY	sahasi
HAMYLTVN	hamilton
TANG	tong
SYMVNA	simona
HAV	haw
MVTVR	motor
KALB	kalb
BVDV	bodo
VYND	wind
PATRYK	patric
ANSKAMB	anscomb
SVPRATYK	supratic
BRABANT	brabant
DVNHAM	dunham
MVRA	mura
SVR	sor
AMVRY	amory
BARKSDYLY	barksdale
MVNS	muns
ANAYLYN	anilane
ARAN	eran
VYSPY	vispi
BAD	bud
FRYNK	frink
HARBVD	harbud
LVM	lum
LVJYK	logic
ZHRA	zara
MARK	mark
AYMRY	emery
ALFARV	alfaro
ASNYL	snail
ASKP	skep
LYAV	liao
MARTYZN	martijn
TRYSY	tracy
JASTAS	justus
SYMVNH	simone
DAS	das
LYKYVRY	liquori
PYNZ	pins
ASTYP	steep
MARSY	marcy
SYRVYZ	sirois
KLAVDYA	claudia
DAHVK	dahuk
KAV	kao
SAMYT	sumit
TVRDA	torda
FLYNT	flint
ABRYNY	ibrini
AYNGL	ingle
MARYA	maria
BRVYLV	broilo
ASTYL	steel
DVHH	duha
DJAMYLA	djamila
PVMA	puma
RYTYSGRT	ritsgert
RAGNAR	ragnar
ANJYLYNY	angelini
GARBH	garbe
MVLYNARY	molinari
DVRMA	dorma
LAN	lan
HAFS	hafs
AVLSVN	olsson
FRANKVYS	francoys
KAPRAL	kapral
NVLAN	nolan
LANKTVN	lankton
SVLD	sold
LVSY	lucy
VYVYANH	viviane
ASKVLY	ascoly
FLVYD	floyd
