DADGYVN	dudgeon
JVANA	juana
KAYA	kaya
MYRMAK	mirmak
SYMVNZ	simons
ADVNYS	adonis
ASKRYBNR	scribner
BALTAYS	baltais
GASKYN	gaskin
AMYHAY	amihai
NYGRA	nigra
GVH	goh
DYVYD	david
AVRLYNZ	orleans
SAKS	saxe
DYYALA	diyala
RYV	ryu
GRAH	grah
SYRYL	cyril
BRAHAM	braham
KRYST	crest
YASAR	yasar
LVRY	lori
FAYNK	finke
KVYST	quist
SYKY	siqi
ANTANAYTYS	antanaitis
BLVNSDVN	blunsdon
GASKYN	gaskin
KVKAL	kokal
PASKV	pasko
PVH	poh
LVAYNJ	luinge
ABRYNY	ibrini
VYLA	vila
ATKYNSVN	atkinson
AYSAN	eason
BRAYSLAV	berislav
VYDAD	widad
PAYK	pike
DVMYNYKAS	dominicus
LALYT	lalit
MAMFVRD	mumford
JYGANG	jigang
FAGANS	fagans
HARYNKAR	harincar
BYR	bir
TVNG	tung
MAYRYK	myrick
KALBYDA	kulbida
MVD	mod
MVRTAN	morton
AYSKANDR	iskander
AVTV	otto
KVL	col
SYTV	seto
KATRYNA	katrina
VYNKV	vinko
RAYLH	rayle
YVFYNGTVN	uffington
DYMA	dima
RYZVY	rizvi
KALYAN	kalyan
ALMKVYST	almqvist
GVRYK	gorik
SVAMY	swami
GARMZ	garms
VAYBY	wiebe
BARKSDYLY	barksdale
NAYA	nina
VYNTVN	winton
KVVAR	kovar
AYZDY	izadi
JVDY	judi
BDYRA	bdira
ALY	ely
KVMVRV	kumoro
NAVYA	navia
PVLV	polo
KLVTH	klute
BRYANT	bryant
BANTVN	banton
HAPKARFT	hopcraft
KAPANGA	kapanga
TRAYNTH	tryntje
ASTARTLD	startled
GVAN	guan
S'YDH	saida
KRANSVYYK	cranswick
PALSKY	polsky
KANYTZ	cunitz
SASKA	suska
LAYMAK	limace
ANAY	anay
PYRARD	pirard
ASTYL	steel
FVRLANG	furlong
KAGBVRN	cogburn
BRAM	bram
TRA	tra
ASTAKR	stoker
RAMY	rami
RVZYTA	rosita
ASPARNDAM	spaarndam
PYRAN	piran
GABARA	gabara
LYVN	leon
NYHALANY	nihalani
SAYRY	sayre
BALDVR	baldur
MVNTVYA	montoya
FVTYNVS	fotinos
KVBSA	kobsa
TRAVAJLYA	travaglia
TYSZA	tisza
KRAYDR	crider
KANDV	kundu
BRVZ	broz
DANKV	danko
GRYKV	greco
RABYDYAKS	robideaux
ALKS	alex
ANRAH	unruh
ALTANYN	eltanin
ASTARYNGR	staringer
BVRM	borm
LVRJYV	lorgio
BAYLZ	byles
FRNASYSKAZ	frnaciscus
VYDAL	vidal
PRYYVTY	priotti
KAMAL	kamal
HAR	har
DYNG	ding
KALPANA	kalpana
AVRV	orue
SALMVND	salmond
HADSVN	hodson
KVNYNG	koning
PYPGRAS	pipgras
AYTJY	oetje
SVKVL	sokol
MYLVARD	milward
TYV	tio
SANDMAN	sandman
PVLYNG	poling
KARP	karp
VYLKYNSVN	wilkinson
RYVNSVN	runeson
DYMYTRYVS	dimitrios
MVRABYTV	morabito
PVH	poh
NAVAR	nawar
KVNVPKA	konopka
SANTSBRN	sansburn
KYPLYNG	kipling
ASKATY	scotty
LANSYNG	lancing
DYLAN	dilan
FYGARD	figard
VAYL	vail
HAVK	hawk
MKGVYRK	mcguirk
PRYSTVN	preston
RVBYNSVN	robinson
PAGLYA	paglia
SAMVSKY	samosky
SVR	sor
FRAZYYR	frazier
ADAM	adam
AYALA	ayala
ANVKVL	anukul
FAVZY	fawzi
HVLM	holm
HAJ	haj
KARMVNA	carmona
BLVM	blum
LVATS	loats
LYZA	lisa
BLAL	blal
MYAYNDRT	meindert
LAY	lai
FABRH	fabre
BVNAR	bonar
BALBYR	balbir
AMAND	amand
SVL	sol
DYVNYDA	dionida
PANGBVRN	pangborn
BARBVRAK	barborak
MVRAD	murad
HLAVYN	hlavin
JANKYNSVN	jenkinson
KVYYLYN	quillin
TKS	tex
JYVVYL	jewell
MYNTAKAH	mintaqah
PVYNT	point
BAD	bud
HYRVTA	hirota
KYVNG	keong
NYPTVN	napton
SASZH	sasze
BANKRVFT	bancroft
KAV	cao
MARTYN	martyn
KAZVNVZY	kazunori
ASTAPLYC	stuplich
LYZ	liz
DVGAN	dogan
VYNTJY	wyntje
YANSVN	yanson
LAYL	lyle
MADABA	madaba
MYLAD	milad
AVCZ	ochs
DAVSAN	dawson
KLAYTVN	clayton
ABYAD	abiad
AYTCVN	itchon
VADH	wade
TVLAY	tully
MANA	mana
GAVYND	govind
MAKAYVLY	macauley
BYLYNSKY	bilinsky
DYRKS	dirks
BALSAM	balsam
PAYNY	payne
PATRYZYV	patrizio
NYGRA	nigra
MVSY	musa
FADYLA	fadila
ANANT	anant
NARLA	narla
KALPAK	kalpak
VYRJYNYA	virginia
BALTAYS	baltais
HADYL	hadil
KARP	karp
AYDY	eady
VYKTYM	victim
KAZVNVZY	kazunori
MAYNR	miner
DABYNSVN	dobinson
MANTVR	mantor
GRYTZ	gritz
ATVL	atul
ALYNGTVN	alington
KVNVPKA	konopka
DVPALM	depalm
SABRAMANYAN	subramanian
PVH	poh
LYNDL	lendl
AYRAY	airay
KVYYMAN	coeyman
KYVNG	cuong
LVNAV	lunau
ANJLYSYA	anglesea
SARVATH	sarwate
RAHVL	rahul
AVGVST	august
GVRVYTZ	gorwitz
SVHAS	suhas
GVGVAN	goguen
KRYVVNVZ	kriwonos
AVZMN	ozmen
BRYSBYN	brisbin
LALY	laly
RVYS	ruiz
PRYYVTY	priotti
ARGAR	orgar
LVNAN	lonon
KYNGFAY	kingfai
KYNARD	kinard
BYPYN	bipin
HARMZ	harms
AL'YN	alain
ARGAN	organ
RYSLYNG	rysling
RAMBV	rambo
LYDYA	lydea
BATRA	batra
ARLYNG	arling
BRAVV	bravo
NAN	nan
GALPYN	galpin
ASKVRR	scorer
FVNKY	funky
RASTYN	rastin
AMYRA	amira
FVRJY	forgy
TAGLV	tuglu
TVKYV	tokyo
YARMAN	yarman
FLYMYNG	fleming
ANVJYT	anujit
SAMVYL	samuel
ADYL	adil
BARTVK	bartok
BRYDY	brady
AVRM	orem
MYNTZ	mintz
SVTV	soto
AVNAYZ	unaiza
FRAYTGRSA	fritgersa
DYNA	dyna
AMAND	amand
ABYAB	abiab
PRAHL	prahl
RVYAL	royal
AYGLV	igloo
GVH	goh
LABKYN	lubkin
LYNKVYS	linkous
ARGAR	orgar
LVNZ	lunz
ASTYVN	steven
'RBYL	arbil
PVALMA	puelma
VYNZ	winz
AYRYZARY	irizarry
AYLYN	ileen
AYVJNH	eugene
HAYVARD	hayward
NVRY	nuri
HARMANVS	harmanus
PADVA	padua
JVAV	joao
ANGVLV	angulo
KAMHVLZ	kamholz
NYNVYS	ninoys
GRAG	grog
GYLPYN	gilpin
ASLATR	slater
HAMPTVN	hampton
AYSKANDR	iskander
PAGLYA	paglia
SVRYN	sorin
BARTVNYKV	bartonico
ABVDHABY	abudhabi
AVADYA	awadia
VYGSTVN	wigston
KANDV	kundu
BVRM	borm
BRYTVN	breton
BYR	bir
MADYV	madeo
RADVF	radov
ARNAT	arnot
LAND	lund
LYDVYNA	lidwina
MYSRA	misra
LAYVRYTSN	lauritsen
MANV	mano
MATVLA	matula
BABA	baba
ASKYN	skene
RYZVY	rizvi
HANKH	hanke
DRVDYNG	druding
ANPYNGKV	unpingco
TVBYAS	tobias
KRAK	kruk
BVD	bud
KVRDYK	kordic
AZANA	ozuna
KARLTVN	carlton
GVSTAVVS	gustavus
VALKA	walka
BYN	bin
ANVPAM	anupam
AGVYV	agoyo
MYTV	mitu
JVNYN	jonin
MYLKV	milko
PYPVNY	piponi
MVRABYTV	morabito
AYNGMAR	ingemar
ANVN	anon
ALYZA	alisa
HARBVD	harbud
MVRAN	moran
KAMPVS	campos
SARVATH	sarwate
TVMANY	tomany
KANYG	konig
GVRKY	gorki
MVRAY	moray
TAYLV	thilo
GVSTAV	gustav
TVAMA	tuama
AKS	axe
VYJNAND	wijnand
KYVMR	kumar
SYSK	sisk
KRYSTYAN	kristian
HVRST	horst
DANYLV	danilo
AYRVN	aaron
VYVLA	viola
SAGARS	sugars
PANYSY	panici
ABA	aba
HVRYNG	hornig
SYLVYV	silvio
FADYL	fadil
ANTVNY	antoni
SKARP	scarp
FAYK	fike
HVDSVN	hodson
NYDA	nida
NVLF	nolf
GAYNVR	gainor
VAN	wan
MANJYT	manjit
TVLANY	tolani
ZAYNAH	zaynah
MARANY	marani
FRAYDY	friday
LVRY	lory
LVM	lum
SANK	sunk
'YN	ain
ASTV	stew
ABRYNY	ibrini
VYMAL	vimal
AVRVM	avrum
SANTYK	santic
KARYDA	karida
GRAD	grad
LVKV	loco
KARBALA	karbala
TYPAL	tipul
PAY	pai
HAYNS	hines
HYTZ	hitz
LVBYN	lubin
SYVN	sune
LYMN	lymn
HVRST	horst
MYNTZ	mintz
MANDAR	mondor
AVLD	auld
ASLVN	olson
SYMVNA	simona
GRAYSLDYZ	griseldis
TYPAL	tipul
ZVLD	zold
GAYNVR	gainor
JAN	jan
ARFYVS	orfeus
LANY	lani
KRYSJH	krisje
PYAK	paik
PANDVLFYNV	pandolfino
GASKYN	gaskin
KLAG	klug
DVMYNGV	domingo
GVDRAN	gudrun
SYSLV	sislo
GLASYYR	glacier
KLVTH	klute
VADAPARTY	vadaparty
DYAB	diab
VAYBY	wiebe
NAVAS	navas
ATKYNSVN	atkinson
TYYVLN	thulen
KATALANV	catalano
NYD	nid
HANT	hunt
LVRA	lora
TAMPAS	tampas
KYSLV	kislo
PRANAV	pranav
LYVNARDV	leonardo
DYNA	dina
GVDYVYN	godewyn
PANDZ	ponds
ADKYNZ	adkins
HARDYNG	harding
NYNJA	ninja
KRYSTAL	crystal
NAVYA	navia
AVFYNGTVN	uffington
PARKZ	parks
FAYNK	finke
PASYFYK	pacific
KVYSMAN	coisman
VYLKYNSVN	wilkinson
RAYBLT	rybolt
NAVAR	nawar
VYRCVAL	virtual
SAYTZ	sites
ALYMA	ulima
HAMYLTVN	hamilton
HRNSBAY	hornsby
MARVAHA	marwaha
TVLANY	tolani
GANZAK	ganzak
MYNAMV	minamo
RAMBV	rambo
RAYSTLYN	raistlin
ASMYTSVN	smithson
FLYVRY	fleury
ASTARKY	starkey
KAM	kam
PYZYALY	piziali
ADVARD	edward
LARJA	larga
JVDAS	judas
ARFVRD	orford
RYVARD	rivard
SANTA	santa
NANSY	nancy
VARYANTZ	variants
DVZAT	duzat
KASY	koci
SYANG	siang
BAKYR	baqir
AYTJY	oetje
BRAVV	bravo
AYGRTVN	egerton
KVSTA	costa
KVYN	kuin
MANKA	manca
ALAYN	alain
TVMANY	tomany
'BVDHABY	abudhabi
BALSVN	balson
HASKYNZ	hoskins
GRYNHAM	grinham
ABY	ebe
DANKV	danko
HALTZ	holtz
BASYLYSK	basilisk
BABVRAV	baburao
VYRJYNYA	virginia
MARTY	marty
FRANGAKYS	frangakis
VARGAS	vargas
KVYNRYDVS	coenradus
FVJYVKA	fujioka
SYMAL	cemal
RABKYN	rabkin
KVYL	quel
SARMA	sarma
BAGZ	bugs
VYGTVN	wigton
LYN	lyn
VVLTRNYNG	woltering
MASATAKA	masataka
GVPTA	gupta
FAYZA	faiza
HAV	hao
JYNTVN	ginton
FRNASYSKAS	frnaciscus
KRYSPYJN	crispijn
HYND	hind
TYMVNYN	timonin
VYNTJH	wyntje
ALVYN	alvin
JVSLYN	joslin
'LYMA	alima
ZAZA	zaza
BRAVV	bravo
PYAK	paik
FARKAS	farkas
MAYTAG	maytag
ALYZA	alisa
HAKABAY	huckaby
HVLM	holm
ASPRVT	sproat
ASTNKAMB	stancomb
ASLATR	slater
FRANSYSKVS	frnaciscus
ADMYRALZ	admirals
HALAT	halat
KAZY	kazi
MANV	manu
KARVLYN	carolyn
KARLTVN	carlton
BYTZ	bitz
BVSTRAM	bostrom
KVYSMAN	coisman
RASKYN	raskin
NAPTVN	napton
SVLY	soli
KYNGSTVN	kingston
HALAN	hulan
RYYD	reed
TAM	tom
JAVYD	javed
DAVN	down
FABRV	fabro
HAGYN	hagin
ZARVS	xaros
ANBAR	anbar
KARASA	karaca
JAKVMYNTYH	jacomyntie
GYLPYN	gilpin
HARTYGAN	hartigan
TVLANY	tolani
FARYHA	fariha
LAMASTVS	lamastus
LYVNVRA	leonora
ASTVART	stewart
BAT	bat
AVBYD	ubaid
ALVYS	alwis
RYSAVY	rysavy
AYTCVN	itchon
KRANSVYYK	cranswick
GAYVN	gawne
ZARYA	zaria
JVNYN	jonin
SANYL	sunil
BYNVY	binoy
GVLAND	goland
HAYVARD	hayward
LAMARK	lamark
DVYNYNG	duening
DVRYS	doris
KASAT	kasat
SYKY	siqi
ASTYP	steep
GVNNA	gonna
ASTATZMN	stutzman
AYRYK	eirik
HANTYNGTVN	huntington
RVJAS	rojas
ZAHYD	zahid
PYZYALY	piziali
ASKV	osku
ASMYRNV	smirnov
RAJ	raj
VYLMVT	wilmot
MAVBY	mawby
BVSTAK	bostak
JVNYVR	junior
NVRHA	norha
KVBYLAH	qubilah
BVYZY	boisy
RAYDN	ryden
SYLVYA	silvia
MYNKY	minqi
HVRVAT	horvat
ASBRYNK	asbrink
DVLAN	dolan
AVBR	ober
GAJNH	gagne
TRAFTVN	trafton
BYPYN	bipin
BLVZVM	bloxom
AVKRAYN	ukraine
LANGDVN	langdon
HAMMANZ	hammans
BVYRKVYL	boerkoel
NYHALANY	nihalani
LYNDAL	lindal
KAPANGA	kapanga
DANYS	danis
HALST	holst
AVTVLYNY	ottolini
RADV	radu
BALTAKS	baltaxe
ASTYL	steel
SYLVYA	silvia
MARGVLYN	margolin
FLAT	flat
PYNDAR	pindar
ASTRYDR	strider
RABVYL	raboel
MARKVPVLY	marcopoli
SANTV	santo
HYYN	hean
KRAVN	crown
ASKY	skee
ASTYL	still
MAMFVRD	mumford
DVALYBAY	dowaliby
ASMA	asma
ARAN	eran
MARKVYZA	marqueza
JYSVZ	jesus
FAVST	faust
PYNSVN	pinson
DYANA	diana
GASTYN	gostin
VYNSN	wincn
RYM	rim
MANK	monk
BASYN	basin
LANDRY	landry
MVSY	musa
SAMVSKY	samosky
SALYAN	salian
PVRANYK	puranik
TAMAS	tamas
'BDVL	abdul
AYSMN	isman
BVSTVN	boston
MKMANYS	mcmanis
ASTAD	stude
HASAKAH	hasakah
SARNA	sarna
FRAYDY	friday
DART	dart
DYVAYN	devine
MYSRA	misra
DYVYD	david
SYRVS	cyrus
AYTJY	oetje
MADABA	madaba
AVRYVLY	aureole
DAYANYSYS	dionisios
BVYRKVYL	boerkoel
HYDAJAT	hidajat
BABV	babu
ABVDHABY	abudhabi
CAYLD	child
KRVPYK	kropik
BRYGVY	bryguy
ASTK	stec
PAM	pam
PALSKY	polsky
PANGBVRN	pangborn
AYSTMAS	isthmus
BARLAS	barlas
ASTNFVRD	stanford
TAMBRVS	tombros
BVDAR	budur
BARLAS	barlas
DAHAK	dahuk
DYMA	dima
CYBANSKY	cybanski
KAPANGA	kapanga
DAL	dal
NYVMAN	neuman
JVSYP	josip
HYDAJAT	hidajat
SKARP	scarp
RYHANH	rihana
ARGAR	orgar
LVDVVYKA	ludovica
TALMY	talmy
ASKP	skep
JANKYNSVN	jenkinson
AYN	ayn
VAYA	vaya
GAVYNDAN	govindan
AYKAM	eckam
KAMALA	kamala
QVASYM	quasim
GRAYSLDYZ	griseldis
JVSVYG	joswig
KRAYJ	craig
AKLVF	eklof
DAS	das
SAVARAM	savaram
NYVARK	newark
PAVLYK	pavlik
MASKYAS	mascias
ATV	oto
DANYLV	danilo
MYGVYL	miguel
GYVZ	guse
PASKV	pasco
JVBAL	jubal
VYLAS	vilas
VYNDVM	windom
MARYTJY	maritje
BRAYR	brier
KARBALA	karbala
ANAGRAM	anagram
RABYDYAKS	robideaux
BANKRVFT	bancroft
LVSTY	lusty
MASAHYRV	masahiro
DAY	day
KVLYN	colin
KAMPAGNA	campagna
LAN	lan
NAKAMVRA	nakamura
AMANY	amani
KYALASA	kailasa
AFAF	afaf
MAV	maw
ANPYNGKV	unpingco
GRANVYN	granvin
ASMYLY	smyley
PVYNT	point
ASKV	osku
HARYNKAR	harincar
RVLDAN	roldan
RANKYN	ronkin
AFAF	afaf
KVAAYNTN	quainton
FAYNLY	finley
MVHAN	mohan
HAPKRAFT	hopcraft
BVRG	borg
ALAYS	elyse
ASTVARD	steward
MAYZ	mize
VYVLA	viola
NYVMAN	neuman
VYKTVR	victor
ASTYRNZ	stearns
PYL	pil
TAM	tam
DAY	duy
MVNTANV	montano
ADYSAK	adisak
KRYYK	creek
PYYRY	pieri
SAKSNM	saxnem
KARVLYN	carolyn
SADYKVYH	saddique
PVLV	polo
MVZYNA	mozina
RAHY	rahi
DYVAYN	divine
RASKYN	raskin
HYSLAP	hyslop
KARTYK	kartik
SYNKLARY	sinclair
ARYK	erik
ATKA	atka
TVNGA	tunga
KATRYJN	catrijn
HANKH	hanke
MKMAHVN	mcmahon
MVBAY	mawby
VYNSVN	vinson
BYTZ	bitz
RYZVY	rizvi
PRANGS	prongs
KAPRAL	kapral
HVRVVYTZ	horowitz
DYKYNZ	dykins
BVYRKVYL	boerkoel
KVTLA	kotla
HARMANVS	harmanus
DVRYS	doris
ASKYN	skean
YAMN	yumn
DANG	dung
VAN	wan
MASATAKA	masataka
ATA	ota
HALTVN	holton
'RRYFA	arrifa
VYMPJY	wimpje
AYVGNH	eugene
AYBAC	ebach
ANTVNYV	antonio
VYLKYNZ	wilkins
AFTAB	aftab
DAMYNY	dominy
ATKYNSVN	atkinson
HYTSVN	hitson
'QYL	akil
HAPKYNZ	hopkins
GRAYY	graae
HAFSAH	hafsah
TAMAS	tamas
ANSYH	anisa
AYMVN	eamon
SAND	sand
DVRAND	durand
KRAYJ	craig
GRYT	grit
GASYK	gasic
ANSKAMB	anscomb
TYTMAS	titmus
JANVTJH	janotje
KVNG	kong
ASTANGYR	stangier
ASTYN	steen
DART	dart
ASPYR	speer
PANYSY	panici
HAGAN	hagan
BYR	bir
ALKAN	elkan
ANYJMA	enigma
RAHY	rahi
HASAKAH	hasakah
KRH	kre
SAMAH	samah
NVRA	nuri
BAYARD	bayard
RABYN	rubin
ASKYN	skene
DYVYLDH	dewilde
AYS	ice
PVMA	puma
RVBYN	rubin
LAMBDA	lambda
BVDRA	budur
BLAHA	blaha
GALYLH	galila
ADYK	adik
MVRAVAN	moravan
AFTAB	aftab
ASLAVK	slawek
SANG	sung
RVBVZ	roboz
LYDYA	lydea
MVSY	musa
BLVNSDVM	blunsdon
MANKS	monks
SAYRY	sayre
HARBVD	harbud
MADAKS	maddux
BLAL	blal
'LYM	alim
JYVVYL	jewell
RABYNSVN	robinson
LABKYN	lubkin
KVBLA	kubla
DAK	duk
PZARAYS	pezaris
ZALAN	zalan
DAYRKTVR	director
BAVKAM	bawcom
DANGYVN	dungeon
SALVMVN	solomon
SAVVY	savoy
MARTY	marty
ASPR	spur
YVMN	yumn
RYYAD	riyad
SAVVY	savoy
GVPALA	gopala
LYBRYK	librik
ANDRYAS	andreas
DAYBALA	dyballa
LYZARDZ	lizards
SKYVRYTY	security
ABST	obst
YVZR	user
TVSYNG	tusing
VAST	vost
PYRARD	pirard
DAG	dug
KVBLA	kubla
KATY	kati
RVSLYN	roslyn
BVSTRVM	bostrom
JAKVBY	jacoby
BRYND	brind
LYNDGARD	lindgard
HYSLAP	hyslop
DAVD	daud
TRANYTSA	turnitsa
GANG	gung
BVYRKVYL	boerkoel
NVLF	nolf
HYVM	hume
LVRY	lory
PVRTNVY	portnoy
AYLKA	ilkka
SANRAYZ	sunrise
AVRAYZ	averis
ALMYNTAGAH	almintaqah
SADYKVYH	saddique
KVJYAS	kogias
LYLA	lila
ANANDA	ananda
BVNYFASYVS	bonifacius
KATRYNTJH	katryntje
JAKVBZ	jacobs
KANV	cano
DVVAYKYNK	duickinck
GADY	gadi
KALHYNH	culhane
AVSNZ	owens
RVLFH	rolfe
HANTYNGTVN	huntington
KANAK	kanak
VARGV	vargo
BARYAKS	bariaux
BLAM	blum
VALDV	waldo
GAMBYNV	gambino
MATAR	matar
ADVARD	edvard
AVHALVRAN	ohalloran
RVBY	roby
MYNTAKAH	mintaqah
DABYNSVN	dobinson
SYLK	silk
KARTYK	kartik
AVBRHVLZ	oberholz
AVDVN	audun
LYDVYNA	lidwina
HALY	hale
