LVJYK	logic
KVNVPKA	konopka
SYVA	siva
ZARYH	zaria
ADNAMS	adnams
SYKVLV	sicolo
KASTVRY	kasturi
VYNSTRVM	winstrom
FRAMSAN	fromson
MARY	mury
SYSK	sisk
YVZR	user
GANDY	gandy
TVBVTYS	tubutis
LYM	lim
JVNYN	jonin
DAYVVN	dauwen
PANT	pant
FVRK	fork
GARTYN	gartin
ABYAB	abiab
FATYMA	fatima
ASMAYT	smythe
BYG	big
HARBVR	harbor
AYBYRVNK	ibironke
RABYJN	robijn
KANA	kana
BAD	bud
DANKY	dunki
VYMPJY	wimpje
NAYMAH	naimah
AVLYVYR	olivier
JAVYD	javed
MAGVAYR	maguire
DVMYNYK	dominic
TALBVYZ	talboys
PYNKY	pinky
PVSV	poso
KASPRZAK	kasprzak
RYVNVLD	reinoud
KVRY	kory
NAGY	nagy
KATRYJN	catrijn
VYMPJH	wimpje
GYBSVN	gibson
ASPLYNTR	splinter
LYRYK	lyric
AKL	akl
HASBY	husby
TALBVYZ	talboys
GAS	gus
AYNTJH	eyntje
KYKVMA	kikuma
LADASKY	ladasky
JVRY	jory
DVRAZYV	dorazio
RYYNKS	rienks
BARVA	barua
AKTVN	acton
BRVYLV	broilo
BLKSVM	bloxom
DYLYP	dilip
ASTRLYNG	stirling
KANYG	konig
BALHAM	balham
BAP	bop
SYMVN	simon
HVGARTY	hogarty
DAPAY	dupuy
HANKZ	hanks
ATKA	atka
DAY	duy
FRYTS	frits
DAHVK	dahuk
VYNTJH	wyntje
ASLVP	slope
TAYSN	tyson
HAYRVNYMVS	hieronimus
NYKY	niki
RAGNVALD	ragnvald
YARLA	iarla
ANV	eno
NVRDBVRG	nordborg
ASMYD	smead
TYV	tio
KVSTA	costa
TABVK	tabuk
ZAPARA	zapara
JVRY	jory
RVNALD	ronald
FYDALGV	fidalgo
KANZY	kanze
VYBVVV	wibowo
ASTALKH	stolcke
STRATVN	straton
RAY	rai
LANGV	lungu
DAL	dal
VYJDAN	wijdan
FYGARD	figard
BRAYD	bryde
AVSNZ	owens
AMYNA	amina
MARGVLYN	margolin
GARDYNR	gardner
MKMANYS	mcmanis
AVSYVN	oseven
AGALY	agali
TVNY	tony
JYM	jim
BASYLYVS	basilius
BYPYN	bipin
BAS	bas
ASKRYV	screve
NYVMAN	neuman
BLANSTAN	blanstan
KALAHAN	calahan
ALYAS	alias
SAMBVLYK	sambolec
RAYSTLYN	raistlin
PRYTZ	pritz
AVT	ott
FLARDYNGA	flardinga
SVDARMV	sudarmo
GRAG	grog
DVNATY	donati
SYVN	sune
PYVN	pion
BVZKART	bozkurt
ASTRND	strand
DYMYTRYVS	dimitrios
BVZKART	bozkurt
ASTABRT	stobert
KAZVHYRV	kazuhiro
AMYT	emit
AMBAR	embar
ALRVY	elroy
ASNV	snow
KVAST	kwast
VYSPY	vispi
DANYYLS	daniels
ALYA	alya
HASKYNZ	hoskins
ABA	aba
VAYS	wise
TVNAR	tonar
TAYLBRY	tilbury
MYLARA	melara
SVNY	sony
BKS	bex
HAV	hau
ADGYNGTVN	edgington
HAFS	hafs
GARYTV	garito
KVYRYN	querin
TVMATYVS	tomatius
ARYKSVN	ericson
BVYRKVYL	boerkoel
GVYYN	gwynn
SASLAV	saslav
DAVSVN	dawson
BANTVN	banton
NYVARK	newark
AYDVAYSVZ	ludovicus
KRAMHVRN	crumhorn
PANJABY	punjabi
KASTANV	castano
NYK	nic
HALY	hale
PAYTVN	payton
SYNDRH	sindre
BRYAN	bryan
JASTYH	justje
NVLAN	nolan
ANALVG	analog
HADSVN	hodson
AGVSTYNY	agostini
YAMYNAH	yaminah
PLANK	plunk
KAVLYNG	cowling
JYZAN	jizan
MANVLY	manolo
KYNGSTVN	kingston
KALDYS	kaldis
DYMYTRYV	demetrio
MAYZ	mize
TVNGA	tunga
ASPYR	speer
MVRYN	morin
PVYNTYNG	poynting
ARLYNG	arling
MYRMAK	mirmak
BARYAKS	bariaux
MARLYN	marlin
NARDY	nardi
FAYRVZ	fairuz
MARYTJY	maritje
TALMY	talmy
TYSZA	tisza
PLATFVRM	platform
ALVA	alva
AFYF	afif
HAPKRAFT	hopcraft
TRAVAJLYA	travaglia
LYBLYT	liblit
PRAYB	pribe
ANVN	anon
TAKV	taco
MVRA	mura
BARKALV	barculo
VYNKV	vinko
ASTNFVRD	stanford
BALSARA	bulsara
YVRK	york
DYNA	dina
SAKSNM	saxnem
GANSVN	gunson
LARJA	larga
BRYNK	brink
SAYTV	saito
ASKLVYR	sklower
GARMZ	garms
DANKV	danco
'LY	ali
AVRN	orne
ABH	abe
KAV	cao
MAYRS	myers
ARSY	arce
BADYN	baden
KAVDLYNG	quodling
GVRKY	gorki
AVLSN	olson
SAMZ	sams
PRANAV	pranav
KALTVN	colton
RASPYNY	ruspini
JARVYS	jarvis
GARMZ	garms
ADYH	adie
BAYRTYH	baertie
BAKSKA	bocska
JAKVBSVN	jacobson
SYRAFYN	serafin
AYNC	inch
BYAN	bian
PANKRAS	pancras
ANPYNGKV	unpingco
DANG	dung
SYVN	sune
AYDS	eads
GARAFALV	garofalo
DVLYN	dolin
VAFA	wafa
ASTNKAMB	stancomb
BVRGA	borge
KYNGFAY	kingfai
AYMAN	aiman
MARKVS	marcus
RYDKVYST	rydquist
SAYDA	saida
PYYK	peak
KAVLYNG	cowling
DANG	dung
MVNTYJV	montijo
FRAMSVN	framson
PYVN	pion
GADBVYS	gadbois
SAYTZ	sites
RAFAYL	rafael
LYKYVRY	liquori
ASLATR	slater
KLATZ	klotz
LYN	lyn
LYVNARDV	leonardo
ZVRYNK	zurink
HANT	hunt
BANKRVFT	bancroft
AYZDY	izadi
MARGVLYS	margolis
LAVRAY	lawrie
SVDARMV	sudarmo
TVNAR	tonar
TAGLV	tuglu
BRAN	bron
TVMY	tomi
VLADV	vlado
HAKABAY	huckaby
JASTYH	justje
YANVVYTZ	yanowitz
AVLYVYR	olivier
ASLATR	slater
MANGYN	mangin
AMNVN	amnon
LVRY	lori
BAVM	baum
AMADVR	amador
ZAKY	zaki
BRYDY	brady
GASTAVVS	gustavus
FVRSAYT	forsyth
KARYDA	karida
VYLKYNZ	wilkins
ABRAHAM	abraham
AYDMN	eidam
ASTAMPR	stamper
DABYNZ	dobyns
PANJABY	punjabi
RAVY	ravi
BRYSYNDA	brisinda
HVGARTY	hogarty
DAY	die
KVYYT	quitt
HALY	hale
'BVDHABY	abudhabi
RYBAR	ribar
NANSY	nancy
AYRDV	airdo
KVANG	kwang
ANVN	anon
LYNDRVTS	lindroth
SYRAFYN	serafin
LAYMAK	limace
DVPALM	depalm
MARYH	murie
LAYVLY	lively
MARYV	mario
HARPVLD	harpold
BRVZ	broz
MATAKV	matako
MANYKS	mannix
SAKSNA	saxena
YVZR	user
ASTARYNGR	staringer
SYNKLAYR	sinclair
KATY	kati
AMYVT	amiot
KVMAR	kumar
AYZAK	isacq
KVRVYN	corwin
GALKV	galko
BVST	bost
AVLSN	olsen
NYD	nid
PAYPR	piper
KYSVN	cason
KYM	kim
BAT	bat
SYN	sin
MVRNYNG	morning
NAYKVLAS	nicolaes
ABYAN	abyan
ASTYSY	stacey
RVYAL	royal
SVPRATYK	supratic
SVLVMVN	solomon
HAVARD	havard
HASTYNGZ	hastings
HAVYS	howes
MARK	marc
BABAH	babah
KASVN	kasun
LYSY	lacy
JANSJH	jansje
SAYM	syme
'QYL	akil
DAYR	dyer
BVS	bos
GRAYYNGR	grainger
VYKLVND	wiklund
KAMBS	combs
VYDY	vidi
MVRA	mura
LYDYA	lydia
SASAKY	cacace
BALHAM	balham
SYNYBALDY	sinibaldi
MARTY	marty
FLYMYNG	fleming
BRANDY	brandi
LAND	lund
YASAR	yasar
GYZAV	gizaw
AKDAG	akdag
SVAGATV	swagato
GAMBYNV	gambino
ANASTASYA	anastacia
AYS	ice
TVMATYVS	tomatius
HASAKAH	hasakah
HAVKYN	hawkin
JASTJH	justje
HAHTAHA	huhtala
TYRZA	tirza
SYMPLYSYTY	simplicity
LAZARD	lazard
MAYRS	myers
ASTNSRAD	stensrud
ANTVNY	antony
DANLVP	dunlap
MYNGV	mingo
KRYSJH	krisje
TABVK	tabuk
YVNYZA	unaiza
PYNSVN	pinson
LAVSTAD	lovstad
RYSLYNG	rysling
GRYT	grit
BVSA	busa
RVLFH	rolfe
LAPASV	lapaso
MARTYNZ	martens
ANRYKV	enrico
RYV	ryu
ALSVN	elson
ANYART	enyart
MABAY	mawby
NANSY	nancy
YAV	yaw
AVRKNY	orkney
KAMSKAYA	kamskaya
AYNS	ines
GAGNH	gagne
ALTZ	oltz
MKMAHVN	mcmahon
AGATY	agate
LYZ	liz
VYVYK	vivek
SABGLASYAL	subglacial
AYDA	aida
PLATFVRM	platform
DARYL	daryl
VYMPJH	wimpje
AGRAVALA	agrawala
MANGLANY	manglani
SABGLASYAL	subglacial
JANG	jang
ANALVG	analog
BVLDT	boldt
AYNGLYS	english
NADYG	nadig
MVNDFRANS	mondfrans
AYLYS	eyles
LANG	lung
MALVNY	malone
GRYGVR	gregor
LYLA	lila
VYNTVN	winton
GAVYN	gavin
DRVDYNG	druding
NYVYSVN	nevison
MARKVM	marcum
ALF	elf
KAYNY	caine
KYBV	kibo
HARVARD	harvard
DRVR	dror
MANK	monk
RAYLY	raile
LVDVRF	ludorf
DANGYVN	dungeon
MVNTANARV	montanaro
AVGVRY	aogori
PVYNTYNG	poynting
JANG	jong
GARSYA	garcia
PYL	pil
LYVYV	liviu
HASK	husk
GATLYN	gatlin
KVJYAS	kogias
KVDAMAH	qudamah
HARVHYSA	haruhisa
ANTVNYVS	antonius
NYVMAN	newman
SYN	sin
AVKYNZ	oakins
HAVN	hawn
KAKY	kaki
PVGVSYAN	pogosyan
BRADY	brady
PVLYS	polis
DAMYNY	dominy
AVNSTY	onesty
TRYVLV	triolo
HVRGAN	horgan
MANTVR	mantor
KATALANV	catalano
BVSTAK	bostak
MS'VD	masud
AKTVN	acton
LANDRY	landry
BASKAR	baskar
ANYSH	anisa
KLVB	club
AMANV	amano
BASMA	basma
ALMAR	elmar
AMY	ami
JASTJY	justje
SVRAJ	suraj
GYVZ	guse
BRAY	brie
ATVSY	atusi
DAMYTRV	dumitru
BALYN	balin
KASVN	kasun
BANYTV	bonito
BARD	bard
ZYL	zyl
RAVDAH	rawdah
BRAVV	bravo
NAYKVLAS	nicolaes
HALAN	hulan
AYNAYN	inauen
HASYK	husik
YARVS	yaros
AVKRAYN	ukraine
LVYD	loyd
ALDYN	eldin
LVPATKYN	lupatkin
SAMBVLYK	sambolec
DHAMAR	dhamar
TVBYAS	tobias
BANKRVFT	bancroft
BASKY	bosky
AKSLY	oxley
RVNY	roni
GANG	gang
AYSYZAKY	ishizaki
JAGARD	jagard
JAGV	jago
LAMBDA	lambda
BRVKSL	brooks
SVNDARAM	sundaram
AYM	aim
LATKYNZ	lutkins
VYNATA	vinata
PASYFYK	pacific
GASLYNG	gosling
ASTATZMN	stutzman
SATVR	satur
KVANLAN	quinlan
MARY	mary
APVNTH	aponte
SYTV	seto
BRAVV	bravo
AMBAR	embar
AMYR	emyr
YAYN	iain
LYDYA	lydea
AMBAR	embar
MYLVT	milut
BRAHAM	braham
SANTSBRN	sansburn
HAYZ	hise
ARYN	erin
FAVST	foust
DADA	dada
KAMBS	combs
SYT	sit
BAYRTAY	baertie
AQBAL	ikbal
LYVANDVN	lewendon
ARYN	erin
ANBAR	anbar
HYN	hin
LADVYG	ladwig
ASTFANV	stefano
ATA	ota
RVYAL	royal
R'NA	rana
ASMAYT	smythe
LYDVYNA	lidwina
SANTV	santo
BARY	bari
FVJYTA	fujita
HAVYS	howes
BYPYN	bipin
SVRAB	sorab
KRYSP	crisp
HAPKRAFT	hopcraft
FYSK	fisk
LATZ	lutz
KVRTH	korte
RYGAN	ragan
TYHAN	tehan
MANV	manu
FAYZA	faiza
MANA	mana
SAYVYR	sawyer
ALYASVN	eliason
HYSLVP	hyslop
TARVB	tarub
ZARYH	zaria
LYMYNG	liming
TRAYNTH	tryntje
AMYVT	amyot
HYRAY	hirai
SAN	son
LANTZ	luntz
HANKZ	hanks
MYTVN	maton
ASMAL	small
ASNV	snow
BAR	bar
LYAM	liam
KVTLA	kotla
ASRAT	israt
LAN	lan
LYVNZ	lions
RADV	radu
AYSRT	israt
HASK	husk
HAMPTVN	hampton
RALF	ralf
AKSV	aksu
HALM	halm
ASTAFVRD	stafford
GVADA	gouda
ASTYP	steep
HADVBA	hudoba
MYR	mir
TRAYNTH	tryntje
KRYS	kris
TVSYNG	tusing
VYKRAM	vikram
SAVAN	sawan
HARYV	horio
PRAYVYT	private
DYVAKARVNY	divakaruni
SVMA	soma
ALVYN	alvin
FAGAN	fagan
BRAHYM	brahim
LYN	lin
GNVSYS	gnosis
AVTVLYNY	ottolini
JVAB	joab
GANDY	gandy
MAGVAYR	maguire
MYTV	mito
ALYLYVNAS	alelyunas
DAVVD	dawud
PLANK	plunk
TABVK	tabuk
KASAT	kasat
YASAR	yasar
ASKY	skee
HYTSVN	hitson
LANKA	lanka
KVYN	kuin
ARKTYKY	arktiki
GALV	galo
AAMYNA	aamina
KAMB	kamb
SASLAV	saslav
KARVLYN	carolyn
ARBYL	arbil
SYLA	sela
JASTYN	gustin
FYNSTAD	finstad
HAYVL	houle
SYMYNGTVN	symington
AYRYZARY	irizarry
BYRK	birk
TVNY	tony
SYMVNA	simona
KAYAK	kayak
AVSTYN	austin
KANZY	kanze
DANKY	dunki
DYVAR	dewar
DVPALM	depalm
LAYN	lynn
NAPVLYTANV	napolitano
GVADA	gouda
BAVA	bawa
BRABANT	brabant
APVNTH	aponte
'BVDHABY	abudhabi
GVRVSAMY	gurusamy
RADAK	radek
KVASYM	quasim
BYTZ	bitz
AYLVARD	aylward
AKMAN	ekman
DAYR	dyer
VYDAD	widad
KARTY	karty
DVLAN	dolan
ALMYNTAKAH	almintaqah
BVDY	budi
ANSYH	anisa
NAVAS	navas
ZYZY	zeke
KANYA	kania
AYBAC	ebach
FVJY	fuji
AVZBRN	osburn
DASYVK	doseok
MARY	mary
SAVAN	sawan
VARDY	vardi
YAYN	iain
VYGJYN	wiggin
JVDY	judy
ABYAB	abiab
KRAVN	crown
MYAV	miao
MAYZ	mize
KARYAGA	cariaga
BRAYS	bryce
ALVF	elof
HVYYSKN	huisken
RAMY	rami
FYSK	fisk
MKKARTY	mccarty
AYSMN	isman
ASLAN	slone
DAMYVN	damion
MYNAMV	minamo
TVNGA	tunga
PARKZ	parks
AVSTYN	austin
KATLYR	cutler
AMYRA	amira
KAMAR	kumar
BVS	bos
MANV	mano
MARTYNTJH	martyntje
MARTYJNTJH	martijntje
SVLV	solo
VAJDYK	vajdic
MYKAYL	mikael
ARFVRD	orford
BALHAM	balham
ANTRVSYV	antrosio
FAGANS	fagans
YANGY	yangi
TRANYTSA	turnitsa
NABYL	nabil
HASAKAH	hasakah
ASKVAYRL	squirrel
RAVDAH	rawdah
DARBY	darby
KAYA	kaya
KANAKAKVRN	kanakakorn
LAMASTVS	lamastus
GYVVN	givon
GASLYNG	gosling
SAMANTA	sumanta
AYSAKS	isaacs
FARAG	farag
DYMYTRYS	dimitris
YAGLA	yagla
AVYRSA	aversa
ABAD	abad
HARMZ	harms
PVGVSYAN	pogosyan
GALYLH	galila
AYSLT	iselt
ADANA	adana
PAPLASKAS	paplaskas
ARFVRD	orford
GVSTAVVS	gustavus
MARYH	murie
FRANKVYS	francoys
NARV	naro
PANDYT	pandit
DAN	dun
GAYA	gaya
AYSAK	isaac
SYMYN	simin
ANTVNY	antoni
VYMAN	wyman
GVRVYTZ	gorwitz
RYVDT	ruudt
RVSTAD	rostad
GVH	goh
SYNK	sync
ANANDA	ananda
LVSYTV	losito
MANYSKAS	maniskas
DRAP	drop
DAVD	daud
SYLA	sela
GYLPYN	gilpin
TVYDA	toida
RABYN	rubin
ASLVN	sloan
BRAVN	brawn
ARYA	arya
LVFSTRVM	lofstrom
KVRZAYN	corzine
ANV	anu
GRANT	grant
GYLRVY	gilroy
VAYS	wise
KAKYVR	kakure
HYNTVN	hinton
KAYRD	caird
DVMYNYK	dominic
RABYDYAKS	robideaux
ASTRYNGR	stringer
KAYAK	kayak
AMY	amy
PAGLYA	paglia
RAYBLT	rybolt
ANAKYN	anakin
GRAYSLDYZ	griseldis
BRVYLV	broilo
ANRYKYV	enrique
FARYD	farid
KYLG	kilg
JAYARAM	jayaram
SANDAR	sundar
DVGAN	dugan
GAYDV	guido
MVNS	muns
BVM	bum
ASTYN	stian
DVSTALYK	dostalik
ASKLVYR	sklower
FARAGV	farago
HYYN	hean
BYTZ	bitz
DYVYS	divis
FYGARD	figard
BYNVY	binoy
SYMYNGTVN	symington
PRYYVTY	priotti
KRYSVJYN	krisoijn
SYLVAN	sylvan
GYZAV	gizaw
JYSVZ	jesus
SVANK	swank
NAYMAH	naimah
RASK	rusk
BRVYLV	broilo
TAPYV	tapio
ALFANSV	alfonso
TRANYTSA	turnitsa
FVY	fui
AYLYN	ileen
AVBR	ober
HAVK	howk
TRAYNTH	tryntje
AYTJY	oetje
BLAHA	blaha
HAVVLA	havola
DANKY	dunki
SRAYNH	shryne
'LY	ali
RYSAVY	rysavy
AVDRA	audra
GAN	gan
VVJAK	vojak
AYSVN	asson
HYTZ	hitz
KVRDAS	kordas
LAV	law
FYGARD	figard
PVRVS	proos
ASTRYDR	strider
ARM	arm
FVY	fui
CAYLDZ	childs
LAFGRYN	lofgren
JVAN	juan
MAGAGNA	magagna
GADBVYS	gadbois
GVANYAV	guanyao
LABYN	lubin
ARSY	arce
ASTV	stew
NANSY	nancy
DYVNYDA	dionida
HARBVR	harbor
DYVAN	dewan
TAFTZ	tufts
KASTRYKVM	castricum
BRYJ	brij
RADHYKA	radhika
AZANA	ozuna
KAY	kai
JANK	junk
KATRYJN	catrijn
ALSVN	olson
ALMVDYVAR	almudevar
LVATS	loats
BVSTVN	boston
KAYAK	kayak
KRAB	krab
BVDRA	budur
MAY	mai
ASKYN	skene
SVNG	sung
KALAFVT	kalafut
DVNATV	donato
DANKY	dunki
LAMARK	lamark
LYDVYNA	lidwina
KADV	kado
KATY	kati
ASKAL	scull
LYNKVLN	lincoln
TYNG	ting
GABVR	gabor
ALDYN	eldin
MYKAYYLYZ	michaelis
ARBY	orbi
VYJDAN	wijdan
KVLYN	colin
AYRLAYNZ	airlines
DADH	dade
RASPYNY	ruspini
ALDYN	eldin
MVRAS	moras
KYRBY	kirby
BALYT	balit
SALYAN	salian
AMS	ems
ANTARAMYAN	antaramian
YYKA	yeka
KAMPAR	kompar
PYRVZ	piroz
HAVKYNZ	hawkins
MANVLY	manoli
FVRK	fork
HYVVYT	hewitt
BAKAYA	bakaya
NAHAM	nahum
GASTAVVS	gustavus
TAMAY	tamai
VYKTVR	viktor
GARDYNR	gardner
LAYVSAY	livesay
BAKVS	bakos
TVBYN	tobin
GRANT	grant
FRANSYSKVS	frnaciscus
TRAFTVN	trafton
AVMGA	omega
DASYVK	doseok
AVN	aun
BARKVS	barcus
AVHRMN	ohrman
KVANLAN	quinlan
KAYAK	kayak
NAVAS	navas
SYKVRA	sikora
KRYSP	crisp
BVSTAK	bostak
'AYMN	ayman
RAD	rad
SANA	sana
BRYTV	brito
KANYG	konig
SANVNDV	sunondo
DAGZ	dogs
MARGVLYS	margolis
RVYS	ruiz
LAST	last
TAV	tow
AVNAYZ	unaiza
KAMSKAYA	kamskaya
YVRANYM	uranium
DVMYNGV	domingo
RAKVN	rukan
KVRKAM	corkum
BRVYLV	broilo
VAYA	vaya
SYMS	sims
LANA	lana
BYAVYS	beavis
KRAY	cray
KAYAK	kayak
ADVARD	edvard
TVYYG	twigg
ALVKAL	alukal
KYNT	kint
GYLYTA	geleta
KARYDA	karida
LAYRD	laird
KAZY	kazi
HANY	hani
GVRALP	guralp
DYK	dik
DYSANTV	desanto
BRYTV	brito
SVA	swa
MATSVMVTV	matsumoto
DVBRYZ	dubris
DAG	dag
RYM	rim
AVLSN	olsen
MARKVS	marcus
GVRAN	goran
