GYFT	gift
DAYANYSYS	dionisios
ASMYTZ	smiths
JAVYD	javed
ANBAR	anbar
BARFVRD	barford
ASLYP	sleep
FARAT	furat
HAVN	hawn
ARNAT	arnot
YVNAL	uenal
GRAYYV	grieve
ALVYN	alvin
AYRYS	ariss
ASKVLYNG	scowling
ANBAR	anbar
PAYK	pike
LABRYVLA	labriola
ASTYVN	steven
ARASMVS	erasmus
JAN	jun
TAYLBRY	tilbury
MVHAN	mohan
PANYSY	panici
APLYN	aplin
RVKAN	rukan
ASKP	skep
KVBYLAH	qubilah
RANKYN	ronkin
TAMPAS	tampas
SYMYN	simin
VYLJV	viljo
ASTRYD	astrid
NAZARYTYAN	nazaretian
VYNSTVN	winston
HYVNGAN	hiongun
BRYND	brind
BVNYTZ	bonitz
JANVTJH	janotje
GVRGANZ	gorgons
LYVYV	liviu
MARY	mary
AVLSVN	olsson
KAYAK	kayak
BRAVN	brown
HYRT	hirt
KADV	kado
LATKYNZ	lutkins
ANTRAPY	entropy
GABA	gaba
VANG	vang
BRANDY	brandi
LVRD	lord
FLAYGYR	flygare
SVDAN	sudan
ASTYGBRG	stigberg
KVYYLYN	quillin
PRAYL	prael
HYGARTY	hegarty
LANTZ	lantz
MYSA	mesa
AYSLT	iselt
GVRAN	goran
NAYLZ	niles
TAMATYVS	tomatius
AYRD	aird
MABANAG	mabanag
MALVNY	malone
VYNSTVN	winston
KRYSVYJN	krisoijn
LYSKANV	liscano
KALHYNH	culhane
ANSYH	anisa
TRAVAJLYA	travaglia
GARBH	garbe
KAV	cao
KRYSTAL	crystal
GVAN	guan
HYRD	hird
BVSA	busa
ASYF	asif
JASTJH	justje
ALYN	olin
TYYVLN	thulen
KYVMR	kumar
GRAH	grah
KASTA	costa
MVMFVRD	mumford
VYK	vik
LVS	los
BARNAM	barnum
ASTK	stec
AYMVN	eamon
HVLRVYD	holroyd
ARMAND	ormond
DVRAND	durand
DARBY	darby
PALYDV	pulido
FRNASYSKAS	frnaciscus
MAY	mai
GRAYSLDYZ	griseldis
HANT	hunt
SANK	sunk
DYVAYN	divine
ARVNAH	arunah
AKS	axe
ASPYR	speer
ASPYDN	speden
DYMA	dema
JANSKY	jansky
GRAV	graw
KASTRYKVM	castricum
BLAVADNYK	blavatnik
MVNDFRANS	mondfrans
PVH	poh
ANAYZA	unaiza
ASTVARD	steward
NYNSTAR	ninstar
PRAYM	prime
LANKA	lanka
APSTVN	upston
JAKVBY	jacoby
KRASBY	crosby
TVYYG	twigg
AYNGRYSVL	ingresole
TRAFTVN	trafton
KANG	kang
DJAMYLA	djamila
KVBV	cobo
KASTANV	castano
NAGY	nagy
BANKRAFT	bancroft
GVDAT	gudat
AMNA	amna
KLAYTVN	clayton
ANAY	anay
SYMYNG	siming
ALMVMAN	elmoman
SYN	sin
GVPTA	gupta
BRYGVY	bryguy
SYNAN	sinan
PVHL	pohl
KARA	kara
KRYSTYAN	kristian
HYNTVN	hinton
ASTYN	steen
AYLSA	ailsa
MARTYNTJH	martyntje
MAY	may
AMVRY	amory
LVBV	lobo
NARLA	narla
MVNTYJV	montijo
TVLAY	tully
LAVD	loud
PVLGAR	pulgar
AYLSA	ailsa
PAM	pam
AYBYRVNK	ibironke
KAYK	kauk
AYR	air
KYNSVN	kinson
PANYKV	panico
ASVALD	oswald
MARVYT	marvit
ASTYNBRG	stenberg
TYPAL	tipul
BRATYNA	bratina
LAMASTVS	lamastus
LABRYVLA	labriola
AYNGRYSVL	ingresole
AVANZ	evans
ASTYN	steen
KAZVHYRV	kazuhiro
LAND	lund
VAYN	vine
LYMN	lymn
MAHAJAN	mahajan
VYNTJH	wyntje
DAY	day
VYNSVN	vinson
KRAVFVRD	crawford
MYKVLYK	mikolic
BVSTVN	boston
RAFAYLY	rafaeli
AYK	aik
SADYVP	sudupe
DRVR	dror
ASLYP	sleep
FYNSTAD	finstad
HYSLVP	hyslop
GANG	gung
KVYSMAN	coisman
RVSA	rosa
VYLAS	vilas
BVKSY	buxey
'QYL	aqil
VYLASKV	velasco
ASTYN	stian
ARVYNG	irving
SYLVYV	silvio
AYNGLF	ingolf
PVYNTYNG	poynting
BANYTA	bonita
MVNS	muns
MVRANV	morano
KANZY	kanze
FALSAM	folsom
KAYA	kaya
KYAT	kiat
MANSYL	munsil
TYN	tin
ASPYN	spine
BAVDVYYN	baudouin
ADYSAK	adisak
NVKS	knox
GASKYN	gaskin
LYNDAL	lindal
KATY	kati
LYLA	lila
HABVRA	habura
AYSVN	ayson
NYLS	nils
ANFANT	enfant
BRANSDVN	brunsdon
BKS	bex
KANZY	kanze
HYTZ	hitz
AMYR	amir
LAYVSAY	livesay
APRYL	april
ADGYNGTVN	edgington
DVMYNYK	dominic
ASTARGYL	sturgill
BANKRAFT	bancroft
AYRP	earp
RABYN	rubin
DYVAKARVNY	divakaruni
FARAT	furat
RVNYT	ronit
SYGMVND	sigmund
FAYNK	finke
ANDRYA	andrea
'BDAL'ZYZ	abdulaziz
AL'YN	alain
GVH	goh
JVZY	josi
MAV	maw
SYRYL	cyril
HARMAN	harman
DAVKNYZ	dawkins
FRANKVYS	francoys
LADVYG	ladwig
TANYS	tanis
VYKAS	vikas
ASTV	stew
GVADA	gouda
AKLVF	eklof
GASKYNZ	gaskins
RVNALD	ronald
AYS	ace
KADV	kado
AVALD	ewald
GVRAL	gural
SYGMVND	sigmund
LYBYD	lebed
ASLYMAN	slimane
KANYVN	canyon
FYSK	fisk
AMAND	amand
JYNTVN	ginton
AMVS	amos
AMBRVSYVS	ambrosius
GYBSVN	gibson
KADMVS	cadmus
PANYKV	panico
ASTYPLZ	staples
DADA	dada
VVJAK	vojak
AYRDV	airdo
VARYANTS	variants
DVLYN	dolin
KANV	cano
BRYND	brind
LVN	lon
KATRYN	katrin
ASKAYT	eskite
TARYK	tariq
ALTMAN	altman
ANAGRAM	anagram
SYMYN	simin
GVRAV	gorav
BRAN	bran
ASKVLY	ascoly
BAYRN	byrne
GYLPYN	gilpin
PVNA	puna
FRANKVYZ	francoys
MVSY	musa
NAZARYV	nazario
DAVKYNZ	dawkins
RALF	ralf
ALYNGTVN	alington
DVA	dua
GVPTH	gupte
KARMVDY	carmody
FYGARD	figard
ASTAMPR	stamper
ZAZA	zaza
'BVDHABY	abudhabi
SAMAH	samah
FYN	fin
AYSAKS	isaacs
VYVYK	vivek
ANRYK	enric
ALYZA	alisa
ATKA	atka
MVRALT	muralt
NYDH	nida
DVBYNYN	dubinin
FARYHA	fariha
MVTVRZ	motors
BAKYR	baqir
ALFVRD	elford
MAMFVRD	mumford
LAYVSAY	livesay
AMANV	amano
HARATZ	haratz
AYSKANDR	iskander
NYVKVYST	newquist
MVRYN	morin
ANDRYAS	andreas
SKYVRYTY	security
AVRBN	orban
SYT	sit
SAYKS	sikes
KLVB	club
AYNS	ines
TAMATYVS	tomatius
MVNKZ	monks
JVDAS	judas
FRASTY	frosti
ASKVLY	scully
MANDAL	mandal
PAYPR	piper
MYGVYL	miguel
MARYSH	maryse
PARSVNS	parsons
MARTYJNTJH	martijntje
FAVZY	fawzi
HARYNKAR	harincar
AYVRY	ivery
KAM	kam
AYLYS	eyles
YAMN	yumn
ANTRAPY	entropy
LVDVRF	ludorf
KASYNSKY	kosinski
PRAPYS	prupis
AYLKA	ilkka
JVAN	juan
VYGSTVN	wigston
ASKVLY	ascoly
AVLSVN	olsson
LVRA	lora
HVRKAN	horkan
BANYTV	bonito
DYVYA	divya
ASTRY	stray
MVTVRZ	motors
KARLKVYST	karlquist
PVSV	poso
ABRAHAM	abraham
ARY	ari
KAVH	kave
PARTVN	parton
KAVH	kave
BAB	bob
AGATY	agate
KVYRYN	querin
ANDR	andr
HARPVLD	harpold
AVBYD	ubaid
AMNA	amna
HANKH	hanke
MARTYNTJH	martyntje
ABST	obst
KVNYNG	koning
RYHANA	rihana
AMYT	amit
VYRCVAL	virtual
MVNK	monk
JVBAL	jubal
LVKV	loco
PADVLA	padula
HYVM	hume
PANGBVRN	pangborn
BRYANT	bryant
BAS	bas
BYPYN	bipin
ASPYRYNG	spearing
AYRAY	airay
MVK	mok
ZARYH	zaria
HANKH	hanke
BAP	bop
BASKAR	baskar
HAPKARFT	hopcraft
JANSJH	jansje
KVZV	kozo
RVSTAD	rostad
BAYLA	bayla
SYRVYZ	sirois
TAMY	tomi
JVAY	juay
KARPLAS	karplus
AND	and
MVSY	musa
BYRK	birk
KVSTA	costa
ASPVLARYC	spolarich
TALMY	talmy
BVLVS	bulus
JYRMASKA	germuska
PARHAM	parham
GVNNA	gonna
MYRTY	mirti
KVYL	coil
KRASYK	krasic
NVKV	noko
SARMA	sarma
BRVZ	broz
KRYSVJYN	krisoijn
HYLSVN	hilson
SAMVN	sumon
DAL	dal
PYRAVAT	pirawat
MYLNVR	milnor
KRAYG	kraig
RABYJN	robijn
FRYTS	frits
HAYN	hine
MANSYL	munsil
HYKARV	hikaru
KLAVDY	claude
BAPTYST	baptist
RVYAL	royal
KAZVNVZY	kazunori
BAJVA	bajwa
ALTV	alto
MAHA	maha
ALDYN	eldin
FARAGV	farago
PVRTNVY	portnoy
GVSTAV	gustav
BLANSTAN	blanstan
SANTSBRN	sansburn
SAKLAD	saklad
LAVANDH	lawande
ASTYVZ	steves
DVRMA	dorma
DVA	dua
YANGY	yangi
BAJVA	bajwa
ZARVS	xaros
PRATVL	pratul
SAMBVLYK	sambolec
FVN	van
PRYTZ	pritz
DART	dart
FAYYZ	fayiz
JVHANSVN	johansen
MYNTZ	mintz
LAYKZ	likes
FRYTS	frits
KATRYNTJH	katryntje
SASAKY	cacace
BRYGVY	bryguy
GVAN	guan
HAVVLA	havola
BAR	bar
PASKV	pasko
HVNG	hung
RVSA	rosa
PYNYAN	pinyan
KRAYG	craig
KVRAM	coram
ALMYNTAKAH	almintaqah
AMYT	amit
ASTRADR	strader
DNVKS	denux
JAST	jost
RABY'H	rabiah
RVYAL	royal
BVDV	bodo
ASTRVK	strock
MAYV	mayo
KANYVN	canyon
YAMN	yumn
A'LY	aali
ASVALD	oswald
'BVDHABY	abudhabi
HYRAY	hirai
AVRN	orne
BVLDT	boldt
LYDVR	lidor
KVYNT	quint
TVLYV	tulio
DYDA	rida
FLYVRY	fleury
SVDARMV	sudarmo
LALKYN	lulkin
BARG	burg
LYMBVRG	limburg
TVM	tom
D'A	dua
MVNYZ	muniz
HASAKAH	hasakah
KVNVPKA	konopka
HYNZ	hinz
KVRY	kory
FRAYDMAN	friedman
KRASBY	crosby
PAPLASKAS	paplaskas
BYN	bin
KNVB	knob
BARLAS	barlas
FARAG	farag
KANYA	kania
SVAMY	swamy
KAPRAL	kapral
LABRYVLA	labriola
HAKABAY	huckaby
ARASMVS	erasmus
DASYVK	doseok
DAYR	dyer
NYMTZ	nimtz
ALYLYVNAS	alelyunas
SANRAYZ	sunrise
GVADA	gouda
BAKAYA	bakaya
JVHANSVN	johansen
BVDRA	budur
FRNASYSKAZ	frnaciscus
SAKAYV	sakaue
BRAYD	bryde
TANTVN	tanton
SVAGATV	swagato
SYT	sit
ANTAL	antal
BARVN	baron
KAMPAGNA	campagna
BRANT	brunt
MVTYSV	mutiso
DYSMVND	desmond
LVBV	lobo
ASTYGBRG	stigberg
BVHL	buhl
DYL	dil
DVLAN	dolan
ALAYN	alain
AVL	owl
RVHN	rohn
TVAMA	tuama
KARBALA	karbala
RVMYG	romig
FANGVS	fungus
GAY	guy
KVRNZ	corns
JYN	jin
MAYK	mike
AGRAVALA	agrawala
VYVYK	vivek
HAVYS	howes
SANTVS	santos
MVNAKV	monaco
KVSKYMAKY	koskimaki
BADYG	budig
YARYAN	yaryan
DVDAMANY	dodamani
BVRAD	borud
DVAN	duan
ASKATV	scotto
LYZA	lisa
HARALD	harald
BALBYR	balbir
ALVARVS	alvarus
ABYA	abia
SYTRAH	sitrah
LYNKVLN	lincoln
AGATY	agate
ADKYNZ	adkins
MAYLN	milne
TAYJMN	tijmen
VYVLA	viola
YVNYZA	unaiza
GYLPYN	gilpin
FRANSYNTYH	francyntie
MARTY	marty
DYAMANTARAS	diamantaras
ANAYLYN	anilane
MYLGRAM	milgram
KAYNY	caine
DVAN	duan
DVRAND	durand
SARNA	sarna
ALFANSV	alfonso
AYGRTVN	egerton
SABYNY	sabini
PYLAZV	peloso
AYVA	iowa
BLASK	blask
AVRFYVS	orpheus
HVNG	hung
MAV	mau
VAYMN	wyman
VYJBRAND	wijbrand
AVALD	ewald
AVTVLYNY	ottolini
DVGAN	dogan
JAGARD	jagard
TAYLBRY	tilbury
DHAMAR	dhamar
RAKYKVT	racicot
DADH	dade
ASTVK	stock
KARP	karp
ASLVMN	sloman
ALYVT	eliot
BANGARTZ	bongarts
PADVA	padua
GYL	gil
LVBV	lobo
TRYSY	tracy
KVHAN	cohan
KAV	cao
RAMVLVS	romulus
VYLADVT	viladot
KLYFT	clift
FAYZ	faiz
DVNAY	dunae
KVDAMAH	qudamah
'LYMA	alima
YARLA	iarla
BYAN	bian
DANGYV	dongyu
MAYZ	mize
KAMAMA	camama
TAHARA	tahara
JYNTVN	ginton
KAYAK	kayak
SVRAB	sorab
KLBAY	kilby
GVYN	gwin
TVNG	tung
AVYS	avis
GVYKARYS	geocaris
VYDAD	widad
MVRLAN	morlan
MARYNV	marino
BRYJ	brij
FVNYVK	foniok
NYMTZ	nimtz
GRVHVL	grohol
LAVZAK	lauzac
LAVD	loud
LVDVVYKAS	ludovicus
AMARYT	amarit
S'YDH	saida
VAYNTH	wyntje
DVNAY	dunae
RYNG	ring
KVRVYN	corwin
AMANY	amani
HYLSVN	hilson
JANA	jana
SVLAR	solar
SANTSBRN	sansburn
VANG	vang
ABYL	abel
NAYA	nina
KAY	kai
ASTRADR	strader
ALMYNTAKVA	almintaqah
AYRLAYNZ	airlines
KRAYG	craig
KYAT	kiat
GRAV	grov
GASKVYYN	gascoyne
ADAMV	adamo
BANGARTZ	bongarts
TRAVN	trown
PARKZ	parks
FAGAN	fagan
LASTRY	lustri
DYSMVND	desmond
TAMARA	tomura
KAMAL	kamal
ALAYS	elyse
AYSTYN	istian
SADYVP	sudupe
KARLTVN	carlton
MKGVYRK	mcguirk
BARVNYA	baronia
DRVDYNG	druding
BAGAY	bugay
ZVRYNK	zurink
DVNG	dong
JYSVZ	jesus
AVKRAYN	ukraine
TAKSBRY	tuxbury
KAPSVN	kapson
DANKV	danko
KRAYDR	crider
MADYS	madis
MVBAY	mawby
BRAVNYNG	browning
AVZMN	ozmen
PVYNTYNG	poynting
MVN	mun
BRVNYYV	bruneau
MARZ	marz
SVSA	susa
AMARAL	amaral
MAYR	myer
AL'YN	alain
HYNTVN	hinton
DVRDAL	dordal
GLASYYR	glacier
NAZARYTYAN	nazaretian
KAMPVS	campos
LYVYV	liviu
HYNTVN	hinton
TAMPAS	tampas
RVSANA	rosana
BASMA	basma
GRAV	grau
MAVPYN	maupin
AYZV	izzo
BYATLYNG	beutling
PATRVKLVS	patroclus
HASBY	husby
DABVYS	dubois
ABYAD	abiad
RADAK	radek
VARYANTS	variants
LYMYNG	liming
VYK	vik
JAST	jost
VYVKS	vieux
AKVNA	acuna
ANDRVS	andrus
KATY	kati
VAVDRY	vawdry
DVRVYN	dorwin
DVRFMAN	dorfman
VYK	vic
LAZARA	lazara
BVLDVYJN	boldwijn
MAK	mak
MATSVDA	matsuda
KLAVDYA	claudia
MADYV	madeo
JVZY	josi
MVNTANARV	montanaro
AYVLYN	evelyn
MARKVPVLY	marcopoli
GVRV	guru
BRAYD	bryde
AKYHYKV	akihiko
LAMARK	lamark
SVHAS	suhas
DAY	die
SVLYTAS	sotilas
MAR	mar
ADRYS	idris
FAYNLY	finley
GVRYK	gorik
MVNYZ	muniz
HALM	halm
LYNDZ	lynds
SVLVMVN	solomon
KVAST	kwast
BYNG	bing
JARVALA	jarwala
VAJDYK	vajdic
TAYRAY	tierie
FARAG	farag
BYLAL	bilal
LYNDGARD	lindgard
DVSTALYK	dostalik
AVTJH	oetje
KLAVDYA	claudia
ASKLVYR	sklower
KAVYTA	kavita
AKYLAH	akilah
KAPSVN	kapson
FVNYVK	foniok
FRAYDA	frieda
LAMASTVS	lamastus
PYNYAN	pinyan
HVRSFVRD	horsford
HVRVAT	horvat
MAYRS	myers
ALVARVS	alvarus
TAMPKYNZ	tompkins
RVBVZ	roboz
LVKV	loco
BRANT	brunt
KLAYTVN	clayton
AYSKANDR	iskander
ASTARKY	starkey
NYVYSVN	nevison
AYSRT	israt
LALKYN	lulkin
PVGVSYAN	pogosyan
RYDKVYST	rydquist
MVNTANARV	montanaro
GRAH	grah
BALDYNGTVN	baldington
AYT	ait
MVNTYJV	montijo
KRYSTYAN	kristian
KALAFATAS	kalafatas
HVGAN	hogan
AYNTJH	eyntje
SVRYN	sorin
MYNKY	minqi
'LYMA	alima
KYNGFAY	kingfai
BYAVYS	beavis
VYNTJY	wyntje
GLDASTYYN	goldsteen
ANAND	anand
AYNMN	inman
SAKAYV	sakaue
BAS	bas
LYBRYK	librik
'LY	ali
AVLA	olah
MYLVARD	milward
SVDARMV	sudarmo
GALAHAD	galahad
DVLAN	dolan
MAYRYK	myrick
MARALY	murali
FABRYS	fabris
KVNYNG	koning
AMAL	amal
KVBV	cobo
MASARA	masaru
JVRY	jory
MAYTAG	maytag
ADMYRALZ	admirals
DADGYVN	dudgeon
KNVFYNKH	knufinke
SVLY	soli
ARMSTRANG	armstrong
KVRL	corl
DVHA	duha
KYNGSFVRD	kingsford
SVRVALY	sorvali
SAMAH	samah
FALTVN	fulton
DVBVYS	dubois
DAY	day
KVYALYK	kowalik
DRYNKS	drinks
KALPANA	kalpana
SAVSAN	sawsan
SYMVNH	simone
GVSTAVVS	gustavus
GVRV	guru
LVBV	lobo
BVYRKVYL	boerkoel
KRAVSVN	crowson
AKYTVMV	akitomo
ASTVK	stock
AKLVF	eklof
NYD	nid
BAP	bop
VYNDVM	windom
BRYND	brind
ASTRADR	strader
AYRDV	airdo
ASPYTZR	spitzer
DYMYTRYVS	dimitrios
SYNKLARY	sinclair
BAT	bat
LAMASTVS	lamastus
BAY	bai
TVKYV	tokyo
AVGVRY	aogori
AYNANA	inanna
FAYRBANK	fairbank
BVZKART	bozkurt
ASTYPLZ	staples
NYNJA	ninja
AND	and
PRATVL	pratul
DABYNSVN	dobinson
GVRAPARTAP	gurupartap
ASTARKY	starkey
ASKARS	scarce
PANKRAS	pancras
HARVHYSA	haruhisa
RVHAN	rohan
KLYFTVN	clifton
MARTY	marty
ANJYLYNY	angelini
ADARA	edara
DAVNYNG	downing
KVDAMAH	qudamah
DVNATV	donato
DVLMAN	dolman
MATAKV	matako
KVYL	quel
CAYLDZ	childs
BAGDAN	bogdon
ASTARGS	sturges
VYKTVR	viktor
ASKATY	scotty
BABAR	babar
JYBSVN	gibson
MYMAS	mimas
SYANG	siang
NAVYA	navia
KVANG	kwang
SAGARS	sugars
ALVYN	elwyn
AYLVR	aylor
YAV	yaw
RYVARD	rivard
KASPRZAK	kasprzak
KADMVS	cadmus
MVRTAN	morton
VYDAD	widad
KYNYVN	kinyon
VYBVVV	wibowo
KAMPAGNA	campagna
KLAG	klug
BRYDY	brady
PARSVNS	parsons
FAYNRTY	finerty
JHANG	jhang
ASKYN	skean
ASKYPY	skippy
BYLHAR	bilhar
SASZH	sasze
DYGAN	degen
RAHVL	rahul
DRAGAN	dragan
DRVDYS	drudis
MARKVM	marcum
ANSYH	anisa
BARNAM	barnum
MARTYJNTJY	martijntje
MARYNV	marino
DARBY	darby
KRYSTYAN	kristian
BARNABY	barnaby
KAGBVRN	cogburn
ADYH	adie
VYPYN	vipin
NYHALANY	nihalani
PYPVNY	piponi
GALAHAD	galahad
NYVARK	newark
KAMPAR	kompar
BASV	basu
MARANY	marani
AMAL	amal
LAYNG	laing
KRH	kre
PARSVNS	parsons
MARKVYZA	marqueza
VARGAS	vargas
JAHMANH	jahmane
DAYVYN	divine
ASTANGYR	stangier
KALYA	kalia
RYM	rim
AYTCVN	itchon
ADYL	adil
BYLYNSKY	bilinsky
LVJYK	logic
TANTVN	tanton
ABVLYN	abolin
MATSVDA	matsuda
MVMFVRD	mumford
SYVN	sune
DYKSN	dixon
RADVF	radov
SYSLV	sislo
HYNSVN	hinson
BDYRA	bdira
JVAN	joan
VYLADVT	viladot
GARDYNR	gardner
