RVSTAD	rostad
DANKV	danco
ASTVRR	storer
FVNYVK	foniok
MARTYJNTJY	martijntje
KALHYNH	culhane
AVRKNY	orkney
KLAYN	klein
ASTARGS	sturges
RAKVN	rukan
KARLKVYST	karlquist
AVLSVN	olsson
AMYT	emit
JASTYH	justje
GVYYN	gwynn
GARYTV	garito
DYMYTRY	dimitri
AYTCVN	itchon
BALTAYS	baltais
AVANZ	evans
GASKVYYN	gascoyne
ANATVLY	anatoly
DYNG	ding
ANTVNY	antony
FADYL	fadil
LAL	lal
DVK	doc
BARKASFYLD	barksfield
VYVLA	viola
TAYLV	thilo
LVSY	lucy
LAYVY	liewe
SYRYL	cyril
AYZAK	isacq
ANAYLYN	anilane
AMNVN	amnon
SVL	sol
NYKVLYK	nikolic
HAVTYN	hawtin
SYDVR	sidor
RADVF	radov
AFAF	afaf
FRANKVYS	francoys
ASTYLZ	stiles
VAN	van
KVYN	quin
PVSV	poso
ASTYNBRG	stenberg
BARTVLYNY	bartolini
LYZARDZ	lizards
LAYNG	laing
PAYK	pike
LAV	lau
FRANKV	franko
VYNTJY	wyntje
KYALASA	kailasa
ABYAB	abiab
LAY	lai
KALAFATAS	kalafatas
DVBSVN	dobson
BVM	bum
HRLAYNDYZ	herlindis
ASPVSYTV	esposito
MYTRVVYK	mitrovic
JVAN	joan
LVS	los
JVBAL	jubal
ABST	obst
YASYN	yasin
DVBYNYN	dubinin
RYHANA	rihana
BRYYTVN	britton
MADYS	madis
DRAM	drum
ABDVN	ebdon
AMBRVSYVS	ambrosius
KASYNSKY	kosinski
AKMAN	ekman
FARAG	farag
ASPAT	spath
ASNL	snel
ASTVN	stoun
LAYVSAY	livesay
KATLYR	cutler
ZAKY	zaki
AKVNA	acuna
VANSY	vance
DRYDJY	dridge
KAV	kao
JANG	jong
AMYHAY	amihai
KARA	kara
ALDZ	olds
BRYJ	brij
PALVMBV	palumbo
NYPTVN	napton
MVRANV	morano
MVRTVN	morton
BYAN	bian
JANSKY	jansky
SYDVR	sidor
BAKSKA	bocska
ANJY	engi
HASYK	husik
PADYAL	padial
HVRN	horn
BVNAR	bonar
VYMPYJ	wimpje
ASMA	asma
GVYKARYS	geocaris
AVRAHAM	avraham
SVRAB	sorab
JAGV	jago
ANVJYT	anujit
ALMYNTAKAH	almintaqah
VYVLA	viola
KARTY	karty
SABRAMANYAN	subramanian
SVHM	sohm
KYRK	kirk
DANGYVN	dungeon
LYSTVN	liston
DANKV	danko
MYNAMV	minamo
ADVNYS	adonis
ANTVNYVS	antonius
GAYVN	gawne
AGYL	aqil
VVN	wun
BARG	burg
AVSN	osen
TAYTY	tytie
DYMYTRYV	demetrio
ADYK	adik
MANDAR	mondor
BAJYK	bajic
RAST	rust
DAMVN	damon
LVYD	loyd
'ADL	adel
TVMY	tomi
APSTVN	upston
DABYNSKY	dubinsky
DYMYTRY	dimitri
PATRYSYA	patricia
LYND	lind
TVYN	twin
DVSTALYK	dostalik
ARAYZ	aries
KVBSA	kobsa
AMARDYV	amardeo
VYKAS	vikas
ASTRY	stray
BLAHA	blaha
GVDSVN	godson
AMVS	amos
BVSTAK	bostak
AYDVAYSVZ	ludovicus
YANG	yang
ALVYN	elwyn
RVNY	roni
AYZDY	izadi
ARNVT	arnot
VYSKA	visca
KVMPTVN	compton
ANTVNYV	antonio
RVSANA	rosana
HAMYLTVN	hamilton
SVNDARAM	sundaram
KAZY	kazi
SYRYL	cyril
RAFALKV	rafalko
BYRK	birk
ABY	ebe
GASTA	gosta
ABVBA	aboba
LYMYNG	liming
SAMANTA	sumanth
GAYNVR	gaynor
KRYYK	creek
NYMTZ	nimtz
HADSVN	hudson
HANTYNGTVN	huntington
AVRFYVS	orpheus
ANBAR	anbar
KYV	kao
HAKABAY	huckaby
PVPAT	popat
KAYA	kaya
KAVYTA	kavita
KARL	carl
ALBAHAH	albahah
MVKASA	mukasa
BALBYR	balbir
PATRYSYA	patricia
BATRA	batra
BARG	burg
MASKARY	mascari
KYKVMA	kikuma
TAMPAS	tampas
ALKS	alex
PVRTNVY	portnoy
VYLKYNSVN	wilkinson
AYVLYN	evelyn
KAKYVR	kakure
SVRANA	surana
PARKZ	parks
LAYVRYTSN	lauritsen
FAYRBANK	fairbank
LYVAYN	levine
RYHANA	rihana
KASTVRY	kasturi
HAV	haw
ABRAMSVN	abramson
ADVARD	edvard
ASMYRNV	smirnov
RAMBV	rambo
MARK	marc
KVYNRYDVS	coenradus
FARAG	farag
AMAL	amal
MARGVLYN	margolin
SVLAR	solar
ASKRYV	screve
PAYNTVN	paynton
AVZMN	ozmen
ARAM	oram
LVKAS	lucas
NYHALANY	nihalani
AMLAK	amlak
AMY	amy
PVYNTYNG	poynting
KAMPTVN	compton
LYTLY	lytle
GYLPYN	gilpin
VYLKYNSVN	wilkinson
GRAV	grau
SRAYNH	shryne
DYSMVND	desmond
SAMBVLYK	sambolec
AVYAN	avian
BASYLYKA	basilica
BVHL	buhl
PARMAR	parmar
MVNDFRANS	mondfrans
SYLVYV	silvio
VATKYNZ	watkins
DYVYD	david
PYRVZ	piroz
AYRYZARY	irizarry
DVLYN	dolin
FRANKV	franco
LYN	lyn
MYN	min
DABAS	dubuc
LYNKVLN	lincoln
MARYH	murie
ANTRAPY	entropy
MARAZAS	marazas
TYNA	tina
KVL	col
RVSA	rosa
HAYD	hyde
SVSYA	sucia
JAG	jog
HAYN	hain
RASTRAM	rostrom
AYVNS	evens
ADRYS	idris
ASLVN	sloan
FRANSYSKAS	frnaciscus
GALY	gali
AYSKANDR	iskander
HALM	halm
HAVKYN	hawkin
JYBSVN	gibson
PRYVR	pryor
HABVRA	habura
KAPYLA	kapila
FRANKV	franko
MS'VD	masud
AVYS	avis
HYVKYNZ	hawkins
BYNG	bing
MVGANTY	moganti
GVLVMB	golomb
MAYR	mayr
MATANA	matana
AVMGA	omega
VYDAD	widad
NAVYA	navia
FRAYDY	friday
MANKVS	mancus
NVTZ	notz
LYBLYT	liblit
SARMA	sarma
PYRANY	pirani
AMYT	amit
BALBYR	balbir
BABYTZ	babitz
KATRYN	katrin
DVNALD	donald
KVDY	cody
KVMVRV	kumoro
ASPRVT	sproat
RALF	ralf
BRYJ	brij
DAYBALA	dyballa
ASLYV	slave
MYLKS	milks
NAZARYV	nazario
KRANSVYYK	cranswick
NAS	nas
KRYSTYN	kristin
BLVZVM	bloxom
MKGVYRK	mcguirk
TVMY	tomi
MARYSH	maryse
AMBRVSYVS	ambrosius
ASTANGYR	stangier
MKMANYS	mcmanis
'BDVL	abdul
ALMAR	elmar
ASPVTYS	seputis
MVNS	muns
LYTLY	lytle
MARYANA	mariano
GVRYS	goris
KYVSMATV	kusumoto
JAYAN	jayan
TVMY	tomi
NYKVLAS	nicolas
VAYLDR	wilder
JANVTJH	janotje
HAVN	hawn
YAMYNAH	yaminah
ASTRAP	strope
BVNYN	bonin
SYVNKA	cionca
YASYRAH	yasirah
AYVA	iowa
GVRVYTZ	gorwitz
AVYRSA	aversa
ASTRYDR	strider
AYSKANDR	iskander
KYMVRA	kimura
DAMYNYKAS	dominicus
KALA	cala
SVZY	suzy
TABVK	tabuk
ATV	oto
ANJYLYNY	angelini
NVKV	noko
AKYL	akil
ASLVN	olson
BARTHVLVMYVS	bartholomeus
LAMYKYN	lamykin
KARPLAS	karplus
ADRYS	idris
TANYS	tanis
KATVALA	katwala
RVNDH	ronde
ZVRYSYKA	jurisica
BYKSLR	bixler
SAMVYL	samuel
VYSPY	vispi
MANTVR	mantor
HAGA	haga
RAYDAH	raidah
GRANVYN	granvin
MVRAS	moras
LVRY	lory
MYKAYL	mikael
HADRAMAVT	hadramawt
'LY	ali
LADVVYKA	ludovica
AYNS	ines
GANSVN	gunson
KVRAM	coram
LVYYNG	luinge
BVKSY	buxey
ABAD	abad
FADVR	fodor
MVNTALBANV	montalbano
KARN	karn
PAPLASKAS	paplaskas
KLATZ	klotz
PAKS	paks
SANRANG	sunrong
ALMYNTAKVA	almintaqah
ALYMA	ulima
KVYL	quel
FYASKVNARV	fiasconaro
DYNG	ding
LARSVN	larson
PANKRAS	pancras
DAVSAN	dawson
ALANA	alana
MADYS	madis
MYZYRA	mizera
ARNVLD	arnold
SVAGATV	swagato
RAYSTLYN	raistlin
MYNARD	menard
KYAT	kiat
DYK	dik
AYSLYK	icelic
FRAMSVN	framson
RYJSVYJK	rijswijk
KARLAYL	carlile
NYDH	nida
LANA	lana
PVLYNG	poling
KVL	col
ADMYRALZ	admirals
MALAN	malan
LANTZ	lantz
BYLYNGASLAY	billingsley
LVND	lund
LYSY	lacy
PVALMA	puelma
HALAT	halat
BAKAYA	bakaya
DVBRYZ	dubris
LVYD	loyd
'BDAL'ZYR	abdulaziz
PADVA	padua
GARMZ	garms
GRAH	grah
ASLYMAN	slimane
RAV	rao
ALYVA	oliva
AFYF	afif
BASYLYVS	basilius
LYLA	lila
GASLYNG	gosling
KVRVYN	corwin
BRVNYYV	bruneau
VYNATA	vinata
KVL	col
DATSVN	dotson
ASTK	stec
HARMANVS	harmanus
PAPAY	papay
GNAGY	gnagy
JAYARAM	jayaram
BALYGA	baliga
KRYSVYJN	krisoijn
BAABAR	baabar
CAYLDZ	childs
LVM	lum
AYSRT	israt
AKMAN	ekman
AMADVR	amador
MYNYARD	minyard
YARVN	yaron
LVDVVYKAS	ludovicus
ASKY	skee
VYNSTVN	winston
ANAY	anay
ANDRYS	andres
ANDRYS	andres
NAM	nam
DRAGANYS	draganis
RANY	rony
MVNTA	monta
ADVARD	edvard
FRANSYSKAS	frnaciscus
LVSY	lucy
ALKSY	alexy
BASKY	bosky
AFYF	afif
PRYSTVN	preston
BASTYVN	bastion
DYVYA	divya
SYRKVYS	cirques
RAYSL	risel
LAYL	lyle
AYSAKS	isaacs
BVRM	borm
'BDAL'ZYZ	abdulaziz
PVNA	puna
BVDA	buda
DYANA	diana
NAVYA	navia
DYZVN	dizon
MADYGAN	madigan
GARYTV	garito
JVDY	judi
DVRYNDA	dorinda
NYVMAN	newman
ATRY	atri
BLAZ	blaz
ASTAMPR	stamper
HASKYNZ	hoskins
LYVAYN	levine
SYDVR	sidor
ADVVART	eduwart
LAYVSAY	livesay
ASKVAYRL	squirrel
HARBVD	harbud
AVANZ	evans
ASLAVK	slawek
HAVTYN	hawtin
BRVDA	broda
MATAKV	matako
VAYMN	wyman
SALVMVN	solomon
RYTYSGRT	ritsgert
KRAVN	crown
BASTYK	bostic
FYGARD	figard
ALKYNGTVN	elkington
AGALY	agali
ADNAMZ	adnams
KART	kurt
GRAH	grah
GVRASPY	gorospe
LVSTY	lusty
MVRYN	morin
GRAV	grau
ASTARYNGR	staringer
HVRGAN	horgan
ANTRVSYV	antrosio
FAYRBANK	fairbank
AVNAYZ	unaiza
RAMVS	ramos
ANYART	enyart
AYSYZAKY	ishizaki
BLAVADNYK	blavatnik
LKS	lax
LVKAS	lucas
HYSLAP	hyslop
AYRLAYNZ	airlines
ZVRYNK	zurink
KVN	kon
LATKYNZ	lutkins
KVBYLAH	qubilah
ALMKVAST	elmquist
DABSVN	dobson
HARTYGAN	hartigan
PVYSL	poisl
ASPARNDAM	spaarndam
KYNGSFVRD	kingsford
MARLA	marla
PYYRY	pieri
GRABNAR	grabnar
ALKAN	elkan
KVYNT	quint
TVYDA	toida
PYNTVN	pinton
MVRAVAN	moravan
LAMYKYN	lamykin
JASTYN	gustin
FYRMA	firma
GALV	galo
BVNYN	bonin
TVYDA	toida
BAT	bat
DVYNYNG	duening
LVAYNJ	luinge
SANYL	sunil
LVMBARDV	lombardo
FYNSTAD	finstad
ASTRYDR	strider
HARALD	harald
ASTAMPR	stamper
MVNAKV	monaco
LAMYKYN	lamykin
AMY	amy
RAMA	rama
NYKVLYK	nikolic
BYKVN	bacon
KYVNG	cuong
VYLKYNSVN	wilkinson
VYLJV	viljo
FLARDYNGA	flardinga
DVMBA	domba
BARG	burg
ARFYVS	orfeus
ATKYNZ	atkins
RAKYKVT	racicot
SANTA	santa
MYNGV	mingo
RAV	rov
ALGAYN	olguin
PVLYYAM	pulliam
JAKVBZ	jacobs
BYN	bin
ASLVMN	sloman
TYNA	tina
RYVPKA	riopka
JVDY	judi
MARV	marv
KRYSTYJNTJH	kristijntje
NYTYN	nitin
ALSVN	elson
PARSVNZ	parsons
BLANZDVN	blunsdon
DYVAR	dewar
ARVNAH	arunah
ANAGRAM	anagram
AYSYZAKY	ishizaki
AVYARS	oyarce
KATZ	katz
ASKVLYN	scullin
ALVA	alva
ALAYN	alain
ASTYT	stith
AKYHYKV	akihiko
BAKAYA	bakaya
SAKSYM	saxnem
AYRL	earl
SAMYT	sumit
PZARAYS	pezaris
ASMAYT	smythe
AYLYN	ileen
AVT	ott
ABA	aba
KAYNY	caine
HASYK	husik
ZAGAR	zagar
SRAYNH	shryne
AKYHYKV	akihiko
KARPLAS	karplus
KRANSVYYK	cranswick
BABAH	babah
LYRYK	lyric
ASKVYVYL	esquivel
RVBYNSVN	robinson
AVAN	awan
BRYTA	brita
BRAHYM	brahim
MARY	mury
PYPGRAS	pipgras
ASTVVAL	stovall
BLYNKV	blinco
DAVT	dout
DYVAYN	divine
AMANV	amano
HARYHARAN	hariharan
PRAYVN	priven
ASKRNTVN	scranton
MARTYNTJH	martyntje
RVSTAD	rostad
ANALVG	analog
JYBSVN	gibson
AGVYRV	aguero
RVSV	rosu
TVLAY	tully
KVSYRA	kucera
MYMY	mime
MABAY	mawby
MATLV	mutlu
LALYT	lalit
MARGARYTA	margretha
AJAY	ajay
YANG	yang
LVYYSALY	loiselle
MANKA	manca
JAN	jun
HALPYN	halpin
AGYLA	aqila
LYNDAL	lindal
RYSLYNG	rysling
HARBVR	harbor
AYMAN	ayman
LVK	lok
RAYLY	raile
TAPTANY	toptani
GAS	gus
FRAMSVN	framson
GVYN	gwin
GAVYND	govind
ASTYGBRG	stigberg
BRVKSL	brooks
RABYDYAKS	robideaux
ANVN	anon
SYANG	siang
KRYSJH	krisje
TKS	tex
PRYSTVN	preston
TYVNYS	teunis
VAYD	wide
PATRYZYV	patrizio
'QYL	akil
JAMVNA	jamuna
LYZARDZ	lizards
LVS	los
HYJDAN	higdon
BRVANHAT	braunhut
VYMAL	vimal
TYMVR	timur
GNVSYS	gnosis
DYMYTRYV	demetrio
TRAFTVN	trafton
ANSKAMB	anscomb
ANVS	enos
BAVM	baum
RVBYN	rubin
SABHANY	subhani
FAVST	foust
BVNYN	bonin
FATYMA	fatima
KYPLYNG	kipling
MARLA	marla
SVSYA	sucia
PYVN	pion
AYSAN	eason
DVSKV	dusko
ZARA	zara
MVRAY	moray
ASKATY	scotty
BYATLYNG	beutling
ASKYN	skean
MARKVS	marcos
AVKSVL	oxwell
BYSAYV	bissau
PYRVZ	piroz
DABYNSVN	dobinson
SAVARAM	savaram
KRYSJH	krisje
FVNKY	funky
KAMPAGNA	campagna
DVMYNYK	dominic
TRAYNTH	tryntje
KANYS	canis
JVZA	juza
KAPRAL	kapral
FRANKLYN	franklin
AYLYN	ileen
ANJLYSYA	anglesea
BASYLYKA	basilica
PANKRAS	pancras
JVANA	juana
JABJH	jobje
MARVYT	marvit
ASTNKAMB	stancomb
TAD	tad
SYMSYK	simcik
PVGA	puga
ASTRYDM	strydom
LATKYNZ	lutkins
DVNG	dong
HADRAMAVT	hadramawt
AYSLT	iselt
RVBYNSVN	robinson
PYAK	paik
BYRNH	byrne
'LY	ali
KALBYDA	kulbida
ALKSANDRVZ	alexandros
MARTY	marty
PABLV	pablo
ALVYN	alvin
NYKVLYK	nikolic
LANDGRYN	lundgren
DYAZ	diaz
LABDVN	labdon
SAYTZ	sites
ALYN	olin
TVLY	tuli
HAYNS	hines
JVLY	joly
FRYNK	frink
MAHAJAN	mahajan
PYSTVN	pistun
RAVT	rout
KVYN	quin
MYMY	mime
KVBLA	kubla
DVBRYKYN	dobrikin
BALKA	balqa
ASPYTZR	spitzer
NANSY	nancy
FRAYDMAN	friedman
ADNAMS	adnams
ASTVRR	storer
KVYYT	quitt
PADVA	padua
SARMA	sarma
KARL	karl
MVNYZ	muniz
HVDAYDAH	hudaydah
KVYST	quist
MARKHAM	markham
PAYPR	piper
BAJYK	bajic
KVSMAS	cosmas
HYLSVN	hilson
AKGAN	akgun
AYSAK	isaac
MAK	mak
GASTYN	gostin
YVRMV	yermo
MYLGRAM	milgram
TVNY	tony
MASKARY	mascari
VARDY	vardi
FADL	fadl
BRYSBYN	brisbin
KALVYN	calvin
SAKAMVTV	sakamoto
ASPARNDAM	spaarndam
SANRANG	sunrong
KYLBY	kilby
LANTZ	luntz
MATVLA	matula
TAHRYHA	tahirah
KRANSVYYK	cranswick
RAYSL	risel
AYNGRM	ingram
JANARDHAN	janardhan
TVLAY	tully
LVK	lok
VLADAN	vladan
KARDYNALY	cardinali
ASK	ask
LYDYA	lydia
ATV	oto
BYFRAST	bifrost
NVRY	nuri
LVSYH	lucie
KVYYNTVN	quainton
FAYYZ	fayiz
JVSYP	josip
FRAMSVN	framson
ASTRYDM	strydom
ANJYLYNY	angelini
VYRYANA	wiryana
BDYRA	bdira
KASAMA	kasama
SVTV	soto
VYZBRAND	wijbrand
DVZAT	duzat
HAJ	haj
ZARYA	zaria
RALF	ralf
BVRG	borg
DARHAM	durham
KYLBY	kilby
HAYN	hain
RVKAN	rukan
AYGLV	igloo
GABARA	gabara
KALAHAN	calahan
JAMVNA	jamuna
ARVNAH	arunah
KARMVNA	carmona
AYZAK	isacq
DANAVAN	donovan
ARNH	arne
TVNY	tony
DRAM	drum
AKVSTA	acosta
AYVRY	ivery
DYNA	dina
APLYN	aplin
KARNYA	carina
RANKYN	ronkin
HAYM	hime
MVNTYJV	montijo
'QYL	akil
ABDVN	ebdon
ALAYN	alain
BALD	bald
GRYYN	green
ASTYRNZ	stearns
KRYSPYJN	crispijn
TVNGA	tunga
ADAM	adam
MVTVR	motor
DADGYVN	dudgeon
BARD	bard
SVRAB	sorab
AVBAJA	obadja
KVYSMAN	coisman
DANDAS	dundas
JANG	jung
DVRAN	doran
LASNYK	lasnik
PVHL	pohl
AVMAKY	ohmaki
DYMA	dema
SVDYP	sudip
RYDKVYST	rydquist
ZARVS	xaros
LYNDAN	lyndon
RVYZ	ruiz
BRAVV	bravo
ASPYR	speer
ASKARS	scarce
KARMVDY	carmody
MAYLN	milne
BAVDYN	baudin
AYRYS	ariss
MARYV	mario
AVZBRN	osburn
DVMYNYKAS	dominicus
MARYV	mario
ASTYN	stian
GALYZYA	galizia
SYNG	sing
MANRV	munro
MYLV	milo
DYKYNZ	dykins
DAY	duy
YAMYNAH	yaminah
FVRTS	forts
MVNTANV	montano
ASTVRY	storey
HAR	har
FAVZY	fawzi
BVYRKVYL	boerkoel
LYYVVH	lieuwe
SVLV	solo
BRYGVY	bryguy
PVTZ	putz
BASTYK	bostic
LVYYNG	luinge
JVNV	juno
JVZY	josi
HASBY	husby
VYNTJH	wyntje
GASTA	gosta
SYDVR	sidor
MVNK	monk
AVMGA	omega
LAN	lan
ALYSVN	elison
HAV	haw
PYLVYV	pilvio
LYSVN	lison
FYNAN	finan
HARKYNZ	harkins
MAYRZ	myers
ANSYH	anisa
MARSY	marcy
SVHAS	suhas
AVYS	avis
LALY	laly
TAT	tat
AGVSTYNY	agostini
TRVYYJH	truitje
LABRYVLA	labriola
HANKZ	hanks
ASLVP	slope
DANAVAN	donovan
LYNDAL	lindal
ABVLYN	abolin
MASKYAS	mascias
PRAKTYKVM	praktikum
ARAM	oram
LVFSTRVM	lofstrom
GLATZ	glatz
MVNAZ	munoz
SVDAN	sudan
TRVMBV	trumbo
DAMYVN	damion
TAYJMN	tijmen
ADANA	adana
LVTZ	lutz
BAV	bao
MVNKS	monks
MADYSVN	madison
MVLYNARY	molinari
JVHANSVN	johansen
ALYSVN	elison
HANKH	hanke
MARALY	murali
RYSAVY	rysavy
KRYST	crest
YVNYZA	unaiza
DVARTH	duarte
LAND	land
FRANSYNTYH	francyntie
RAGNVALD	ragnvald
ANPYNGKV	unpingco
BVDY	budi
MALTYN	maltin
DYSMVND	desmond
GAT	gat
LYBYD	lebed
FAYNK	finke
ASTFANV	stefano
ANATVLY	anatoly
GRYYNVALD	greenwald
ALKS	alex
KVBYLAH	qubilah
KANRVY	conroy
ASTAKR	stoker
KAKYVR	kakure
DAYR	dyer
AGYLA	aqila
AKVSTA	acosta
ZAYNAH	zaynah
HYN	hin
RABYDYAKS	robideaux
DVLAN	dolan
LVDVVYKAS	ludovicus
