AACTAY	mackay
AALTJ	aaltje
AAMYNA	aamina
AARVN	aaron
ABA	aba
ABAD	abad
ABADA	abad
ABADHBY	abudhabi
ABAJA	abuja
ABAR	aabar
ABCR	abcher
ABDJA	abidjan
ABDLRHMAN	abdalrahman
ABDVN	labdon
ABH	aba
ABHAY	abhay
ABHY	abhay
ABLA	aba
ABL	abel
ABL	abel
ABLH	able
ABLHYD	abley
ABLJ	able
ABLT	able
ABLTJ	abeltje
ABLY	abley
ABLYSN	allyson
ABND	abend
ABNR	abner
'ABR	aabar
ABR	aabar
ABRAHAM	abraham
ABRAHYM	abraham
ABRAHYM	abraham
ABRAM	abram
ABRAMSVN	abramson
ABRAPT	abrupt
ABRAYT	abhay
ABRBAC	abbas
ABRG	aberg
ABRG	aberg
ABRKRVMBY	abercrombie
ABRL	abel
ABRLY	abery
ABRMSKY	abrams
ABRT	abrupt
ABRT	abrupt
ABRVTR	abrupt
ABRY	abery
ABRY	abery
ABRYN	bryn
ABRYNY	bryony
ABSTGARTN	obstgarten
ABST	pabst
ABSTRKT	abstract
ABT	aba
ABTYN	abtine
ABV	aba
ABVBA	aboba
ABVDBY	abby
ABVDHABY	abudhabi
ABVHBYB	abby
ABVLYN	abolin
ABVRYMH	abery
ABVT	abbot
ABVT	abbot
ABVTSMYT	abbotsmith
ABYA	abyan
ABYAB	abiab
ABY	abby
ABY	abby
ABYAD	abad
ABYAN	abyan
ABYD	abad
ABY	abby
ABYL	abel
ABYLAK	abyan
ABYNA	abyan
ABYNGM	abyan
ABYNGN	abyan
ACDL	abdul
AC	ac
ACR	ac
ACRNAR	achernar
ACTY	acts
ACTYH	acton
ACY	lacy
ACYLS	daryls
ACYSVN	alyson
ACYT	acts
ADAB	adab
ADAM	adam
ADAMV	adam
ADANA	adana
ADAN	adan
ADANL	adan
ADARA	adhara
ADB	adab
ADBRG	aberg
ADGRYNGLND	adgeringelant
ADGRYNGLNT	adgeringelant
ADGYNGTVN	addington
ADH	ada
ADKAK	adisak
ADKK	adik
ADKRYK	ackroyd
ADKVK	adik
ADKYNZ	adkins
ADKYRK	adar
ADLA	adela
'ADL	fadl
ADL	adel
ADLARDV	adelardo
ADLAYD	hadland
ADLAYD	hadland
ADLHYD	adelheid
ADLMA	adalma
ADL	adel
ADLR	adler
ADLSVN	adelson
ADLY	addy
ADMVND	amand
ADMVNDS	armands
ADMVNDZ	amand
ADMVNZ	adametz
ADMYRALN	admiralen
ADMYRALZ	admiral
ADMYSTVN	edmiston
ADNAMS	adnams
ADNAMZ	adnams
ADNBRAG	abram
ADNBRG	aberg
ADNBRV	anbar
ADNBRVG	aberg
ADNBVRG	aberg
ADRY	badry
ADRY	badry
ADRYANA	adriana
ADRYAN	adrian
ADRYANS	aryans
ADRYN	adrian
ADRYNKLNT	adgeringelant
ADRYNS	aldrins
ADRYNY	adrian
ADRYNY	adrian
ADRYS	audreys
ADSAL	adisak
ADST	adit
ADSVN	madsen
ADT	adit
ADVARD	edvard
ADVARD	edvard
ADVARDSN	harvards
ADVART	adar
ADVLF	adolf
ADVLFSVN	adolfsson
ADVLF	adolf
ADVNCR	advent
ADVNL	advil
ADVNYS	advents
ADVSVMALY	adusumalli
ADVVART	adar
ADY	addy
ADY	addy
ADY	addy
ADY	addy
ADY	addy
ADYH	addy
ADYK	adik
ADYKS	andys
'ADYL	adel
ADYL	adel
ADYLRD	adelardo
ADYNA	adana
ADYNGTVN	addington
ADYNGTVN	addington
ADYS	andys
ADYSAK	adisak
ADYSVN	alyson
ADYT	adit
AFA	afa
AFAF	afaf
AFRA	afra
AFRDYT	hardy
AFRVDYT	alfred
AFTAB	aftab
AFV	afa
AFVRYL	avery
AFYCART	cathcart
AFYF	afaf
AFYGTN	afghan
AFYNGTN	alington
AFYS	amys
AFYSR	amys
AFYVN	abyan
AFZAL	afzal
AFZL	afzal
AGALY	agali
AGAS	agass
AGATY	agate
AGBRN	agren
AGBVRN	agsorn
AG	ag
AGLSTVN	agustin
AGMN	ageno
AGMVZ	gomez
AGNDY	andy
AGNV	agni
AGNVYK	cagney
AGPYAN	agopian
AGR	agra
AGRAVALA	agrawala
AGRN	agren
AGRTN	agren
AGRTVN	agren
AGRYNGLANT	adgeringelant
AGRYNGLND	adgeringelant
AGVLV	agali
AGVR	agra
AGVSTV	agustin
AGVSTYN	augustyn
AGVSTYNLY	augustyn
AGVSTYNY	augustyn
AGVYRV	agoyo
AGVYV	agoyo
AGYLA	angela
AGYL	argyle
AGYLSVN	abelson
AGYNST	against
AHAY	abhay
AHLAND	garland
AHMAN	ahmad
AHMN	ahern
AHRN	ahern
AHY	abhay
AHYH	ayah
AJ	haj
AJAST	ajaxs
AJAY	ajay
AJDA	ada
AJLVS	alves
AJNT	aint
AJRAYNGLND	langland
AJYNGTVN	alington
AJYNTVN	paynton
AKA	aka
AK	ack
AKADMY	academy
AKADMYK	akademik
AKAKS	dakars
AKAPADY	accapadi
AKBRG	aberg
AKBVRN	akbar
AKDAG	akdag
AK	ack
AKGAN	akgun
AKL	akl
AKLAND	oakland
AKLND	oakland
AKLVF	akiva
AKLY	ackley
AKLY	ackley
AKM	aim
AKMAN	akman
AKMANDNSYS	ekmundensis
AKMANDSYS	amandas
AKMAN	akman
AKMNA	amna
AKMN	akman
AKMR	akar
AKMVNDNSYS	ekmundensis
AKMY	amy
AKN	akin
AK	ack
AKR	akar
AKRM	arm
AKRMAN	ackerman
AKRMN	akron
AKRSAND	armand
AKRSLATV	ekerslato
AKRSLYTV	ekerslato
AKRSTV	akers
AKRT	art
AKRVYD	ackroyd
AKRYL	akrill
AKS	aksu
AKSAYL	assakul
AKSDLM	anselm
AKSFRD	ashford
AKSFVRD	ashford
AKSFVRD	ashford
AKSKRYTYA	fakhriyya
AKSLSVN	abelson
AKSLY	ansley
AKSS	aksu
AKSTRND	ekstrand
AKSTYN	alston
AKSV	aksu
AKSYL	akil
AKTS	acts
AKTVN	acton
AKTVN	acton
AKTY	akita
AKTYV	active
AKVAL	akiva
AKVAYLA	kayla
AKVAYL	akiva
AKVDV	akdag
AKVKS	akivas
AKVNA	akiva
AKVNR	akar
AKVSTA	avesta
AKY	laky
AKY	laky
AKYF	laky
AKYHYKV	akihiko
AKYLA	akella
AKYLA	akella
AKYLAH	akilah
AKYL	akil
AKYL	akil
AKYLH	akilah
AKYLS	daryls
AKYM	akeem
AKYN	akin
AKYTVMV	akitomo
AL'ADYN	alaaldin
ALAHAYDYKYA	galahad
ALAHDVD	alhudud
ALALDYN	alaaldin
AL	al
ALAM	alamo
ALAMZ	alamo
ALANA	alana
ALANGKV	alan
ALAPATY	alapati
ALAQBH	alaqabah
ALARD	allard
ALASR	alar
ALASVRS	alars
ALAVAY	allaway
ALAVY	galbavy
ALAYN	alain
ALAYSDYR	alaisdair
ALAYS	malays
ALBAHAH	albahah
ALBHA	alba
ALBHAH	albahah
ALBLJH	allah
ALBR	alber
ALBRAYT	galbraith
ALBRT	albert
ALBRTYNY	albertini
ALBRY	allbery
ALBRYJ	allbery
ALBVN	albany
ALBVZ	alba
ALBYNGR	albinger
ALDHAYD	alphard
ALDLHLD	adelheid
ALDN	aldan
ALDN	aldan
ALD	aldo
ALDR	alder
ALDRD	baldred
ALDRYC	aldrich
ALDRYDJ	aldridge
ALDRYG	aldridge
ALDRYG	aldridge
ALDRYJ	aldrin
ALDRYJ	aldrin
ALDRYJ	aldrin
ALDRYJH	aldrich
ALDYN	aldan
ALDZ	aldo
ALFA	afa
ALF	alf
ALFANSV	alans
ALFARV	alfaro
ALF	alf
ALFRD	alford
ALFRDV	alford
ALFRS	alfors
ALFRYNG	elfering
ALFVRD	alford
ALFVRD	alford
ALGADV	alegado
ALGARD	allard
ALGAYN	alain
ALGRV	alger
ALGSAN	alagesan
ALGY	abley
ALGYNGTVN	alington
ALHDAD	alhudud
ALHDVD	alhudud
ALJ	al
ALJH	allah
ALKAN	balkan
ALKBAH	talibah
ALKBR	akbar
ALKBYR	akbar
ALKK	alok
ALKMR	walker
ALKMRH	alcmere
ALKMRY	alcmere
ALKR	alar
ALKRTN	alkerton
ALKRTVN	alkerton
ALKS	alps
ALKSANDR	alesandro
ALKSANDRVZ	alesandro
ALKSNDR	alesandro
ALKSY	aksu
ALKSYV	calsyn
ALKVAB	alva
ALKVK	alok
ALKVR	walker
ALKYNGTN	alington
ALKYNGTVN	alington
ALKYNTN	alkerton
ALLADHKYAH	alladhiqiyah
ALLADHYKYAH	alladhiqiyah
ALLAHYGYAH	alladhiqiyah
ALLDHYKYAH	alladhiqiyah
ALLDYKYAH	aliyyah
ALLHYQYH	alladhiqiyah
ALM	alm
ALMAR	alar
ALMAS	almas
ALMATVN	almaty
ALMGRN	almgren
ALMKVAST	almqvist
ALMKVYST	almqvist
ALMN	alan
ALMNTAJ	almintaqah
ALMR	alar
ALMRS	alars
ALMRVT	almeroth
ALMVD	talmud
ALMVDYVAR	almudevar
ALMV	alm
ALMVMAN	allman
ALMVR	almira
ALMYNAKAH	almintaqah
ALMYNTAGAH	almintaqah
ALMYNTAKAH	almintaqah
ALMYNTAKVA	almintaqah
ALMYNTKH	almintaqah
ALMYRAL	almirall
ALN	alan
ALN	alan
ALND	and
ALNDR	andr
ALN	alan
ALNVR	alnoor
ALNY	albany
ALPN	alpen
ALPRT	alpert
ALPVRT	alpert
AL'QBH	alaqabah
ALRBK	alba
ALRD	aird
ALRTN	aldrin
ALRTVN	alkerton
ALRVY	airay
ALRY	malory
ALRYGH	albright
ALRYJ	aliya
ALSANDRY	alesandro
ALSAN	alan
ALSAN	alan
ALSAP	alsop
ALSAP	alsop
ALSAP	alsop
ALSNDRV	alesandro
ALSN	alan
ALSN	alan
ALSNR	aleser
ALSP	alsop
ALSP	alsop
ALSPD	alsop
ALSR	alar
ALSTRVM	ahlstrom
ALSVN	alison
ALSVN	alison
ALSVN	alison
ALSVP	alsop
ALSVP	alsop
ALSVRS	alars
ALSVRT	albert
ALSVZ	allyz
ALSY	als
ALT	alta
ALTANYN	albany
ALT	alta
ALTAYR	altair
ALTMAN	altman
ALTMN	altman
ALTMN	altman
ALTRVAYD	harvard
ALTRVD	alfred
ALTRVYD	aaltruide
ALTRVYYD	aaltruide
ALTSVN	aitsen
ALTV	alta
ALTYR	altair
ALTZ	alta
ALVA	alva
ALVAN	galvan
ALVARV	alvaro
ALVARVS	alvaros
ALVARZ	alvarez
ALVAY	alva
ALVF	alf
ALVKAL	alukal
ALVK	alok
ALVLD	alfeld
ALVRS	alars
ALVSA	alisa
ALVVD	alva
ALVVD	alva
ALVY	alva
ALVY	alva
ALVYN	allyn
ALVYN	allyn
ALVYN	allyn
ALVYN	allyn
ALVYN	allyn
ALVYS	alves
ALVZ	alva
ALXZNA	alzena
'ALYA	alya
ALYA	alya
'ALY	daly
A'LY	abley
ALY	alya
ALYA	alya
ALYA	alya
A'LYAH	aaliyah
ALYAH	aaliyah
ALY	alya
ALY	alya
ALY	alya
ALYAN	kalyan
ALYAS	alias
ALYASVN	alyson
ALYBY	alibey
ALY	alya
ALY	alya
ALYFAS	alyssas
'ALYH	aaliyah
ALYJ	alya
ALYKS	alyces
ALYLYVNAS	alelyunas
ALYMA	alima
AL'YN	allyn
ALYN	allyn
ALYN	allyn
ALYN	allyn
ALYN	allyn
ALYNGR	albinger
ALYNGTVN	alington
ALYNGTVN	alington
ALYN	allyn
ALYNYK	albany
ALY	alya
ALYSA	alyssa
ALYS	alps
ALYS	alps
ALYS	alps
ALYSN	alyson
ALYSTVN	alston
ALYSTYR	alistair
ALYSVN	alyson
ALYSVN	alyson
ALYSVN	alyson
ALYSVN	alyson
ALYSYA	alyssa
ALYVA	alva
ALYVRYA	alberta
ALYVT	salyut
ALYVT	salyut
ALYVY	alexy
ALYYA	aliya
ALYZA	alya
ALYZABT	alya
ALYZ	allyz
ALYZR	allyz
ALZ	al
ALZNA	alzena
ALZN	alan
ALZVRS	alars
AMA	ama
AMADVR	amador
AMAGYV	almaty
A'MAL	amal
AMAL	amal
AMAND	amand
AMANVAL	amanda
AMANV	amand
AMANVL	amal
AMANVYL	ratanvel
AMANY	amand
AMANYVL	amal
AMARA	amara
AMARAL	amaral
AMARDYV	amardeo
AMARNT	amarit
AMARYT	amarit
AMBAR	aabar
AMBASY	embassy
AMBLR	ambler
AMBRLY	amberle
AMBRLY	amberle
AMBRLYNG	emberling
AMBRVSS	ambrosius
AMBRVSVS	ambrosius
AMBRVSYV	ambrosio
AMBRVSYVS	ambrosius
AMBVS	ambers
AMBYJ	abby
AMDYV	addy
AMFN	amin
AMLAK	amlak
AML	amal
AMLK	amlak
AMLN	amin
AMLYA	alya
AMNA	amna
AMN	amin
AMNVN	amnon
AMPN	ampon
AMPRVR	amparo
AMPSVN	sampson
AMPT	ampte
AMPTH	ampte
AMPY	amy
AMRALD	amaral
AMR	amir
AMRJYNG	amran
AMRMAN	amerman
AMRVSYV	amarus
AMRY	amery
AMRY	amery
AMRY	amery
AMRYKA	amerikan
AMRYKN	amerikan
AMRYKN	amerikan
AMRYTA	amritha
AMS	ams
AMSTAT	amstadt
AMSTD	amstadt
AMSTR	amster
AMSY	ams
AMT	amit
AMTYSTA	amethysta
AMVNA	amina
AMVNDSYZ	amundsen
AMVRVSV	amarus
AMVRY	amery
AMVS	amos
AMY	amy
AMY	amy
AMYH	amy
AMYHAY	abhay
AMYKVS	amys
AMYLY	bayly
AMYLY	bayly
AMYLYYV	smyley
AMYNA	amina
AMYNA	amina
AMYNH	amand
AMYRA	amara
AMYR	amir
AMYR	amir
AMYT	amyot
AMYTAVA	amitava
AMYT	amyot
AMYT	amyot
AMYVT	amyot
AMYVT	amyot
AMYZVTA	amezquita
ANAGRAM	anagram
ANAKYN	anakin
ANALVG	analog
ANANDA	ananda
ANAND	anand
AN	ain
ANANSA	ananda
ANANT	anant
ANAS	anas
ANASTASYA	anastasia
ANATVLY	anatoly
ANATY	anatoly
ANAY	anay
ANAYLYN	anatoly
ANAYZA	ananda
ANAZ	ana
ANAZA	ananda
ANBAR	anbar
ANBR	anbar
ANBV	anbu
ANCY	dancy
ANDAMZ	andaman
AND	and
AND	and
ANDNS	andenes
ANDRA	andra
ANDR	andr
ANDR	andr
ANDRBRG	anderberg
ANDRBVRG	anderberg
ANDRBY	enderby
ANDR	andr
ANDR	andr
ANDRR	ander
ANDRS	andras
ANDRS	andras
ANDRSN	andersen
ANDRSN	andersen
ANDRSVN	andersen
ANDRVS	andras
ANDRVZ	andr
ANDRYA	andra
ANDRY	landry
ANDRY	landry
ANDRYAS	andras
ANDRYS	landrys
ANDRYS	landrys
ANDRYS	landrys
ANDRYSN	landrys
ANDRYSN	landrys
ANDRYVZ	landry
ANDRYYA	andra
ANDRYZ	landry
ANDSVRS	andess
ANDSVRT	vandivort
ANDSVVRT	vandivort
ANDVLSN	andolsen
ANDYSL	andys
ANDYYVRANS	aldebarans
ANFANT	anant
ANFYLD	alfeld
ANGBRTSN	engebretsen
ANGH	anghe
ANGLAND	langland
ANGLANDR	englander
ANGLASMA	anglesea
ANGLHARD	engelhardt
ANGLHLM	engelholm
ANGLHVRN	engelhorn
ANGLND	langland
ANGLS	angels
ANGLS	angels
ANGLSMA	anglesea
ANGLSVN	andolsen
ANGLTH	angelita
ANGLTJ	angelita
ANGLTJH	engeltje
ANGLYNA	angelina
ANGLYS	angles
ANGLZ	angle
ANGRSVL	angel
ANGVLV	angel
ANH	ana
ANHLD	anhold
ANJBRTSVN	andersen
ANJL	anil
ANJLJY	ansley
ANJLS	angels
ANJLT	anujit
ANJLTJA	aaltje
ANJLV	angle
ANJLYNA	angelina
ANJLYS	andys
ANJLYSYA	alyssa
ANJY	anay
ANJYLYNY	marylynn
ANKNY	ankeney
ANKR	anker
ANKRLY	ackley
ANKSTAD	annexstad
ANKVRN	anckorn
ANPYNGKV	unpingco
ANQ	ana
ANQH	anchi
ANRAH	andra
ANR	andr
ANRYK	anay
ANRYKV	vandyke
ANRYKYV	andropov
ANRYKYYVZ	andropov
ANSAR	ainsaar
ANSKAMB	anscomb
ANSL	anil
ANSLM	anselm
ANSLMV	anselm
ANSLY	ansley
ANSLYN	ansley
ANSPAC	anspach
ANSR	andr
ANSTYTV	antti
ANSY	pansy
ANSY	pansy
ANSYH	anshu
ANSYKR	ainsaar
ANTAL	antal
ANTANAYTYS	antanaitis
ANTARAMYAN	antaramian
ANT	aint
ANTH	anthea
ANTNA	anna
ANTRAPY	entropy
ANTRV	antero
ANTRVSYV	antevs
ANTRYKYN	entrikin
ANTSTL	anthistle
ANTSYTL	anthistle
ANTVN	anton
ANTVN	anton
ANTVN	anton
ANTVNVGLV	antonoglou
ANTVNVVYC	antony
ANTVNY	antony
ANTVNY	antony
ANTVNY	antony
ANTVNYS	antonys
ANTVNYS	antonys
ANTVNYV	antony
ANTVNYVS	antonys
ANTVS	antevs
ANTY	anay
ANTYLA	antila
ANTYPDS	antipas
ANTYSTL	anthistle
ANTYSTLH	anthistle
ANV	ana
ANV	ana
ANVAR	anbar
ANVCYN	anacin
ANV	ana
ANV	ana
ANVJYT	anujit
ANVKVL	anukul
ANVN	ann
ANVPAM	anupam
ANVP	anoop
ANVR	andr
ANVR	andr
ANVR	andr
ANVRS	anvers
ANVS	anas
ANVS	anas
ANVTYYADYS	alvarados
ANVVY	anay
ANYART	enyart
ANYJMA	andaman
ANYL	anil
ANYL	anil
ANYL	anil
ANYMA	ayman
ANYNG	enying
ANYSA	anisa
ANYS	andys
ANYSH	andys
ANYSTYN	augustyn
ANYVRSRY	anniversary
ANYVS	andys
ANYYV	anay
ANZALVNY	anzalone
ANZLVAR	anzlovar
ANZYNGR	enzinger
APCRC	accra
AP	apr
APL	apel
APL	apel
APLBAY	albany
APLBRG	appelberg
APLBY	appleby
APLBY	appleby
APLMN	aplin
APLNDS	laplands
APLYBY	appleby
APLYBY	appleby
APLYN	allyn
APNDYS	andys
APRAYT	airay
APRLY	april
APRSVN	aperson
APRYL	april
APSTN	alston
APSTVN	alston
APSTYN	alston
APSYLVN	sylvan
APVNTH	aponte
APVRVA	apoorva
APYDAL	ayda
APYSTYN	augustyn
AQBAL	iqbal
ARAM	abram
ARAND	armand
ARAN	amran
ARARKH	parakh
ARAS	aras
ARAS	aras
ARASMVS	erasmus
ARAY	airay
ARAYZ	airay
ARBANAS	arbanas
ARBR	arber
ARBVR	arber
ARBYD	araby
ARBY	araby
ARBYL	arbil
ARBY	araby
ARCAL	aral
ARCALH	aral
ARC	arce
ARCARD	barnard
ARCDALY	archdale
ARCDL	archdale
ARCDYL	archdale
ARCR	arce
ARCYBALD	archibald
ARDALYC	ardalich
ARDMN	arden
ARDN	arden
ARDRZ	adri
ARDYS	andys
AR	ar
ARFANAKYS	orfanakis
ARFVRD	barford
ARFYVS	arafats
ARGAN	aryan
ARGAN	aryan
ARGAR	orgar
ARHARD	erhard
ARKARD	barnard
ARKDYL	arkell
ARKTYKY	arktiki
ARLAYJ	barclay
ARL	aral
ARL	aral
ARL	aral
ARLT	arlet
ARLY	carly
ARLYJ	carly
ARLYNDH	garland
ARLYNG	arling
ARMAND	armand
ARM	arm
ARMASTRANG	armstrong
ARMATV	armato
ARMNY	armand
ARMRY	amery
ARMSRVNG	armstrong
ARMSTRANG	armstrong
ARMVNTRVT	armontrout
ARMVR	armour
ARMYN	armand
ARMYTAJ	armitage
ARMYT	amyot
ARMYTAZ	armitage
ARN	arne
ARNAT	arnot
ARND	arend
ARNDT	arendt
ARNFYLD	arnfield
ARNH	arch
ARNLD	arnold
ARNST	arnot
ARNT	arnot
ARNT	arnot
ARNT	arnot
ARNTS	arantes
ARNVLD	arnold
ARNVT	arnot
ARNVT	arnot
ARP	earp
ARPYN	arpin
ARS	ars
ARSKAT	barakat
ARSKAYN	carskadon
ARSNALT	arsenault
ARSY	ars
ARSYD	ackroyd
ARSYKR	arsikere
ARTL	aral
ARTR	arter
ARTRS	arthers
ARTRZ	arter
ARTVT	arlet
ARTYS	martys
ARTYZ	bartz
ARVAL	aral
ARVMA	aromaa
ARVN	aron
ARVNACALAM	arunachalam
ARVNAH	arunah
ARVND	arend
ARVNN	darvon
ARVRKH	farrah
ARVSN	arvesen
ARVYNG	arling
ARVYVLA	arviola
ARYA	arya
ARYA	arya
ARY	arya
ARYC	arya
ARYFA	arya
ARYJ	arya
ARYKA	arya
ARYKA	arya
ARYK	ark
ARYK	ark
ARYKSN	aryan
ARYKSVN	alyson
ARYKSVN	alyson
ARYKSVN	alyson
ARYN	aryan
ARYNGTN	arlington
ARYS	marys
ARYS	marys
ARYS	marys
ARYSTVTL	aristotle
ARYZ	ariz
ARYZ	ariz
ARZAT	arzate
ARZ	ariz
ASAKVL	assakul
ASBL	asbell
ASBRN	asbrink
ASBRYNK	asbrink
ASBVRN	asbrink
ASCAFYLD	ashfield
ASCAGN	mascagni
ASCRVVYC	ascoly
ASCVFYLD	ashfield
ASCVYLAR	ascella
ASCYPLVDN	sylvan
ASCYPLVYDN	ascoly
ASCYPN	alcyone
ASDS	assads
ASFAR	alfaro
ASFYLD	alfeld
ASGVRYAN	asguarian
ASKADZ	akkad
ASKAGN	alaskan
ASKAHAN	skahan
ASKAJN	alaskan
ASKALANT	atalanta
ASKAL	alukal
ASKALYK	kalmyk
ASKALY	ascoly
ASKANL	askanas
ASKANYL	askanas
ASKARP	baskar
ASKARS	ankaras
ASKARTSYS	skartsis
ASKARY	baskar
ASK	ask
ASKATV	ashanti
ASKATYA	kamskaya
ASKATY	kasaty
ASKAVN	skaven
ASKAYA	kamskaya
ASKAYLR	baskar
ASKAY	asoka
ASKAYT	kamskaya
ASKLDSVN	eskeldson
ASKLTN	skelton
ASKLTVN	skelton
ASKLVYR	ackley
ASKNL	haskel
ASKNS	askanas
ASKP	ask
ASKRAB	arab
ASKRANTVN	austranten
ASKRAYZ	ackroyd
ASKRNTN	austranten
ASKRNTVN	austranten
ASKRVYC	ackroyd
ASKRYBLYNG	marylynn
ASKRYBNR	scribner
ASKRYC	ackroyd
ASKRY	waskey
ASKRYS	averys
ASKRYV	ackroyd
ASKVAYRL	baskar
ASKVAYR	baskar
ASKVFYLD	ashfield
ASKVGAN	akgun
ASKVLY	ascoly
ASKVLYNG	aveling
ASKVLYN	jacklyn
ASKVLY	ascoly
ASKVLYZ	allyz
ASKV	ask
ASKVRR	baskar
ASKV	ask
ASKVTVNY	antony
ASKVYLR	aylor
ASKVYVYL	baskerville
ASKYBA	skiba
ASKYLS	skylabs
ASKYNR	askanas
ASKYN	baskin
ASKYN	baskin
ASKYPLADN	assyrian
ASKYPLVYDN	sylvan
ASKYPN	skype
ASKYP	skype
ASKYPY	skype
ASKYRS	akers
ASKY	ask
ASKYTR	aster
ASLANKARD	slankard
ASLAN	alan
ASLAN	alan
ASLAN	alan
ASLATKYN	slatkin
ASLATKYN	slatkin
ASLATR	slater
ASLATRY	slattery
ASLATVBR	slater
ASLAVK	saslav
ASLAVMYZ	saslav
ASLAVNBRG	slavenburg
ASLAVYN	slavin
ASLAYK	amlak
ASLBVTNN	slabotnen
ASLD	auld
ASLMN	allman
ASLNGZVALD	slangsvold
ASLP	aesop
ASLR	basler
ASLS	als
ASLSYNG	calsyn
ASLTN	alton
ASLTR	aster
ASLVAN	galvan
ASLVKAM	alukal
ASLVKA	alva
ASLVMN	alvin
ASLVN	alvin
ASLVN	alvin
ASLVP	alva
ASLY	ansley
ASLYGRZ	allegra
ASLYMAN	allman
ASLYNY	allyn
ASLYPR	basler
ASLYP	allyn
ASLYTY	almaty
ASLYVPAS	alyssas
ASLYV	saslav
ASMA	asma
ASMADJ	smadja
ASMAL	amal
ASMALY	almaty
ASMART	asmara
ASMAYT	asma
ASMDLY	ascoly
ASMLN	tasman
ASMVKY	smoky
ASMVLYK	amlak
ASMVLYN	allyn
ASMVR	asmara
ASMVT	amit
ASMYD	ahmad
ASMYKLA	smikla
ASMYL	amal
ASMYLY	smyley
ASMYRNV	smirnov
ASMYT	amyot
ASMYTSVN	rasmussen
ASMYTVYK	almaty
ASMYTZ	adametz
ASMYTZ	adametz
ASNAG	hasna
ASNAYDR	snyder
ASNDN	ashenden
ASNL	anil
ASNL	anil
ASNLYNG	allyn
ASNR	casner
ASNVDN	ashenden
ASNVFYLD	arnfield
ASNVGRS	anvers
ASNV	hasna
ASNYD	and
ASNYL	anil
ASNYSL	andys
ASPANGLR	spangler
ASPARDAM	spaarndam
ASPARKS	sparks
ASPARNDAM	spaarndam
ASPAR	caspar
ASPARV	kasparov
ASPARZA	esparza
ASPATAFVRA	spatafora
ASPAT	caspar
ASPATSVVD	kasparov
ASPATZ	spatz
ASPAVLDYNG	spaulding
ASPAYDR	caspar
ASPAYDRZ	casandra
ASPAYK	masaryk
ASPAYKS	sparks
ASPAYNYNG	spinning
ASPAYRZ	caspar
ASPAYZ	spatz
ASPLMN	aplin
ASPLYD	ascoly
ASPLYNTR	splinter
ASPNSR	aspens
ASPNS	aspens
ASPRAG	sprag
ASPR	apr
ASPRVT	alpert
ASPRYBRY	sprayberry
ASPRY	abery
ASPVLARYC	spolarich
ASPVLARYX	calvary
ASPVR	caspar
ASPVRY	avery
ASPVSTA	avesta
ASPVSYTV	esposito
ASPVTYS	almatys
ASPYDN	aspen
ASPYLMN	asselman
ASPYNAK	spinak
ASPYNDRYFT	spindrift
ASPYN	aspen
ASPYRAS	assyrias
ASPYR	caspar
ASPYR	caspar
ASPYRV	kasparov
ASPYRV	kasparov
ASPYRYNG	assyrian
ASPYRZ	assyria
ASPYRZ	assyria
ASPYSAK	spisak
ASPYSYK	spisak
ASPYT	aspen
ASPYTZR	spitzer
ASPYVAK	spivak
ASPZYTV	kasparov
ASRAT	israt
ASRAYYL	karayel
ASRMN	asherman
ASTABRT	astarte
ASTABZ	aftab
ASTAD	amstadt
ASTAD	amstadt
ASTAFL	antal
ASTAFVRD	bastard
ASTAG	astana
ASTAJANV	stajano
ASTAKMN	astrakhan
ASTAKR	astaire
ASTAKSLAJR	stockslager
ASTAKS	astanas
ASTAKY	pataky
ASTAKY	pataky
ASTALKH	masalkhi
ASTAMPR	stamper
ASTAM	assam
ASTANGYR	stangier
ASTANVL	astana
ASTAPLYC	staples
ASTARBAK	pasternak
ASTARGS	astartes
ASTARGYL	astarte
ASTARK	stark
ASTARKYP	starkey
ASTARKY	starkey
ASTAR	astaire
ASTAR	astaire
ASTARTLD	startled
ASTART	astarte
ASTARTZ	astarte
ASTARYNGR	staringer
ASTARZ	astaire
ASTAS	acostas
ASTATM	astarte
ASTATRZ	astaire
ASTATZMN	stutzman
ASTAYLZ	antal
ASTAYNLS	astanas
ASTAYNMN	astana
ASTAYN	astana
ASTAYR	astaire
ASTBAY	eastway
ASTCNYK	antony
ASTDLR	aster
ASTDMN	aston
ASTDYNA	astana
ASTFANS	astanas
ASTFAN	astana
ASTFAN	astana
ASTFANVS	astanas
ASTFANV	astana
ASTFANZ	astana
ASTFN	aston
ASTFNSVN	carstensen
ASTGN	aston
ASTK	astik
ASTLR	aster
ASTLY	astley
ASTLYK	astley
ASTLY	astley
ASTNFRD	stanford
ASTNFVRD	stanford
ASTNFVRT	stenfort
ASTNKAMB	astana
ASTNSL	alstons
ASTNSRAD	stensrud
ASTN	aston
ASTNTJY	astley
ASTPKN	aspen
ASTPK	astik
ASTRABRYJ	araby
ASTRADR	strader
ASTRAKMN	astrakhan
ASTRAK	amtrak
ASTRANDR	ostrander
ASTRAP	kastrup
ASTR	aster
ASTRASYM	asturias
ASTRAVB	straub
ASTRLYNG	sterling
ASTRMLR	stremler
ASTRN	aston
ASTRND	astrid
ASTRN	aston
ASTRVK	amtrak
ASTRVM	ahlstrom
ASTRVS	antevs
ASTRVSTRAP	stroustrup
ASTRYAN	austrian
ASTRYBL	gastrell
ASTRYD	astrid
ASTRYDM	strydom
ASTRYDR	astrid
ASTRYM	ahlstrom
ASTRYN	aston
ASTRYNGR	stringer
ASTRYNJR	easterner
ASTRYN	aston
ASTRYNY	anthony
ASTRYR	aster
ASTRY	aster
ASTRYTY	astarte
ASTS	easts
ASTVARD	bastard
ASTVART	astarte
ASTVBRYJ	astaire
ASTVDVLA	stodola
ASTVFL	advil
ASTVKLAS	stoklas
ASTVK	astik
ASTVK	astik
ASTVKVL	assakul
ASTVKY	astik
ASTVLK	astik
ASTVLR	aster
ASTVL	antal
ASTVN	aston
ASTVNBRAYJ	glastonbury
ASTVNSN	alstons
ASTVN	aston
ASTVN	aston
ASTVR	aster
ASTVRGA	astoria
ASTVRLYR	astley
ASTVRMZ	astarte
ASTVRR	aster
ASTVRYM	ahlstrom
ASTVRY	aster
ASTVRY	aster
ASTV	aster
ASTVVAL	stovall
ASTVY	astley
ASTYANSN	astanas
ASTYBL	sybil
ASTYBR	aster
ASTYD	astrid
ASTYGBRG	stigberg
ASTYGMN	stygian
ASTYGRS	castors
ASTYG	aster
ASTYJH	aetje
ASTYK	astik
ASTYKLMN	asselman
ASTYLR	aster
ASTYL	antal
ASTYL	antal
ASTYL	antal
ASTYLY	astley
ASTYLZ	astley
ASTYN	aston
ASTYNBRG	stenberg
ASTYNSN	alstons
ASTYN	aston
ASTYN	aston
ASTYNSVN	carstensen
ASTYNTH	styntie
ASTYNTJH	martyntje
ASTYNTJ	martyntje
ASTYNZ	astana
ASTYPLZ	aspell
ASTYP	aster
ASTYRN	austern
ASTYRNZ	austern
ASTYSY	astley
ASTYSY	astley
ASTYT	adsett
ASTYVDNT	amstadt
ASTYVN	aston
ASTYVNSVN	stevenson
ASTYVS	antevs
ASTYVZ	active
ASVALAP	aswalap
ASVALD	osvaldo
ASVANAY	askanas
ASVK	ask
ASVLT	iselt
ASVRS	anvers
ASVSKY	nevsky
ASVYSR	caseys
ASYA	alya
ASY	amy
'ASYF	asif
ASYF	asif
ASYMYLYT	smyley
ATANSYV	satans
ATA	alta
ATA	alta
ATARAS	ataras
ATH	gath
ATJH	aetje
ATKA	atka
ATKYNSN	atkinson
ATKYNSVN	atkinson
ATKYNZ	atkins
ATKYNZ	atkins
ATL	atle
ATLS	atlas
ATMSFR	amster
ATMZ	atems
AT	at
ATRAM	atram
ATR	atri
ATRTN	atherton
ATRY	atri
ATRYSPS	atriceps
ATRZ	atri
ATTLY	antley
ATV	at
ATVATR	atwater
ATVD	abad
ATV	at
ATVL	atul
ATVL	atul
ATV	at
ATV	at
ATVSAN	latvian
ATVS	antevs
ATVSY	patsy
ATVVD	active
ATVVL	advil
ATVYL	advil
ATYA	atiya
ATY	katy
ATYG	atiya
ATYLRD	aylward
ATYLRDH	aylward
ATYLYV	bayly
ATYNGR	tyng
ATYNY	antony
ATYNZVN	etinzon
ATYS	katys
ATYVL	atul
ATYYA	atiya
AVACA	havana
AVAD	abad
AVADYA	acadia
AVALD	avalon
AVAN	avian
AVANZ	avian
AVASTY	avas
AVBAJA	abuja
AVBRAYAN	abraham
AVBRDVRFR	oberdorfer
AVBRHVLZ	oberholz
AVBRHYM	abraham
AVBR	aabar
AVBRTAS	albertas
AVBRY	avery
AVBRY	avery
AVBYD	abad
AVBYNGM	abyan
AVCARD	havard
AVCAR	bacar
AVCLND	auckland
AVCZ	ac
AVDDY	addy
AVDKRYK	avery
AVDKYRK	oudekirk
AVDL	abdul
AVDLY	ardley
AVDRA	andra
AVDRGV	aberg
AVDVAK	aviva
AVDVN	adan
AVDV	aviva
AVDYVM	adam
AVFNR	avins
AVFYNGTVN	addington
AVGAR	angara
AVGBVRN	pangborn
AVGLT	aoglat
AVGNH	agni
AVGNYV	avignon
AVGVR	alger
AVGVRY	avery
AVGVST	august
AVGVSTV	august
AVGVSTYN	augustyn
AVGYNH	ageno
AVHALVRAN	ohalloran
AVHRMN	ahriman
AVJN	avon
AVKLND	auckland
AVKLY	ackley
AVKR	akar
AVKRAYN	ackerman
AVKR	akar
AVKSLY	ackley
AVKSTVN	agustin
AVKSVL	akil
AVKT	ack
AVKTS	acts
AVKTZ	savetz
AVKYNZ	parkyn
AVKYTS	advents
AVLAFSVN	olafson
AVLA	avila
AVL	advil
AVLAYVVLA	layla
AVLD	auld
AVLDKVRN	aldrin
AVLDRAYT	aludra
AVLDRYJ	aldrin
AVLDZ	aldo
AVLMN	allman
AVL	advil
AVLSN	avalon
AVLSN	avalon
AVLSVN	abelson
AVLSVN	abelson
AVLVSTAD	lovstad
AVLYMA	alima
AVLYNG	aveling
AVLY	abley
AVLY	abley
AVLYVYH	aliyyah
AVLYVYR	alvaro
AVMAKY	almaty
AVMBRGR	baumberger
AVMGA	amiga
AVMLAS	avilas
AVMR	amir
AVNAT	anant
AVN	avon
AVNAYZA	ananda
AVNAYZ	anay
AVNGLYSTA	anglesea
AVNG	aveling
AVNSTY	avesta
AVNSVN	anson
AVNVSKV	avinash
AVNYL	avniel
AVNYL	avniel
AVNZ	avins
AVQVAQ	aviva
AVRAHAM	avraham
AVRAM	avram
AVRAYL	airay
AVRAYS	averys
AVRAYZ	airay
AVRAYZ	airay
AVRBN	aaron
AVRCARD	barnard
AVRDALN	aurdalen
AVRFYVS	averys
AVRGAN	adrian
AVRHAN	avraham
AVRHAN	avraham
AVRHART	carhart
AVRHRT	carhart
AVRHV	aurho
AVRKLYVN	aurkleven
AVRKNY	avery
AVRLANDV	garland
AVRL	advil
AVRLYNZ	allyn
AVRMA	aversa
AVRM	avram
AVRMSPVRDN	ormesporden
AVRN	avon
AVRNVPN	aurnupen
AVR	air
AVRSBRG	eversberg
AVRSLR	averell
AVRTS	arts
AVRTYZ	avery
AVRVM	avram
AVRV	avery
AVRVYL	argyle
AVRY	avery
AVRYGA	arya
AVRYK	avery
AVRYL	avery
AVRYL	avery
AVRYNTS	advents
AVRYS	averys
AVRYS	averys
AVRYS	averys
AVRY	avery
AVRYVLY	ardley
AVRYVN	aryan
AVRYVRDAN	aryan
AVRYZ	avery
AVSAL	faisal
AVSBVRN	sansburn
AVSBVRN	sansburn
AVSLANDR	auslander
AVSLYNA	alana
AVSN	avon
AVSN	avon
AVSNZ	avins
AVSTBANN	austbanen
AVSTHAMARN	austhamaren
AVSTLYC	astley
AVSTNDVRP	oostendorp
AVSTRANDR	ostrander
AVSTRNDR	astrid
AVSTVLYN	austvollen
AVSTVRYN	austern
AVSTYN	alston
AVSYVN	calsyn
AVSYZ	allyz
AVTAGVRV	altair
AVTA	alta
AVTH	baath
AVTJH	aetje
AVTJ	aetje
AVTLV	atle
AVTLV	atle
AVT	ait
AVT	ait
AVTRY	avery
AVTVLYNY	katelyn
AVTV	aviva
AVTYS	averys
AVVLYV	pavlov
AVVRDAL	overdal
AVVRPK	amtrak
AVYAN	abyan
AVYARS	magyars
AVYCAY	avichay
AVYK	aveek
AVYNAS	avinash
AVYNG	auyeung
AVYNZ	avins
AVYRSA	aversa
AVYS	amys
AVYSNA	alyssa
AVYVA	aviva
AVYVN	abyan
AVZBRN	lavern
AVZGVR	alger
AVZMN	avian
AVZVNYS	albanys
AYALA	ayala
AYBAC	zayac
AYBAR	aabar
AYBL	abel
AYBYRVNK	asbrink
AYCAS	accras
AYCBVRN	ayckbourn
AYCYRV	accra
AYDA	ayda
AYDA	ayda
AYDAN	adan
AYDMN	ayman
AYDNBVRG	rydberg
AYD	ayda
AYDS	ayda
AYDVAYSVZ	adametz
AYDVRY	audrey
AYDYD	addy
AYDY	addy
AY	amy
AYF	alf
AYFJH	nayfeh
AYFJ	afa
AYFVFL	advil
AYFV	afa
AYGAN	ayman
AYGLASTVN	afghanistan
AYGLSTVN	agustin
AYGLV	angle
AYGLY	bayly
AYGRT	agra
AYGRTVN	agren
AYGV	ag
AYGVR	alger
AYJH	ayah
AYJLSTVN	alston
AYJVYN	kayvon
AYK	ack
AYKAM	abram
AYKARVS	ankaras
AYKBRN	ayckbourn
AYKBVRN	ayckbourn
AYKH	ayah
AYKLVZAN	sylvan
AYKN	ayn
AYKVK	akiva
AYLANA	alana
AYLAN	alan
AYLKA	ayala
AYLMYN	allman
AYLPV	alpo
AYLR	aylor
AYLSA	ailsa
AYLTH	aylott
AYLVARD	aylward
AYLVR	aylor
AYLVT	aylott
AYLVT	aylott
AYLVYZA	aliya
AYLYA	alya
AYLYDYV	bayly
AYLYN	allyn
AYLYN	allyn
AYLYN	allyn
AYLYNG	ayling
AYLYN	allyn
AYLYS	ayalas
AYLYS	ayalas
AYLZ	allyz
AYM	aim
AYMAN	ayman
AYMAN	ayman
AYMANTZ	ayman
AYMAR	aymara
'AYMN	ayman
AYMN	ayman
AYMN	ayman
AYMRY	amery
AYMVN	ayman
AYMY	amy
AYNAC	anzac
AYN	ayn
AYNA	amna
AYNANA	ananda
AYNAN	ayman
AYNARYNV	catharyn
AYNAT	anant
AYN	ayn
AYNAYN	anay
AYNC	ayn
AYNDALYS	mandalays
AYNDAYRSN	andersen
AYNDRA	andra
AYNDRAJYT	indrajit
AYNDRANYL	indranil
AYNDRLY	landry
AYNDSVRS	rynders
AYNDVY	andy
AYNGALZ	sangal
AYNG	ayling
AYNG	ayling
AYNG	ayling
AYNGLD	angle
AYNGLF	angle
AYNGL	angel
AYNGLS	angels
AYNGLYS	angles
AYNGLYS	angles
AYNGMAR	ingmar
AYNGMAR	ingmar
AYNGRAHAM	ingraham
AYNGRAM	anagram
AYNGRM	anagram
AYNGRSVL	abners
AYNGRYA	angara
AYNGRYD	maynard
AYNGRYSL	angoras
AYNGRYSVL	angoras
AYNGVAR	ingvar
AYNGYJD	maynard
AYNHV	ayah
AYNJH	zaynah
AYNJJNRY	ankeney
AYNKH	zaynah
AYNKVGNYTA	incognita
AYNLY	ainley
AYNMN	ayman
AYNR	ayn
AYNS	anns
AYNS	anns
AYNSR	gaynor
AYNT	aint
AYNTAYR	anntar
AYNT	aint
AYNTH	zaynah
AYNTJ	eyntje
AYNTJH	eyntje
AYNTLSAT	intelsat
AYNTRNT	paynton
AYNTRNT	paynton
AYNVKSN	anakin
AYNVN	amnon
AYNVSNT	advent
AYNYSA	anisa
AYNZ	ayn
AYNZHNRY	inzhenery
AYNZ	ayn
AYNZ	ayn
AYPRSVN	aperson
AYPRT	alpert
AYR	dayr
AYRARDY	aylward
AYRAY	airay
AYRBYD	ackroyd
AYRD	aird
AYRDV	aird
AYR	dayr
AYR	dayr
AYRLAYNZ	garland
AYRL	april
AYRLND	arend
AYRNST	arnot
AYRNVT	arnot
AYRP	ayers
AYRS	ayers
AYRVN	aaron
AYRVN	aaron
AYRVNSVN	aronson
AYRVVD	ayurveda
AYRVYNG	arling
AYRVYN	aryan
AYRVYN	aryan
AYRVYYN	aryan
AYRY	abery
AYRYK	ark
AYRYS	ayres
AYRYZARY	barbary
AYRZ	ariz
'AYSA	maysan
AYSA	alyssa
'AYSA	maysan
AYSA	alyssa
AYS	amys
AYSA	alyssa
AYSAK	adisak
AYSAK	adisak
AYSAKS	alyssas
AYSAMA	asama
AYSAN	maysan
AYSASK	alyssas
AYSBL	asbell
AYSFALZ	ayala
'AYSH	ayush
AYSH	ayush
'AYSH	ayush
AYSH	ayush
AYS	amys
AYSKANDR	auslander
AYSK	ask
AYSLT	ayala
AYSLYK	ansley
AYSMAN	ayman
AYSMN	ayson
AYSNSTAT	aisenstat
AYSPVRT	allport
AYSRAT	abstract
AYSRT	art
AYSRT	art
AYSTBRN	austern
AYSTLND	eastland
AYSTMAS	asamas
AYSTMN	mayston
AYSTMVS	systems
AYSTRAGV	abstract
AYSTRBRVK	easterbrook
AYSTR	amster
AYSTR	amster
AYSTVVD	astrid
AYSTVY	rysavy
AYSTYK	astik
AYSTYN	mayston
AYSVN	ayson
AYSVN	ayson
AYSY	ayse
AYSYZAKY	kasprzak
AYT	ait
AYT	ait
AYTAMAR	itamar
AYTCV	active
AYTCVN	aztecan
AYTH	ayah
AYTH	ayah
AYTJ	aetje
AYTJ	aetje
AYTJY	aetje
AYTKN	aitken
AYTR	hayter
AYTSN	aitsen
AYVA	alva
AYVALD	ayala
AYVANZ	ayman
AYVAR	alvaro
AYVAYNG	ayling
AYVGNH	kayvon
AYV	av
AYVJNH	kayvon
AYVLYN	allyn
AYVND	abend
AYVNS	alvins
AYVRS	ayers
AYVRSVN	amerson
AYVRY	avery
AYVS	avs
AYVS	avs
AYVSTYS	avestas
AYVSV	avs
AYVSYN	ayson
AYVTYK	astik
AYVYN	kayvon
AYZAK	ganzak
AYZAKSVN	kazakhstan
AYZCYL	afzal
AYZDY	addy
AYZ	allyz
AYZL	afzal
AYZMN	ayman
AYZRVDA	ayurveda
AYZV	azov
AZAD	azad
AZALYA	azalea
AZALY	afzal
AZANA	azana
AZAR	azhar
AZBVRN	harburn
AZCYL	zyl
AZHR	azhar
AZLA	azlan
AZLN	azlan
AZR	air
AZVR	azhar
AZYCL	alyce
BAABAR	baabar
BAAFJ	baefje
BABA	baba
BABA	baba
BABAH	babah
BABAR	babar
BABAR	babar
BAB	baba
BAB	baba
BAB	baba
BABK	babak
BABK	babak
BABL	babel
BABR	babar
BABT	baba
BABV	baba
BABVRAV	baburao
BABVSKYN	babushkin
BABY	baba
BABY	baba
BABY	baba
BABYKV	babak
BABYRL	babar
BABYTZ	babitz
BACALTR	bacall
BACARAC	bacharach
BACAS	backas
BAC	bach
BACLDR	balder
BAD	abad
BAD	abad
BADKK	badrak
BADKVK	badrak
BADLVC	badeloch
BADMN	baden
BADNYK	badrak
BADR	badr
BADRMN	baderman
BADRYK	badrak
BADVYN	bauduyn
BADVYYN	bauduyn
BADY	badry
BADYG	badry
BADYN	baden
BADYN	baden
BADYNGTN	baldington
BADYNGTVN	baldington
BADYVN	baden
BADZ	badr
BADZYAK	badrak
BAFL	baal
BAFY	badry
BAFY	badry
BAGA	bagga
BAGAM	baugham
BAGARLY	baggarly
BAGAY	bugay
BAGDAN	badian
BAGHAM	baugham
BAGLY	bagley
BAGLY	bagley
BAGM	baum
BAGSAV	bagga
BAGVLY	bagley
BAGYD	bagade
BAGZ	baez
BAGZ	baez
BAHYH	albahah
BAJVA	bajwa
BAJYK	babak
BAKAR	baskar
BAKAS	backas
BAKAYA	bakaya
BAKLY	bally
BAKNR	baker
BAKR	baker
BAKR	baker
BAKSKA	baskar
BAKSR	baker
BAKSY	bakaya
BAKVM	bakkum
BAKVS	bakos
BAKY	bak
BAKYR	baker
BALAK	babak
BALANDR	badlands
BALANS	balkans
BALARD	ballard
BALARY	balarie
BALAS	balash
BALAST	ballast
BAL	baal
BAL	baal
BALBYR	balbir
BALCVNAS	balchunas
BALD	bald
BALDRD	baldred
BALDVR	balder
BALDYNGTN	baldington
BALDYNGTVN	baldington
BALFNZ	balfanz
BALGA	baliga
BALHAM	balham
BALKA	balkan
BALKVSKY	bilinsky
BALMA	balma
BALMASDA	balmaseda
BALMR	balmer
BALNDRA	balendra
BALNY	balleny
BALSAM	balsam
BALSARA	bulsara
BALSK	baals
BALSLY	balsley
BALSVN	balson
BALTAKS	baltais
BALTAYS	baltais
BALTAZAR	balthazar
BALTZL	baltzell
BALV	bald
BALY	bally
BALYGA	baliga
BALYK	balaye
BALYN	balin
BALYN	balin
BALYSTYK	bialystok
BALYT	balit
BAMBRGR	baumberger
BAMN	bain
BAMSV	bamse
BANA	banan
BANABYV	barnaby
BAN	bain
BAN	bain
BAND	bandi
BANDD	banded
BANDYRDY	badry
BANDZ	bandi
BANGARTZ	bongarts
BANG	bang
BANGRZ	bangor
BANKLR	bankler
BANKRAFT	bancroft
BANKRVFT	bancroft
BANKS	banks
BANKVALA	bankwalla
BANL	baal
BANR	badr
BANTVN	banton
BANTY	bandy
BANTYNG	banting
BANY	bandy
BANY	bandy
BANY	bandy
BANYTA	baniya
BANYTV	bantu
BANYVRA	baniya
BAP	ba
BAPTYSTA	baptista
BAPTYST	baptist
BARAKVTA	barakat
BARAS	barash
BARASV	barash
BARAT	barath
BARBAGALV	barbagallo
BAR	bar
BARBAS	barbas
BARBR	barber
BARBVRAK	barborak
BARBVR	barber
BARBY	barb
BARD	bard
BARDVLVMZ	bardell
BARDYK	bandy
BARF	barff
BARFRD	barford
BARFVRD	barford
BARFYT	barff
BARG	bargh
BARGS	bargus
BARGVS	bargus
BARH	bargh
BARJYL	banjul
BARKALV	baikal
BARKASFYLD	barksfield
BARKAY	barkah
BARK	bark
BARKLY	barkley
BARKRAFT	barcroft
BARKR	barker
BARKSDYLY	barksdale
BARKSFYLD	barksfield
BARKVLV	barkell
BARKVS	barkus
BARLAS	barlas
BARL	baral
BARL	baral
BARLV	baral
BARNABY	barnaby
BARNAM	barnas
BARNARD	barnard
BARNAS	barnas
BARN	barn
BARND	barend
BARNSA	barnshaw
BARNSAV	barnshaw
BARNSV	barnas
BARNT	barents
BARNY	barney
BARNYK	barney
BARQARD	barnard
BARS	barrs
BARSY	barry
BARTA	barta
BART	bart
BART	bart
BARTHVLVMYVS	bartholomeus
BARTK	bartok
BARTKVR	barker
BARTL	bartle
BARTL	bartle
BARTLMAS	bartelmus
BARTLMVS	bartelmus
BARTLT	bartelt
BARTLT	bartelt
BARTLY	bartley
BARTMVS	bartelmus
BARTN	barton
BARTN	barton
BARTVK	bartok
BARTVLVMVS	bartelmus
BARTVLVMYVS	bartelmus
BARTVLYNY	bartley
BARTVN	barton
BARTVNYKV	bartley
BARTY	barry
BARTY	barry
BARTYH	barth
BARTYS	martys
BARTZ	bartz
BARVA	barta
BARVC	barack
BARVN	barn
BARVN	barn
BARVNS	barents
BARVNYA	baronia
BARVZ	bartz
BARYAKS	baracks
BARY	badry
BARY	badry
BARY	badry
BARY	badry
BARYNGR	barringer
BARYNGTN	barrington
BARYNGTVN	barrington
BARYS	barneys
BASA	basha
BAS	bas
BAS	bas
BASKAR	baskar
BASKRVYL	baskerville
BASKY	bosky
BASL	basel
BASMA	basma
BASN	basin
BASR	basir
BASSA	bassam
BASSN	basson
BASTARD	bastard
BAST	basit
BASTYK	astik
BASTYLVS	bastilles
BASTYN	bastien
BASTYN	bastien
BASTYN	bastien
BASTYVN	bastien
BASVAL	baal
BASV	bas
BASV	bas
BASVM	basem
BASYL	basel
BASYLYKA	basilica
BASYLYSK	basilisk
BASYLYVS	babylons
BASYN	basin
BATALS	baals
BATAN	bataan
BAT	bat
BATL	batel
BATLR	bartle
BATNAT	banan
BATN	bain
BATRA	batra
BATRBY	barraby
BATRS	barrs
BATRSS	barsse
BATRST	bathurst
BATRVRS	barrs
BATRYS	gantrys
BATRZ	batra
BATY	bat
BATYL	batel
BATYNG	banting
BAVA	ava
BAV	av
BAVCMP	basecamp
BAVDN	baden
BAVDN	baden
BAVDVYYN	bauduyn
BAVDYN	bauduyn
BAVDYN	bauduyn
BAVDYSYN	bauduyn
BAVGMN	baughman
BAVKAM	avram
BAVKVS	backas
BAVM	baum
BAVMGARTNR	baumgartner
BAVPRS	baupres
BAVRY	badry
BAVS	avs
BAVYZ	baez
BAXVM	axum
BAYARD	bayard
BAY	bray
BAYDA	bayda
BAYDN	bayda
BAYFYLD	byfield
BAYKRASTAF	bickerstaffe
BAYKRZTAF	barta
BAYLA	bayla
BAYLS	baals
BAYLY	bayly
BAYLYNGSLY	billingsley
BAYLYNGTVN	baldington
BAYLYV	bayly
BAYLZ	bayla
BAYNVN	banan
BAYPRT	bart
BAYR	bayer
BAYRD	bayard
BAYRN	bayern
BAYRN	bayern
BAYRTAY	barta
BAYRTYH	barth
BAYRVN	bayern
BAYSVT	basit
BAYZ	baez
BAZBY	buzby
BAZBY	buzby
BAZT	bart
BBKAK	babak
BBYT	abbot
BCLDR	balder
BCLR	bacar
BDAL	bdale
'BDALH	bdale
'BDALLH	abdullah
'BDALRHMAN	abdalrahman
'BDALRHMAN	abdalrahman
'BDALRHMN	abdalrahman
'BDALRHMN	abdalrahman
'BDAL'ZYR	balzer
'BDAL'ZYZ	abdulaziz
'BDHBY	abby
BDKK	bekki
BDKVK	badrak
'BDL	abdul
BDLAK	badrak
BDL	abdul
BDLVC	blvd
'BDL'ZYZ	abdulaziz
BDMY	badry
BDNAR	bednar
BDRK	badrak
BDRYK	badrak
'BDVAL'ZYZ	abdulaziz
'BDVL	abdul
'BDVLRHMN	abdalrahman
BDYN	bryn
BDYRA	bdira
BDYR	badir
BFJ	baefje
BGDAD	baghdad
BGLY	bagley
BGNVLD	bagnold
BGVYL	beryl
BGYR	bayer
BHAMND	bahamonde
BHARA	behara
BHNAM	behnam
BHRV	bahro
BHST	best
BHYJA	bahija
BJLY	bally
BKA	aka
BKAR	akar
BK	bk
BK	bk
BK	bk
BKDVR	badir
BKHVRST	backhurst
BKMN	akman
BKMN	akman
BKMYR	beckmeyer
BKR	baker
BKR	baker
BKR	baker
BKR	baker
BKS	bks
BKT	bat
BKVA	akiva
BKVF	backof
BKVK	back
BKVY	bakaya
BKVYT	bakaya
BKVYYR	bayer
BKY	becky
BKY	becky
BKYNGSAL	beckingsale
BKYNGSL	byungse
BKYNGSYL	beckingsale
BKYR	baker
BKYS	beckys
BLA	bela
BLAC	black
BLAF	blal
BLAFS	blas
BLAHA	blaha
BLAK	black
BLAKSVM	blacks
BLALAK	blalock
BLAL	blal
BLAL	blal
BLAM	balham
BLAMKH	black
BLAMY	bellamy
BLANCARD	blanchard
BLANCH	blanche
BLANSDAN	blanstan
BLANSDN	blanstan
BLANSTAN	blanstan
BLANZDVN	blanstan
BLAS	blas
BLASDN	basin
BLASK	blask
BLASR	blair
BLASY	blas
BLASYVS	blasius
BLAVADNYK	blavatnik
BLAVYZ	blatz
BLAYT	blatt
BLAZ	blaz
BLAZK	blazek
BLAZKYYVZ	blazquez
BL	blu
BLDN	bolden
BLDRD	baldred
BLDVYJN	boldwijn
BLDVYN	baldwin
BLDVYYN	baldwin
BLDYNG	belding
BLDYNGTVN	baldington
BLGA	baliga
BLKA	balkan
BLK	bak
BLKLND	blokland
BLKLY	bally
BLKMN	balkan
BLKMN	balkan
BLKSVM	balsam
BLKSYR	bekesy
BLKVL	blal
BLNK	blank
BLNKHVRN	blenkhorn
BLNKV	blank
BLNKY	belenky
BLS	blas
BLTBRG	blattberg
BLTRAV	beltrao
BLV	blvd
BLVC	blvd
BLVHM	blohm
BLVKSVM	balsam
BLVM	blom
BLVMBRG	bloomberg
BLVMN	belvin
BLVMNFLD	blumenfeld
BLVNSDVM	blunsdon
BLVNSDVN	blunsdon
BLVNZDM	blvd
BLVRNJ	belvin
BLVSKVM	blask
BLVYN	belvin
BLVZ	blaz
BLVZVM	blaz
BLYK	black
BLYK	black
BLYN	boleyn
BLYN	boleyn
BLYNDA	lynda
BLYNGASLY	billingsley
BLYNGTN	alington
BLYNKV	blank
BLYNKV	blank
BLYNKVV	blank
BLYR	bayer
BLYSTVN	blystone
BLYTA	blyth
BLYVYS	levys
BLYZ	blaz
BNAKSY	bakaya
BNAMAR	benamar
BNAN	banan
BNARY	badry
BN	ben
BNDANG	bandung
BNDASTVN	bandstone
BNDK	bendek
BNDLY	bandy
BNDR	andr
BNDRVB	banderob
BNDY	bandy
BNG	bang
BNG	bang
BNG	bang
BNGT	bengt
BNH	bench
BNJYMAN	benjiman
BNKR	banker
BNKR	banker
BNKS	banks
BNR	abner
BNS	bens
BNSN	bensen
BNSN	bensen
BNSVN	bensen
BNT	bantu
BNT	bantu
BNT	bantu
BNTLY	bentley
BNTN	banton
BNTN	banton
BNTV	bantu
BNTVN	banton
BNTZ	bentz
BNTZ	bentz
BNYA	baniya
BNYAMYN	beniamin
BNYFASYVS	belfasts
BNYN	bryn
BNZ	benz
BNZN	banan
BQYR	baqir
BRABANT	brabant
BRABY	araby
BRACMN	brachman
BRAD	brad
BRAD	brad
BRADLY	bradly
BRADR	badr
BRADRTN	braden
BRADRTVN	barton
BRADSAV	bradshaw
BRADY	brady
BRADYS	bradlys
BRAFVRD	bradford
BRAGHAM	braham
BRAHAM	braham
BRAHYM	braham
BRAK	brake
BRAKLY	bradly
BRAKNY	brackney
BRAMBAV	barabbas
BRAM	bram
BRAMR	bram
BRAN	bran
BRAN	bran
BRAN	bran
BRANDL	brandel
BRANDY	brandy
BRANN	bormann
BRANSAV	branshaw
BRANSDVN	branden
BRANSKVMB	branscombe
BRANSVYK	brandy
BRANT	brant
BRANT	brant
BRARDY	brady
BRASARD	brassard
BRASAYR	brassard
BRASRZ	basra
BRASYRZ	brashers
BRAT	brat
BRATLT	bratlie
BRATR	brater
BRATYNA	bratina
BRAVN	brain
BRAVN	brain
BRAVNFYLD	brownfield
BRAVNR	beaver
BRAVNYNG	brannen
BRAVTVN	brampton
BRAVV	bravo
BRAVYC	brady
BRAYAN	bryan
BRAY	bray
BRAYD	brad
BRAYN	brain
BRAYNKLR	bankler
BRAYR	brar
BRAYS	brays
BRAYS	brays
BRAYSLAV	bratislava
BRAYSVN	brays
BRAYT	brant
BRAYTN	braden
BRAYTVN	brampton
BRAYTVYT	baptist
BRAZVN	braden
BR	br
BRBVR	barber
BRCA	bacar
BRCR	brar
BRD	bard
BRD	bard
BRDLY	bradly
BRDLY	bradly
BRDLY	bradly
BRDN	borden
BRDN	borden
BRDN	borden
BRDSANG	birdsong
BRDSAV	berislav
BRDY	brady
BRDYK	brady
BRDYT	brady
BRFVRD	barford
BRGANTY	briganti
BRGARD	burgaard
BRGAYLV	borgailo
BRG	berg
BRG	berg
BRGDAN	bergman
BRGLAND	berglund
BRGL	bergel
BRGMN	bergman
BRGR	berger
BRGS	borgs
BRGS	borgs
BRGSVN	bergson
BRGYVT	bergeot
BRHAN	burhan
BRJ	brij
BRKAH	barkah
BRKASPYR	breakspear
BRKAT	barakat
BRKAT	barakat
BRK	bark
BRK	bark
BRK	bark
BRKLY	barkley
BRKSFYLD	barksfield
BRKT	brat
BRKVL	barkell
BRKVVYC	barkley
BRKY	berkey
BRLACR	black
BRL	burl
BRLND	borland
BRLSVN	balson
BRLV	berle
BRLYN	bruyn
BRLYNG	burling
BRLYNG	burling
BRML	bermel
BRMN	barman
BRMN	barman
BRNADVS	bernadus
BRNAL	bernal
BRNAN	banan
BRNARD	barnard
BRNARD	barnard
BRNARDV	barnard
BRNARDY	barnard
BRNARDYN	bernardin
BRNARDZ	barnard
BRNCAVD	branchaud
BRNC	branch
BRNCLY	brenchley
BRNDAN	brendan
BRND	bernd
BRND	bernd
BRND	bernd
BRNDL	brandel
BRNDL	brandel
BRNDS	berends
BRNDVN	branden
BRNDY	brandy
BRNDY	brandy
BRNDYS	brandys
BRNHARD	bernhard
BRNHART	barnhart
BRNHR	bernher
BRNR	brar
BRNSAV	barnshaw
BRNSV	berns
BRNT	bernt
BRNT	bernt
BRNT	bernt
BRNV	brno
BRNVL	bernal
BRNY	barney
BRNY	barney
BRNYR	breyer
BRNZ	benz
BRQ	br
BRSAV	barsai
BRS	brs
BRSFVRD	beresford
BRSLAV	berislav
BRSLR	bresler
BRSMN	bremen
BRSVN	bryson
BRSY	bray
BRT	bart
BRTLSVN	bertelson
BRTN	barton
BRTRAND	bertrand
BRTR	brar
BRTS	berts
BRTVN	barton
BRTVN	barton
BRTVN	barton
BRTY	bruty
BRTY	bruty
BRTYH	barth
BRVANHAT	branshaw
BRVARK	bark
BRVDA	broda
BRVD	blvd
BRVDFYLD	bradford
BRVDHAST	bradshaws
BRVDLY	bradly
BRVDR	broder
BRVDRTVN	braverman
BRVHL	brohl
BRVKAV	brokaw
BRVK	brevik
BRVK	brevik
BRVK	brevik
BRVK	brevik
BRVKN	broken
BRVKNR	bruckner
BRVKR	barker
BRVKS	borks
BRVKSL	borks
BRVKVL	baikal
BRVKZ	brake
BRVMBRG	bromberg
BRVMBRGR	bromberger
BRVMFYLD	brumfield
BRVMLY	bromley
BRVMYJ	brady
BRVNL	bernal
BRVNR	bruner
BRVNVYYN	branden
BRVNYYV	brandy
BRVR	brar
BRVSRD	brassard
BRVSTR	berster
BRVSYAV	berislav
BRVTY	bruty
BRVTZMN	brutzman
BRVVR	brar
BRVYK	brevik
BRVYLV	beryl
BRVYN	bruyn
BRVYNS	bryons
BRVYNYNG	browning
BRVYR	breyer
BRVYR	breyer
BRVZ	broz
BRXARD	barnard
BRYAN	bryan
BRYAN	bryan
BRYANT	bryant
BRY	bray
BRY	bray
BRY	bray
BRY	bray
BRYBR	breyer
BRY	bray
BRY	bray
BRYDLAV	berislav
BRYDVL	bryde
BRYDY	brady
BRYDYNG	breeding
BRYGVY	bryguy
BRYJ	brij
BRYJ	brij
BRYJMN	bryan
BRYKASPYR	breakespear
BRYKSPYR	breakspear
BRYL	beryl
BRYM	bram
BRYMR	breyer
BRYMSTVN	brimstone
BRYN	bryn
BRYN	bryn
BRYNDAN	brendan
BRYND	brand
BRYNDL	brandel
BRYNGARDNR	bringardner
BRYNGTN	barrington
BRYNGTVN	barrington
BRYNK	brink
BRYNKMN	brinkman
BRYNR	bryner
BRYNSN	brinson
BRYR	brar
BRYR	brar
BRYS	brays
BRYS	brays
BRYSBYN	brisbin
BRYSBYN	brisbin
BRYSNV	bryson
BRYSTVL	bristol
BRYSYNDA	brisinda
BRYTA	brita
BRYT	brat
BRYTLYNG	breitling
BRYTV	blyth
BRYTVN	breton
BRYTYS	bettys
BRYVN	bryan
BRYVNY	bryony
BRYVR	breyer
BRYVRY	bryguy
BRYYKPR	breyer
BRYYTVN	brenton
BRYZA	bereza
BRZA	bereza
BSAK	bosak
BSAM	besam
BS	bs
BSBRYS	besbris
BSKT	basit
BSKV	besko
BSL	basel
BSMA	basma
BSMY	basma
BST	best
BSVAL	baal
BSVL	basel
BSVN	basin
BSYL	beyl
BSYM	basem
BSYRA	byra
BSYT	basit
BTAN	bataan
BTCLDR	batchelder
BTHVN	bethan
BTL	batel
BTMN	batman
BTRYS	beryls
BTSY	betsy
BTVL	batel
BTY	betsy
BTY	betsy
BTYG	tyng
BTYYV	bayly
BTZA	betza
BVALY	bally
BVAS	avas
BVAY	bovary
BVAY	bovary
BVAYVYN	bayern
BV	bev
BVBY	abby
BVBYS	abbys
BVCA	bacar
BVCA	bacar
BVC	bic
BVCGA	bagga
BVDA	beda
BVDA	beda
BVDAPATY	bodapati
BVDAR	bednar
BVD	blvd
BVD	blvd
BVD	blvd
'BVDHABY	abudhabi
BVDLA	bodla
BVDN	baden
BVDN	baden
BVDNMYLR	bodenmiller
BVDRA	badrak
BVDRV	badr
BVDV	blvd
BVDVR	badir
BVDVYN	bauduyn
BVDY	badry
BVDYVN	baden
BVDYVYN	bauduyn
BVFALV	buffalo
BVGARD	bogaard
BVGHAM	baugham
BVGS	bugs
BVHL	buhl
BVHR	bohr
BVJY	bovary
BVKL	bokel
BVKL	bokel
BVKLY	bally
BVKR	baker
BVKSY	bekesy
BVKVN	baken
BVLA	bela
BVLARD	abelard
BVL	abel
BVLDN	bolden
BVLDT	boldt
BVLDVYJN	boldwijn
BVLDZR	balder
BVLF	bolef
BVLN	balin
BVLR	byler
BVLR	byler
BVLTAN	beltane
BVLTN	bolton
BVLTVN	bolton
BVLV	blvd
BVLVC	blvd
BVLVS	balis
BVLVYJN	belvin
BVLYNG	aveling
BVMBR	bomber
BVMBRGR	bomberger
BVM	bum
BVMGARDNR	bumgardner
BVMHARD	bomhard
BVMN	bevan
BVNANDR	bonander
BVNAR	bonar
BVNAVGLYA	bonavoglia
BVN	ben
BVN	ben
BVNGARD	bongard
BVNSTRA	boonstra
BVNTN	banton
BVNVMV	bonomo
BVNVNV	banan
BVNY	bandy
BVNYFASS	bunyans
BVNYFASYVS	beaufays
BVNYFKYVS	bangkoks
BVNYFYSS	bernayss
BVNYN	bunyan
BVNYTZ	bentz
BVQAM	avram
BVRA	byra
BVRAD	brad
BVRAP	avram
BVRASCY	buraschi
BVR	bar
BVRCRT	barcroft
BVRDR	border
BVRDYK	brady
BVRGA	borgia
BVRG	berg
BVRGV	bargh
BVRGYVYS	burgoynes
BVRJYA	bryan
BVRKVAL	baikal
BVRKVL	barkell
BVRKVYL	barkell
BVRKY	berkey
BVRL	burl
BVRL	burl
BVRLN	berlin
BVRM	borm
BVRML	bermel
BVRMN	barman
BVRSL	baral
BVRST	borst
BVRSYR	berster
BVRVS	barrs
BVRYJ	beryl
BVRYL	beryl
BVRYLLV	berilla
BVRYS	bovarys
BVRYVN	bryan
BVRYZ	bartz
BVRZ	bartz
BVSA	busa
BVSAL	baal
BVSART	bossart
BVSARV	baskar
BVSAYSN	bayse
BVS	avs
BVS	avs
BVS	avs
BVS	avs
BVS	avs
BVS	avs
BVSCA	biscay
BVSCGA	boschga
BVSGA	bagga
BVSKA	baskar
BVSK	besko
BVSLY	bosley
BVSNL	basel
BVSNY	benny
BVSTAK	bostak
BVSTAMNT	bustamante
BVST	best
BVSTRAM	bertram
BVSTRVM	bostrom
BVSTVN	boston
BVSTYK	bostak
BVSVAL	boswall
BVSVL	basel
BVSVM	basem
BVSVN	basin
BVSVR	basir
BVSVYSN	boshuysen
BVSY	betsy
BVSY	betsy
BVSYK	bosak
BVSYSN	basson
BVSYVYSN	boshuysen
BVTARY	bovary
BVTAYS	butaysh
BVT	bat
BVT	bat
BVTCR	butch
BVTLR	butler
BVTRL	batel
BVTRS	butrus
BVTSYH	betsy
BVTVN	banton
BVTZ	bitz
BVVDVYN	bauduyn
BVVN	bevan
BVVY	bev
BVXNY	benny
BVY	ivy
BVYKV	boyko
BVYLN	boylan
BVYR	bayer
BVYRKVYL	barkell
BVYS	abbys
BVYS	abbys
BVYSVYKS	betsys
BVYSYV	bayly
BVYVN	bryan
BVYZY	bayly
BVZANCYV	bojanchev
BVZ	baez
BVZKART	bozkurt
BVZMAN	bozeman
BVZVA	aviva
BVZVAL	afzal
BVZVVA	aviva
BVZVVYL	beryl
BVZYDAR	bozhidar
BVZYD	boyd
BYAKV	bak
BYAN	abyan
BYANG	bang
BYANGTAY	byungtae
BYATLYNG	beutling
BYAVYS	beavis
BY	abby
BYBL	byblos
BYBR	byer
BYCAM	bacar
BYC	bic
BYCLY	bayly
BYCMP	basecamp
BYCYNGSYL	beckingsale
BYCZ	bryce
BYDA	bayda
BYDL	bayda
'BYD	boyd
BYDV	bayda
BYDVL	abdul
BYDY	badry
BYF	beyl
BYFJH	baefje
BYFRAST	bifrost
BYG	big
BYGLHL	bagley
BYGND	bigend
BYGNVALD	ragnvald
BYGV	bev
BYGVRDAN	bigourdan
BYGZ	baez
BYHAN	beyhan
BYHYV	bayly
BYJ	beyl
BYJH	blyth
BYKA	byra
BYKARD	bayard
BYK	bak
BYK	bak
BYK	bak
BYK	bak
BYKLY	bayly
BYKN	abyan
BYKNST	bakeneset
BYKRASTAF	bickerstaffe
BYKRASTAFY	bickerstaffe
BYKRASTF	ballast
BYKRASTYF	grasty
BYKR	byer
BYKRSTF	borst
BYKRTN	byron
BYKSLR	basler
BYKVL	bokel
BYKVN	baken
BYLAL	bilal
BYLANY	billany
BYL	beyl
BYL	beyl
BYL	beyl
BYLHAR	bilhar
BYLKY	bayly
BYLNGTVN	baldington
BYLR	byler
BYLR	byler
BYLR	byler
BYLS	byles
BYLV	bayla
BYLYKVK	bayly
BYLYNGASLAY	billingsley
BYLYNG	ayling
BYLYNGSLY	billingsley
BYLYNGTVN	baldington
BYLYNGZ	ayling
BYLYNSKY	bilinsky
BYLYR	byler
BYLZ	bayla
BYLZYBAB	beelzebub
BYMN	lymn
BYMYNG	byung
BYN	bryn
BYN	bryn
BYN	bryn
BYN	bryn
BYNDMN	bygden
BYNFNG	bienfang
BYNG	byung
BYNH	bench
BYNJN	bynon
BYNMDART	bainmedart
BYNQAM	behnam
BYNR	bryner
BYNS	bens
BYNS	bens
BYNVD	binod
BYNVY	bandy
BYNY	bryony
BYNY	bryony
BYNY	bryony
BYNYYVN	bunyan
BYNZ	benz
BYNZ	benz
BYNZ	benz
BYPYN	bipin
BYRA	byra
BYR	byer
BYR	byer
BYR	byer
BYR	byer
BYR	byer
BYRBK	barb
BYRC	byra
BYRD	byrd
BYRD	byrd
BYRDMR	border
BYRDN	byrd
BYRFYS	brays
BYRG	berg
BYRGL	bergel
BYRK	bark
BYRLA	byra
BYRMN	byron
BYRNBVYM	barnaby
BYRN	byrne
BYRNH	byrne
BYRNS	byrnes
BYRTAY	barta
BYRT	bart
BYRTRYK	barry
BYRTYH	barth
BYRTYH	barth
BYRVT	bart
BYRYC	bryce
BYRYGANTY	briganti
BYRYNG	bering
BYRZ	byra
BYSAYV	biscay
BYS	abbys
BYSH	bush
BYSKMP	basecamp
BYSL	basel
BYSLY	bayly
BYSMARK	bismark
BYSM	basem
BYSR	byer
BYSTANDR	bystander
BYST	best
BYST	best
BYSYN	bryson
BYTANKRT	bystander
BYTARD	bastard
BYT	bat
BYT	bat
BYTMN	batman
BYTN	abyan
BYTRAYS	brays
BYTRYK	amtrak
BYTZ	bitz
BYVAN	bevan
BYV	bev
BYVCAMP	basecamp
BYVCMP	basecamp
BYVDVYN	bauduyn
BYVFYZ	buffy
BYVGAM	baugham
BYVKMP	backman
BYVKRAFT	kraft
BYVLY	bayly
BYVLYV	bayly
BYVMNT	belmont
BYVMVNT	belmont
BYVNGS	byungse
BYVR	byer
BYVRLY	beverly
BYVRZ	byer
BYVSH	ayush
BYVTL	bartle
BYVYS	bovarys
BYVZVYL	beryl
BYYVCMP	basecamp
BYYVNYK	bryony
BYZ	baez
BYZR	byer
BYZVANAT	biswanath
BYZVAS	sylvias
BYZVYL	beryl
BYZYR	bizer
BZVA	bevan
CAGN	cage
CAKV	cave
CALK	chalk
CAMBRLAYN	cambrian
CAMPLYN	champlin
CAND	candy
CANDRAN	chandran
CANDR	andr
CANDVNYA	chandonia
CANSY	candy
CANY	candy
CAPLA	cala
CAPL	cal
CAPMN	chapman
CAPRA	capra
CAPYN	calsyn
CARD	caird
CARLTN	carlton
CARLTVN	carlton
CARLVT	arlet
CARLY	carly
CARLYH	carly
CARLYN	carolyn
CARLZ	carl
CARNG	charng
CARTVN	carlton
CARYK	cary
CAS	cas
CASMZ	chasms
CASTYN	calsyn
CATANY	castano
CAV	cave
CAVDA	chavda
CAVHAN	calahan
CAVN	cain
CAVVYN	calsyn
CAVVYV	calsyn
CAVZ	cave
CAY	cary
CAYKN	canyon
CAYLD	called
CAYLDZ	cadiz
CAYZ	cadiz
CH	che
CKRD	ackroyd
CLATVN	clanton
CLYVS	clovis
CLYYAN	cayman
CMALY	chemaly
CMBRLYN	charlyn
CMBRZ	cabre
CMBZY	bombay
CNADR	canada
CN	c
CND	and
CNDLR	chandler
CNSLVR	culver
CNTH	cantu
CNY	candy
CPDY	cody
CPZ	cape
CRAG	craig
CRASKAYNT	prashant
CRBL	arbil
CRC	circe
CRCYL	crecy
CRPY	cray
CRSKYNAY	cristina
CRVBYNY	cerveny
CRVYC	cray
CRY	cary
CRY	cary
CRYL	cheryl
CRYSKYNTY	chrescyntie
CRYSTAL	crystal
CRYSYNTH	chrescyntie
CSBRV	cabre
CS	cs
CSNY	chesny
CSNY	chesny
CSTR	caster
CTAL	cal
CT	cat
CTVYN	cathryn
CVA	ava
CVA	ava
CV	av
CV	av
CV	av
CV	av
CV	av
CVDHARY	choudhary
CVKRY	avery
CVKSY	bekesy
CVLKA	cala
CVN	avon
CVNPYG	candy
CVRN	chern
CVSAK	chusak
CVVANAK	chovanak
CVY	chevy
CVY	chevy
CVYLR	coyle
CYA	ca
CYA	ca
CYAKY	cary
CYANG	chang
CYBANSKY	cybanski
CY	coy
CY	coy
CYCSTR	caster
CYK	cyr
CYK	cyr
CYK	cyr
CYKN	ayn
CYKRY	camry
CYKY	becky
CYKZ	coke
CYLDZ	cadiz
CYLT	celt
CYLTH	celt
CYLTJ	celetje
CYLTJH	celetje
CYLY	lyly
CYLYJH	blyth
CYLYNGVRS	challengers
CYLYNGVRT	calvert
CYM	cm
CYN	ayn
CYN	ayn
CYNN	conn
CYNV	coyne
CYP	cyr
CYP	cyr
CYPLVYDN	calsyn
CYPMN	cayman
CYPN	cyprian
CYRAG	cherag
CYRAK	cyrano
CYSM	chism
CYSMN	ayson
CYSTY	casey
CYSVLM	anselm
CYTA	cetia
CYTAM	coram
CYTAN	cayman
CYT	cat
CYT	cat
CYTRDY	chitrady
CYTVVD	active
CYTVYN	cathryn
CYTYK	cathy
CYV	cyr
CYV	cyr
CYZVBA	chizoba
CYZV	cyr
CYZVRV	cyr
DABAC	baback
DABAS	dadas
DABL	dahl
DABNY	dabney
DABS	dais
DABSVN	dabin
DABVS	darbys
DABVYS	darbys
DABYL	daryl
DABYNSKY	dubinsky
DABYNSN	dobyns
DABYNSVN	dobinson
DABYNZ	dabin
DADA	dada
DAD	dada
DADGYVN	dady
DADH	dada
DADK	dada
DADLY	dady
DADS	dadas
D'A	dea
DADV	dada
DADYR	dady
DAF	dag
DAGAN	dagan
DAGAN	dagan
DAG	dag
DAG	dag
DAG	dag
DAGLY	dagley
DAGN	dagan
DAGR	dag
DAGRTY	daugherty
DAGRZ	agra
DAGVAC	dagan
DAGZ	dag
DAHAK	dahar
DAHAML	duhamel
DAHN	dahl
DAHRTY	daugherty
DAHVD	david
DAHVK	dahuk
DAJ	dag
DAJ	dag
DAJYVN	darvon
DAKAS	dakars
DAK	bak
DAK	bak
DAK	bak
DAKHVRN	dockhorn
DAKLVZ	akiva
DAKMN	dakin
DAKN	dakin
DAKRYNG	darling
DAKS	dais
DAKS	dais
DAKTRZ	dakar
DAKV	dakar
DAKVRS	dakars
DAKYNG	dakin
DAKYNZ	dakin
DAKZ	danz
DALAJR	dalager
DALAN	dalian
DALAS	dallas
DALAYR	dalager
DALBK	dalbec
DALBRGR	dulberger
DALBYR	alber
DAL	dal
DAL	dal
DAL	dal
DALFR	darfur
DALMN	adalma
DALMS	adalma
DALMYYA	dalmia
DALNZ	danz
DALRS	adars
DALRYMPL	dalrymple
DALTVN	dalton
DALY	daly
DALY	daly
DALY	daly
DALY	daly
DALYNAR	dolinar
DALYNGR	dalager
DAMAR	dhamar
DAMBL	gamble
DAMLR	daimler
DAMPLTVN	dumpleton
DAMVN	damon
DAMVNTT	dumontet
DAMYAN	damian
DAMYANV	damian
DAMYLA	djamila
DAMYNGS	damons
DAMYNY	damon
DAMYNYKAS	amandas
DAMYTRV	datri
DAMYVN	damian
DANA	dana
DANALD	danald
DANA	dana
DANAVAN	canaan
DAN	dan
DANDAS	dadas
DAN	dan
DAN	dan
DAN	dan
DANDY	andy
DANFRD	dunford
DANFY	dancy
DANG	bang
DANG	bang
DANGTAY	dongtai
DANGVY	dancy
DANGYV	dancy
DANGYVN	angevin
DANHAM	denham
DANH	danih
DANJL	banjul
DANKAN	balkan
DANKV	danko
DANKV	danko
DANKY	dancy
DANLVP	dunlap
DANLY	daly
DANNBARGR	danenbarger
DANNLY	danny
DANR	dan
DANSMVR	dinsmoor
DANSTR	dunster
DANSY	daisy
DANSYNG	dancing
DANTN	danton
DANVAN	donovan
DANY	dancy
DANY	dancy
DANYDYN	andy
DANYL	daryl
DANYL	daryl
DANYL	daryl
DANYLSVN	danielson
DANYLV	danald
DANYLZ	danald
DANYS	dannys
DANYYLS	danials
DANZ	danz
DAPAY	papay
DAPNYK	danny
DAPRK	apr
DAPRRY	darryl
DAPRY	darby
DARANG	darling
DARA	darla
DARBY	darby
DAR	adar
DARHAM	durham
DARL	darla
DARLY	darley
DARLYNGTN	darlington
DARNAL	darnall
DARNL	darnall
DARNL	darnall
DART	dart
DARV	dare
DARVN	darvon
DARYGVS	daryls
DARYL	daryl
DAS	das
DAS	das
DASN	dan
DASVN	darvon
DASYNG	calsyn
DASYVK	daisy
DAT	dart
DATH	darth
DATJH	daatje
DATRY	datri
DATSVN	dawson
DATVN	dalton
DATVYT	davy
DATY	dady
DATY	dady
DAVAD	davao
DAVARK	dahar
DAVBR	dauber
DAVD	david
DAVD	david
DAVD	david
DAV	dave
DAV	dave
DAV	dave
DAVKNYZ	danny
DAVKYNZ	dakin
DAVN	dan
DAVNPRT	davenport
DAVNY	danny
DAVNYNG	dawning
DAVNYNG	dawning
DAVRS	daves
DAVRYN	daverin
DAVSAN	davison
DAVS	daves
DAVSN	davison
DAVSVN	davison
DAVT	dart
DAVVD	david
DAVVD	david
DAYAL	dalal
DAYAN	dagan
DAYAN	dagan
DAYANYSYA	dannys
DAYANYSYS	cabaniss
DAYAZ	ayah
DAYBALA	dyballa
DAYBL	daryl
DAYCYNC	dancing
DAY	day
DAY	day
DAYDRYC	badry
DAY	day
DAYK	day
DAYKSVN	ayson
DAYKY	bayly
DAYKYNK	dakin
DAYKYNZ	dakin
DAYLAYGAN	malayan
DAYLVN	dallan
DAYMND	dymond
DAYN	ayn
DAYN	ayn
DAYR	dayr
DAYRDRYK	darryl
DAYR	dayr
DAYRKTVR	arter
DAYRT	dart
DAYS	dais
DAYT	dart
DAYVD	david
DAYVRJH	darth
DAYVRJH	darth
DAYVRT	dart
DAYVRTH	darth
DAYVRTJ	dart
DAYVRTJ	dart
DAYVRYA	arya
DAYVVN	darvon
DAYVYN	darvon
DBATVNYA	debathonia
DBLR	deibler
DBYT	bat
DDFYLD	deadfield
DDJN	dijon
DDRYK	daryl
DDY	addy
DFRVY	defroy
DGLY	dagley
DGRAF	degraff
DGRF	degraff
DGRLVND	degerlund
DGVTARDY	degotardi
DHA	doha
DHAMAR	dhamar
DHNR	dehner
DHNRT	dehnert
DHVK	dahuk
DJAMYLA	djamila
DJLY	daly
DKAN	dekan
DKK	dekok
DKLRK	dierk
DKR	dakar
DKSTR	dikstra
DKYAH	ayah
DKY	day
DK	dik
DLAL	dalal
DLANY	delaney
DL	dal
DLH	delhi
DLMAN	dolman
DLNY	daley
DLRD	dallard
DLRYV	daryl
DLTN	dalton
DLTVVYA	deltuvia
DLVRA	elvira
DLVRYZ	alvarez
DLVYS	daleys
DLY	daly
DLYKATNY	delikatny
DLYS	daleys
DLYSYV	alyson
DMA	dema
DMA	dema
DMKAK	demcak
DMKH	demke
DML	dal
DMLR	demler
DMN	damon
DMPSTR	dempster
DMR	dr
DMRZ	marz
DMSQ	dimashq
DMYLA	diyala
DMYNYSVS	dionysus
DMYS	amys
DNALD	danald
DNAQY	anay
DNAVLT	denault
DN	dan
DNDLR	dandler
DN	dan
DNDRYJ	landry
DNG	deng
DNHAM	denham
DNJVR	denver
DNKVALTR	denkewalter
DNKYND	danekind
DNL	dal
DNMN	denman
DNNL	danny
DNRYJ	daryl
DNSR	dingsor
DNTVN	danton
DNV	dov
DNVKS	daves
DNYH	danih
DNYL	daryl
DNYLZ	doyle
DNYNG	drying
DNYS	dannys
DNYSVN	dyson
DRABK	drabek
DRADR	drader
DRAGAN	dragan
DRAGANYS	draganis
DRAGN	dragan
DRAGR	drag
DRAKMN	dratman
DRAL	aral
DRALT	dralle
DRAMATYS	dramatis
DRAM	dream
DRAP	drag
DRAPR	draper
DRAST	doras
DRATMN	dratman
DRATY	dreary
DRAVN	craven
DRAVR	drader
DRAYNH	draine
DRAYR	dayr
DRBS	darbys
DRBY	darby
DRCMN	drachman
DRDH	darde
DRG	drag
DRGVMYR	dragomir
DRGVN	dragan
DRGVNS	dragons
DRK	dirk
DRKSL	dirks
DRMVT	dermott
DRNAL	darnall
DRNK	drnek
DRNTR	drenter
DRSNR	dressner
DRTCN	dortchen
DRTH	darth
DRV	dov
DRV	dov
DRVDYNG	druding
DRVDYS	drudis
DRVMAND	armand
DRVMR	drover
DRVNY	cerveny
DRVNYS	dannys
DRVR	dror
DRVT	dart
DRVYK	drevik
DRVYT	davy
DRVZN	darvon
DRYDJY	dryden
DRYFVS	dreyfus
DRYJR	dreyer
DRYK	daryl
DRYK	daryl
DRYM	drum
DRYMR	dreyer
DRYMZ	drum
DRYNKS	drinks
DRYNZ	drying
DRYR	dayr
DRYRY	drury
DRYS	darbys
DRYSKVL	driskill
DRYSKYL	driskill
DRYV	daryl
DRYV	daryl
DRYVT	drout
DRYXA	arya
DS	ds
DSL	dal
DSMVLYNZ	desmoulins
DSMVND	desmond
DSMYT	desmet
DSNVYRZ	denver
DSRAZYRS	fraziers
DSRVZYRZ	dreyer
DSTLY	astley
DSVTV	adsett
DTLFS	detlefs
DTMN	atman
DTRYJ	daryl
DTS	dots
DTVYLR	taylor
DVA	ava
DVAK	davao
DVALYBAY	albany
DVAN	dan
DVANYR	dayr
DVAR	dear
DVARTH	darth
DVAYKYNK	dakin
DVBAY	dubay
DVBRATZ	dobbratz
DVBRYDJ	bryde
DVBRYKYN	dobrikin
DVBRYZ	avery
DVBSVN	dobson
DVBVYS	debbys
DVBYNSVN	dobinson
DVBYNYN	bynon
DVBYR	dayr
DVCARM	ducharme
DVCAYLARD	duchaylard
DVCT	advent
DVCYNC	dobyns
DVDA	dada
DVDAMANY	dodamani
DVD	david
DVDGVN	dodgen
DVDJ	dada
DVDL	advil
DVDLY	dudley
DV	dov
DV	dov
DVFVR	darfur
DVGAN	dagan
DVGAN	dagan
DVG	dag
DVGYVN	dagan
DVHA	doha
DVHH	dahl
DVHRTY	doherty
DVHVR	dahar
DVHYRST	dewhirst
DVJN	deven
DVK	dik
DVK	dik
DVLAN	dilan
DVL	advil
DVLKYA	divya
DVLMAN	dolman
DVLR	diver
DVLY	daly
DVLYN	devlin
DVMBA	domba
DVM	dem
DVM	dem
DVMN	damon
DVMNYKV	domeyko
DVMYKV	domeyko
DVMYKZ	domeyko
DVMYNGV	deming
DVMYNYKAS	dominicas
DVMYNYK	dominy
DVMYNYK	dominy
DVMYNYKS	dominicks
DVMYNYKYVS	minskys
DVMYNYN	dominy
DVMYNYVS	damons
DVNACY	dancy
DVNA	dvina
DVNALD	danald
DVNAT	donath
DVNATV	donath
DVNATY	donath
DVNAY	dvina
DVN	dan
DVN	dan
DVNG	deng
DVNHAM	denham
DVNKN	danko
DVNLY	daly
DVNPK	devenpeck
DVNPYK	devenpeck
DVNS	devins
DVNTSK	donetsk
DVNVAN	donovan
DVNYNY	danny
DVNYS	dannys
DVPALM	depalm
DVPLR	doppler
DVPLT	doppelt
DVPRY	avery
DVPYVYS	pygmys
DVRA	dora
DVRAND	durand
DVRAND	durand
DVRAN	doran
DVRAN	doran
DVRAPT	durant
DVRAS	doras
DVRASY	doras
DVRATH	barath
DVRATY	dorothy
DVRAVKS	baracks
DVRAYA	vaya
DVRAZYV	dorazio
DVRCAK	demcak
DVRCN	darcy
DVRDAL	dordal
DVRFMAN	dorfman
DVRHAM	durham
DVRKN	dorken
DVRKYN	dorken
DVRL	advil
DVRLD	darla
DVRMA	dorma
DVRND	durand
DVRND	durand
DVRN	dorn
DVRN	dorn
DVRRANS	darrens
DVRST	dorset
DVRSY	dorsey
DVRSY	dorsey
DVRTCN	dortchen
DVRT	dart
DVRTH	darth
DVRTJ	divertje
DVRTJH	darth
DVRTVN	darvon
DVRTY	dorthy
DVRTY	dorthy
DVRVC	dirac
DVRVTY	dorothy
DVRVYN	darvon
DVRY	dory
DVRYNDA	dorinda
DVRYS	averys
DVRYS	averys
DVRYSVMY	rysavy
DVS	avs
DVSKV	dusko
DVSN	davison
DVSTALYK	dostalik
DVSTY	dusty
DVTA	delta
DVVAYKYNK	dakin
DVVL	advil
DVY	davy
DVYKYNK	duyckinck
DVYKYNK	duyckinck
DVYN	davy
DVYNDR	devender
DVYNY	danny
DVYNYNG	dawning
DVYR	dayr
DVYSR	dayr
DVYT	davy
DVYTV	davy
DVYVYR	davy
DVYYKYNK	duyckinck
DVZAT	duzat
DVZYYR	dayr
DYAB	diab
DYA	diya
DYA	diya
DYALA	diyala
DYAMANTARAS	diamantaras
DYAMDY	dady
DYAMVND	diamond
DYANA	dana
DYAN	dylan
DYAZ	diaz
DYBAT	bat
DYBATH	debathe
DYBATVNYA	debathonia
DYB	dib
DYBL	dyballa
DYBT	dart
DYBTVNYA	lyubovny
DYBV	debs
DYBYT	darby
DYCYR	cyr
DYDA	ayda
DY	day
DY	day
DY	day
DYDRYSZ	dyers
DYDRYX	badry
DYDYRYCS	cedrics
DYGAN	dagan
DYGAZMN	deguzman
DYGH	dighe
DYGNARV	dagnall
DYGRAF	degraff
DYGRF	degraff
DYGRV	dyer
DYGV	dag
DYGVYD	david
DYKANYNK	danny
DYKAVTY	davy
DYK	dik
DYK	dik
DYKL	dekel
DYKNS	dykins
DYKNZ	dykins
DYKNZ	dykins
DYKSAY	dykes
DYKS	dykes
DYKSN	dykes
DYKSTRA	dikstra
DYKSVN	dyson
DYKSVN	dyson
DYKV	dykes
DYKV	dykes
DYKY	dicky
DYKY	dicky
DYKYNZ	dykins
'DYL	adel
DYLAN	dylan
DYLAYR	dayr
DYL	dal
DYLMA	dilma
DYLN	dylan
DYLNY	dylan
DYLR	dyer
DYLVRS	dyers
DYLY	daly
DYLY	daly
DYLYNGR	ayling
DYLYNGTN	darlington
DYLYP	daly
DYLYP	daly
DYLYV	daly
DYMAD	dymond
DYMA	dema
DYMA	dema
DYMARS	demars
DYMARST	demarest
DYMARYP	dimaryp
DYMAS	dumas
DYMASK	dumas
DYM	dem
DYMN	dymond
DYMRS	dyers
DYMSAK	demcak
DYMVK	demcak
DYMYNG	deming
DYMYTAR	dimitar
DYMYTRY	dimitry
DYMYTRYS	dimitris
DYMYTRYV	dimitry
DYMYTRYV	dimitry
DYMYTRYVS	demetrius
DYNA	dyna
DYNA	dyna
DYNA	dyna
DYNAMYT	dynamite
DYNBYM	dancy
DYN	dyna
DYN	dyna
DYN	dyna
DYNG	deng
DYNGLV	dangel
DYNGSVR	dingsor
DYNGY	dinghy
DYNGY	dinghy
DYNL	dyna
DYNLR	dinler
DYNN	dinn
DYNPYK	dunphy
DYNR	dyer
DYNS	dobyns
DYNS	dobyns
DYNSMVR	dinsmoor
DYNT	dent
DYNV	dyna
DYNY	dyna
DYNYNGR	deininger
DYPAK	dipak
DYPAYVLA	depaola
DYPAYVLV	pavlov
DYPBVY	dipboye
DYPLD	dippold
DYPRSYV	dyers
DYPRTR	deporter
DYPYTRV	dipietro
DYR	dayr
DYR	dayr
DYR	dayr
DYRDRK	deirdre
DYRDRYK	darryl
DYRK	dirk
DYRK	dirk
DYRKS	dirks
DYRVKV	darvon
DYRVRTJ	dievertje
DYSANTV	desanto
DYSAV	rysavy
DYSAY	rysavy
DYS	andys
DYSGY	dusty
DYSMVND	desmond
DYSNT	dyson
DYSTL	distel
DYTJY	sytje
DYTMAR	dietmar
DYTR	dyer
DYTVRZ	datri
DYTVTALA	ditutala
DYVA	dyna
DYVAKARVNY	divakaruni
DYVANATAN	devanathan
DYVAN	dylan
DYVAR	dahar
DYVAYN	dylan
DYVAYN	dylan
DYVAYZR	dayr
DYVHA	divya
DYVN	deven
DYVNH	dyna
DYVNPK	devenpeck
DYVNYDA	dionida
DYVRT	dart
DYVRT	dart
DYVRTH	darth
DYVRTJ	divertje
DYVRTJH	divertje
DYVRTJH	divertje
DYVVSR	daves
DYVYA	divya
DYVY	davy
DYVYD	david
DYVYD	david
DYVYD	david
DYVY	davy
DYVYDSVN	davidson
DYVYDYAN	davidian
DYVYLDH	danald
DYVYS	daves
DYVYSN	davison
DYVYSVN	davison
DYVYT	davy
DYYALA	diyala
DYZNY	danny
DYZR	dyer
DYZVN	dizon
DZ	d
DZGAGNH	desgagne
FABLR	faber
FABRH	fabre
FABRV	fabre
FABRYS	fabris
FABYANV	abyan
FACS	acs
FAD	fadl
FADL	fadl
FADNBRG	fudenberg
FADVR	adar
FADYLA	fadila
FADYL	fadil
'FAF	afaf
FAGAN	fagan
FAGANS	fagans
FAJN	fan
FAJYVAR	hajar
FAKS	farkas
FALCVK	falchuk
FALK	falk
FALKNR	faulkner
FALKRSVN	fulkerson
FALKV	falk
FALKVNR	faulkner
FALN	falk
FALSAM	balsam
FALTAK	foltak
FALTLS	faultless
FALTVN	alton
FALVN	alvin
FALY	daly
FALYVT	salyut
FALZ	faiz
FAMYVS	amys
FANDRYC	fandrich
FANG	bang
FANGVS	angus
FANTS	kants
FARA	farag
FARAG	farag
FARAGV	farag
FARAT	fafat
FARKAS	farkas
FARL	carl
FARLY	farley
FARMR	farmer
FARSBRG	forsberg
FARST	farsi
FARTK	bartok
FARVANYA	farwaniyah
FARVANYAH	farwaniyah
FARVGYA	farrugia
FARVK	farouk
FARVK	farouk
FARVQ	farooq
FARVZ	fairuz
FARYD	farid
FARY	farry
FARYHA	fariha
FARYVR	farer
FASBRG	fabbro
FAS	fash
FAS	fash
FASL	fasel
FATYMA	fatima
FATYS	fates
FAVAZ	fawaz
FAVL	fadl
FAVNS	avins
FAVNS	avins
FAVST	fast
FAVST	fast
FAVST	fast
FAVST	fast
FAVZYA	faiza
FAVZY	davy
FAVZYYA	fawziyya
FAXRY	farry
FAYF	fay
FAYK	falk
FAYLS	fayes
FAYN	fayne
FAYNK	fayne
FAYNLY	bayly
FAYNRTY	finerty
FAYNSTVN	mayston
FAYNTVN	paynton
FAYRBANK	fairbank
FAYRVZ	fairuz
FAYT	fast
FAYYZ	fayiz
FAYZA	faiza
FAYZ	fayiz
FAYZ	fayiz
FAYZL	faizel
FAZA	faiza
FAZ	faiz
FAZL	fadl
FAZYA	faiza
FAZY	fay
FAZY	fay
FBRV	fabre
FCNR	fechner
FDL	fadl
FDR	dr
FDR	dr
FDRL	fadil
FDRMN	federman
FDVR	feder
FDYLA	dylan
FDYL	fadil
FHD	fahd
FHT	chet
FK	bk
FLAGLLY	flaglelee
FLAHRTY	flaherty
FLAKYGR	fluckiger
FLARDYNGA	flardinga
FLAT	flat
FLAT	flat
FLAVKA	felawka
FLAY	clay
FLAYGYR	flygare
FLAYS	fays
FLDMAN	feldman
FLDMAR	feldmar
FLDMN	feldman
FLDR	felder
FLDSPAR	feldspar
FLJ	fla
FLK	falk
FLKYNZ	flynn
FLMR	flor
FLSTY	flesti
FLTH	blyth
FLTJ	fletje
FLTJH	fletje
FLTYV	floyd
FLVCH	fluche
FLVDYN	flodin
FLVRA	flora
FLVR	flor
FLVR	flor
FLVRK	florek
FLVRNS	alvins
FLVRS	elvers
FLVRY	flory
FLVRYN	flory
FLVRZ	alvarez
FLVT	flat
FLVVRZ	alvarez
FLVYD	floyd
FLYJH	blyth
FLYKS	flynns
FLYKYNGR	flickinger
FLYM	fly
FLYMYNG	fleming
FLYNDRZ	flanders
FLYNT	flint
FLYNY	flynn
FLYSZ	elyse
FLYVRY	fleury
FLYZARDV	felizardo
FMMTH	faith
FMT	fm
FMTJ	femmetje
FMYA	femea
FNCARC	encarta
FNDR	andr
FN	fan
FN	fan
FNG	feng
FNGR	fanger
FNR	fr
FNSKY	fenske
FNTVN	fenton
FNTYMAN	fentiman
FNVYK	envoy
FNY	fanny
FNYS	fannys
FRA	afra
FRAGVRGYA	frageorgia
FRAM	frahm
FRAMSAN	framson
FRAMSVN	framson
FRANDSN	frandsen
FRAN	fran
FRANGAKYS	frangakis
FRANKL	frankel
FRANKL	frankel
FRANKLYN	franklin
FRANKV	frank
FRANKV	frank
FRANKVY	frank
FRANKVYS	francoys
FRANKVYZ	francoys
FRANS	frans
FRANSR	franser
FRANSSYDTJ	franscyntje
FRANSVYZ	francoys
FRANSYKA	fransiska
FRANSYNTAY	franscyntje
FRANSYNTH	franscyntje
FRANSYNTJH	franscyntje
FRANSYNTY	franscyntje
FRANSYNTYH	franscyntje
FRANSYNTZ	franscyntje
FRANSYSKA	fransiska
FRANSYSKA	fransiska
FRANSYSKAS	fransiska
FRANSYSKVS	fransiska
FRANSYSYVS	franciscas
FRANTYSK	frantisek
FRANTZN	frantzen
FRAQ	fran
FRARY	dreary
FRASR	fraser
FRAST	fast
FRASTY	grasty
FRAYDA	ayda
FRAYDMAN	freedman
FRAYDMN	fradkin
FRAYDY	brady
FRAY	bray
FRAYGRSA	fritgersa
FRAYTGRSA	fritgersa
FRAZR	frazer
FRAZYR	frazer
FRAZYYR	frazer
FRDA	freda
FRDAYNND	ferdinand
FRD	ford
FRDKYN	fradkin
FRDRKYNG	frederking
FRDRYK	fredrik
FRDRYK	fredrik
FRDRYK	fredrik
FRDRYK	fredrik
FRDRYKV	fredrik
FRDT	ford
FRDYA	freya
FRDY	freddy
FRDY	freddy
FRDYG	ferdig
FRG	farag
FRGT	forget
FRGVSN	ferguson
FRH	farah
FRJ	fr
FRJN	fran
FRLANG	furlong
FRLY	farley
FRM	arm
FRNANDS	fernandes
FRNANDV	fernando
FRNANDZ	fernandez
FRNASYSKAS	fransiska
FRNASYSKAZ	fransiska
FRNC	france
FRNK	frank
FRNK	frank
FRNKH	frank
FRNKL	frankel
FRNKL	frankel
FRNKLYN	franklin
FRNKSVN	frankson
FRNKVYS	francoys
FRNKVYZ	funky
FRNSAYNT	franscyntje
FRNS	ferns
FRNSNYT	franny
FRNSNYT	franny
FRNSVYS	francoys
FRNSYNTY	franscyntje
FRNSYSKA	fransiska
FRNSYSKA	fransiska
FRNZL	frenzel
FRQ	fr
FRR	furr
FRSR	fraser
FRTYK	fertik
FRVANYAH	farwaniyah
FRVANYH	farwaniyah
FRVK	fork
FRVK	fork
FRVMYN	foreman
FRVNYAH	farwaniyah
FRVZ	franz
FRYBRG	forsberg
FRYDA	freda
FRYDBRGR	friedberger
FRYD	fred
FRYDGYR	fridgeir
FRYDH	bryde
FRYDL	friedl
FRYDMAR	friedmar
FRYDMN	fridman
FRYDMN	fridman
FRYDRYK	fredrik
FRYDYN	dryden
FRY	fry
FRY	fry
FRYHA	fariha
FRYKS	fryes
FRYLND	freeland
FRYLYNG	forsling
FRYLYNGR	freilinger
FRYLZ	fayiz
FRYMAL	freemal
FRYMVT	fermat
FRYNGTVN	farrington
FRYNK	frank
FRYNK	frank
FRYR	fry
FRYR	fry
FRYRMAT	fermat
FRYS	freys
FRYS	freys
FRYS	freys
FRYTAG	freitag
FRYTAS	freitas
FRYT	fry
FRYTGRSA	fritgersa
FRYTN	aryan
FRYTS	frits
FRYTV	forsyth
FRYTVL	crystal
FRYTZYVS	fritzius
FRYVALD	freiwald
FRYVVGL	freivogel
FRYZ	fry
FRYZR	frazer
FRYZR	frazer
FSDAL	fosdal
FST	fast
FSYG	fasig
FTC	fac
FTCN	fatin
FTRA	fetra
FTR	fetra
FVD	fed
FVJY	fay
FVJYTA	fujita
FVJYVKA	fujioka
FVKV	fike
FVLDZ	valdez
FVLGAM	flame
FVLKANYS	falklands
FVLK	falk
FVLKS	folkes
FVLMN	feldman
FVLN	avalon
FVLR	flor
FVLR	flor
FVLY	fly
FVMRTVN	fumerton
FVNDAL	fundal
FVNDV	fonda
FVNGN	fongen
FVNG	feng
FVNKY	funky
FVNTNVT	fontenot
FVN	fan
FVNYVK	fenyes
FVRBS	forbes
FVRBZ	fairuz
FVRD	ford
FVRDHAM	fordham
FVRDSANDN	furdesanden
FVRJY	farry
FVRK	fork
FVRLANG	furlong
FVRMN	forman
FVRMN	forman
FVRNR	farer
FVRNY	fanny
FVRNY	fanny
FVRNYR	fafnir
FVRR	furr
FVRRV	farry
FVRSAYT	forsyth
FVRSAYT	forsyth
FVRSBLAM	forsblom
FVRSBRG	forsberg
FVRS	frs
FVRSYL	forsale
FVRT	evert
FVRTS	forts
FVRY	fry
FVSNG	fasig
FVT	fast
FVTRR	fetra
FVTS	fates
FVTYNVS	flynns
FVY	fay
FVYS	fays
FVYY	fay
FVZARD	fozzard
FVZY	fuzzy
FVZYH	fuzzy
FXRYA	freya
FXRY	fry
FXRYYA	freya
FXYR	cyr
FYABAN	fabian
FYAKSY	franks
FYASKVNARV	fiasconaro
FYBR	faber
FYDALGV	fidalgo
FYDL	fadl
FYDLR	fidler
FYDVR	feder
'FYF	afaf
FYGARD	figard
FYGVRA	figura
FYHAN	afghan
FYK	eyck
FYKS	dykes
FYLAKS	dylans
FYL	zyl
FYLK	falk
FYLPAT	flat
FYL	zyl
FYL	zyl
FYLPS	alps
FYLR	aylor
FYLVS	byles
FYLVZ	fayiz
FYLYAS	filias
FYLY	fly
FYLYP	fly
FYLYPS	cyclops
FYLYPS	cyclops
FYLZ	fayiz
FYMTJH	eyntje
FYMYJH	myth
FYNAN	feynman
FYNAN	feynman
FYNC	sync
FYN	ayn
FYN	ayn
FYNK	fink
FYNKL	finkle
FYNLY	finlay
FYNLY	finlay
FYNLY	finlay
FYNSTAD	finstad
FYNY	fanny
FYNYN	flynn
FYNYS	fannys
FY	fay
FYPS	fayes
FYRBNKS	fairbanks
FYRBRYN	bryn
FYR	cyr
FYRHRST	fairhurst
FYRMA	firma
FYRN	fern
FYRVDR	ayurveda
FYRVK	fork
FYRVZ	fairuz
FYRVZ	fairuz
FYSBYN	ayson
FYS	fays
FYS	fays
FYSK	fisk
FYSR	fays
FYTA	fatah
FYTC	fetch
FYTZJRALD	fitzgerald
FYTZVL	faizel
FYVR	byer
FYVSTL	feustel
FYZA	faiza
FYZ	fayiz
FYZH	ayah
FYZL	afzal
FZYA	freya
GABA	gaba
GABARA	gabara
GABBL	gabel
GABLR	gabler
GABRYLH	gabriel
GABRYLH	gabriel
GABRYYLSVN	gabrielsson
GABVR	gabor
GABYN	gabon
GACR	gaca
GADBRY	gadbury
GADBT	adit
GADBVRY	gadbury
GADBVYS	gadbois
GADFRVYD	godfrey
GADFRY	gadbury
GADGL	gadil
GADMN	cadman
GADRV	adri
GADSN	gadsden
GADSVARD	asgard
GADVYN	galvan
GADY	gandy
GADYJN	gadsden
GADYL	gadil
GAF	graf
GAF	graf
GAFNY	gaffney
GAFRAN	ghufran
GAFYN	gaffin
GAGNH	gagne
GAHRTY	gaherty
GAJNH	gagne
GAJR	gair
GALA	galea
GALAGHR	gallagher
GALAGR	dalager
GALAHAD	galahad
GALAN	galvan
GALANT	gallant
GALATYN	gallatin
GALAVY	galbavy
GALBAVAY	galbavy
GALC	gaelic
GALDN	galen
GAL	gaal
GAL	gaal
GAL	gaal
GAL	gaal
GALJ	gale
GALKV	galko
GALN	galen
GALP	gale
GALPYN	galpin
GALT	gale
GALV	gale
GALVLA	galila
GALVSN	galvan
GALVVY	galbavy
GALVY	galbavy
GALYBRT	galibert
GALY	daly
GALY	daly
GALY	daly
GALY	daly
GALYLA	galila
GALYLH	galila
GALYLH	galila
GALYTY	gallaty
GALYVN	galvan
GALYZYA	galizia
GAMAK	gamal
GAMAL	gamal
GAMBYNV	gambino
GAML	gamal
GAML	gamal
GAMRV	gamero
GAMRVS	camrys
GAMVN	gaiman
GAMYJ	gamay
GAMYSH	amish
GANAPATY	ganapathy
GANAR	ganatra
GANATRA	ganatra
GANAVAN	ghanaian
GANDLC	gandhi
GANDRSVN	andersen
GANDRZYK	gonderzik
GANDVRP	glandorf
GANDY	gandy
GAN	gan
GANG	gang
GANG	gang
GANGVLY	gangolli
GANL	gaal
GANRVS	gantrys
GANS	gans
GANSVN	ganesan
GANTRAM	guntram
GANTR	ganter
GANTR	ganter
GANTR	ganter
GANTRP	gantry
GANTRT	gantert
GANTVRP	ganter
GANTVRPH	ganter
GANTY	gantry
GANVN	granvin
GANVYL	gandy
GANYR	gainor
GANYSAN	ganesan
GANZAK	ganzak
GANZALZ	gonzalez
GAPTA	gatta
GAPYSTY	grasty
GARADVAN	garagan
GARAFALV	garofalo
GARANS	guaranis
GARBH	garbe
GARBY	darby
GARDNR	gardner
GARDYNR	gardner
GARFYLD	garfield
GARFYNKL	garfinkel
GARLYK	garlick
GARMZ	garms
GARN	garon
GARNR	garner
GARNT	garnett
GARNY	garry
GARSKY	gursky
GARSS	garms
GARSVL	garshol
GARSYA	arya
GART	garth
GARTMN	gartin
GARTRYJ	gantry
GARTYN	gartin
GARVD	garrod
GARVFALV	garofalo
GARVLA	arvola
GARVTV	gareth
GARYK	gary
GARYK	gary
GARYS	garrys
GARYTV	gareth
GASARD	asgard
GAS	gas
GASKAT	baskar
GASKVN	gaskin
GASKVYN	gaskin
GASKVYYN	gaskin
GASKYN	gaskin
GASKYNZ	gaskin
GASLR	gashler
GASLR	gashler
GASLYK	galko
GASLYNG	gatling
GASPAR	gaspar
GASPR	gaspar
GASTA	gatta
GASTAVS	gustavs
GASTAVVS	gustavos
GASTLAV	gastli
GASTLV	gastli
GASTYLV	gastli
GASTYN	grasty
GASTYNYV	gascony
GASVL	gastli
GASY	gary
GASYK	ask
GASYNK	gascoyne
GATA	gatta
GAT	gat
GAT	gat
GATHARD	gotthard
GATKVMB	gatcombe
GATLYB	gateley
GATLY	gateley
GATLYN	gatlin
GATMN	gatun
GATMN	gatun
GATRYJ	gantry
GATSF	gates
GATS	gates
GATS	gates
GATVYN	galvan
GATYS	gantrys
GATYZ	gatz
GATZ	gatz
GATZVYLR	gayler
GAVAZNY	gavazzeni
GAV	av
GAVRD	garrod
GAVR	gair
GAVTYR	ganter
GAVYNDAN	govindan
GAVYND	gavin
GAVYN	gavin
GAYA	gaya
GAYAT	gaya
GAYBS	gayles
GAYDA	gayda
GAYDRY	badry
GAYDVAL	gayda
GAYDV	gayda
GAYGL	gayle
GAY	gay
GAYLR	gayler
GAYLVN	galvan
GAYMN	gayman
GAYMVND	gayman
GAYNL	gaynell
GAYNVR	gaynor
GAYNVR	gaynor
GAYR	dayr
GAYT	gat
GAYVN	galvan
GAYYTZ	gaetz
GAZK	ganzak
GAZMN	gaiman
GBY	gay
GDARD	goddard
GDBRY	gadbury
GDK	gd
GDRALT	gaudrault
GDR	dr
GDYRA	bdira
GDYRH	darth
GDYR	dayr
GDYS	gds
GF	cf
GFRAN	fran
GLAS	gilas
GLASKV	alaska
GLASYR	glaser
GLASYYR	glaser
GLATZ	glatz
GLAYR	gladys
GLDASTYYN	goldsteen
GLDBRG	goldberg
GLDBRGR	goldberger
GLDFSMAN	geldefsman
GLDFSMN	geldefsman
GLDFVT	goldfoot
GLD	gold
GLDKMP	goldkamp
GLDMN	goldman
GLDR	golder
GLDYNG	golding
GLDZMN	goldman
GLDZVRSY	gladders
GLF	gulf
GL	gil
GLNDVRF	glandorf
GLN	glen
GLRYK	gary
GLS	gils
GLSYRZ	glaser
GLTR	gelter
GLVB	golub
GLVJ	alva
GLVRYA	gloria
GLVVY	galbavy
GLYB	glynn
GLYC	alyce
GLYCMN	glynn
GLYK	glynn
GLYKSMN	glicksman
GLYN	glynn
GLYNZ	glynn
GLYSVN	alyson
GLYVS	gladys
GLYZR	gloyer
GMBL	gamble
GMG	gog
GML	gamal
GML	gamal
GMYJ	amy
GNAGY	gnagy
GNKS	genks
GNVSYS	gipsys
GNYSYLDA	gnishilda
GNZALS	gonzales
GNZALS	gonzales
GNZALZ	gonzalez
GNZALZ	gonzalez
GNZ	agni
GPH	goh
GPJ	gepje
GRAB	arab
GRABNAR	grabnar
GRABN	graben
GRABYNR	grabiner
GRAD	grad
GRAF	graf
GRAFT	graft
GRAG	drag
GRAGTY	geraghty
GRAHAM	graham
GRAHAM	graham
GRAH	grah
GRAHRNA	grahorna
GRALYN	gralian
GRAMSS	gramsas
GRANBRGR	grunberger
GRANDASTRVM	grandmaster
GRAND	grand
GRAN	gran
GRANTAM	grantham
GRANT	grant
GRANVYN	granvin
GRANYT	grant
GRANZYV	granzeau
GRARDYN	gerardin
GRASKYN	gaskin
GRASR	graser
GRATR	grater
GRAV	gorav
GRAV	gorav
GRAV	gorav
GRAV	gorav
GRAYM	gray
GRAYNGR	grainger
GRAYSLDYZ	grady
GRAYSYLD	gerald
GRAYVAS	gramsas
GRAYY	grady
GRAYYNGR	grainger
GRAYYV	grady
GRBS	gerbes
GRBYAH	gharbiyah
GRBYH	gharbiyah
GRDAN	gordan
GRDN	gordan
GRDNR	gardner
GRDY	grady
GRFYT	graft
GRG	garg
GRG	garg
GRG	garg
GRGVR	gregor
GRGVR	gregor
GRHARD	gerhard
GRHART	gerhart
GRHART	gerhart
GRJVAYSN	grivas
GRKV	grov
GRL	girl
GRLY	gray
GRLYK	grilk
GRMAK	germack
GRMBAN	gremban
GRM	gorm
GRNANDR	grenander
GRND	grand
GRNDMSTR	grandmaster
GRNDYDYR	grandidier
GRN	gran
GRNGR	granger
GRNJR	garner
GRNJR	garner
GRNLY	gently
GRNSYNG	grensing
GRNT	grant
GRNVYL	gornall
GRNYCR	gonyer
GRNY	gony
GRQTY	grasty
GRSAPH	gersappe
GRSDVRF	gersdorf
GRS	gris
GRS	gris
GRSLDYS	gradys
GRSR	graser
GRSTL	gerstl
GRSTY	grasty
GRSTYNN	gerstein
GRTA	greta
GRTCN	gartin
GRT	grit
GRT	grit
GRTRVD	gertrude
GRTRVYD	geertruyd
GRVBY	garvey
GRV	grov
GRVGVRY	gregory
GRVHVL	grohol
GRVLAYT	gallant
GRVLYT	garvey
GRVM	gorm
GRVNR	groner
GRVNVALD	greenwald
GRVNYNK	groenink
GRVS	graves
GRVSJVHAN	grossjohann
GRVSK	grosek
GRVSR	graser
GRVSY	garvey
GRVT	grit
GRVT	grit
GRVTHAVS	grothause
GRVVR	grover
GRVVY	garvey
GRVYNCM	grinch
GRVYN	bruyn
GRVYNLND	greenland
GRVYNVLD	groenveld
GRYBH	grah
GRYBL	grable
GRYBYH	araby
GRYF	graf
GRYF	graf
GRYFR	graf
GRYFR	graf
GRYFR	graf
GRYFY	griffy
GRYFYS	gradys
GRYFYTS	arafats
GRYFYTZ	graft
GRYG	greg
GRY	gary
GRYGR	gregor
GRYGVR	gregor
GRYKV	gromyko
GRYLK	grilk
GRYLNBK	grilk
GRYNBRG	greenberg
GRYNDLY	grindley
GRYNG	drying
GRYNGH	grinch
GRYN	bryn
GRYNGR	granger
GRYNHAM	grinham
GRYNJ	bryn
GRYNJR	bryner
GRYNSVN	grinsven
GRYNVALD	greenwald
GRYNV	bryn
GRYNVP	granvin
GRYNVVD	grand
GRYNYAS	granadas
GRYNYJ	bryony
GRYPNKRL	griepenkerl
GRYR	gary
GRYSAYLD	griswald
GRYS	garrys
GRYSLD	griswald
GRYSLDYS	griseldis
GRYSMVR	grismore
GRYSR	graser
GRYST	grist
GRYSVALD	griswald
GRYSVLD	griswald
GRYSVN	greyson
GRYSYLD	griswald
GRYSYLDH	griseldis
GRYT	grit
GRYTS	grants
GRYTZ	gritz
GRYTZN	gritz
GRYTZVN	gerritzon
GRYVL	grail
GRYVLYT	garvey
GRYVNVD	grand
GRYYN	aryan
GRYYNVALD	greenwald
GRYZLY	grizzly
GRYZVN	granvin
GSAN	gan
GS	gs
GSKVYN	gaskin
GSKVYNH	gascoyne
GSKYN	gaskin
GSKYNS	gaskins
GSKYNZ	gaskin
GSTAVVS	gustavos
GST	gat
GSTL	gastli
GTYS	gettys
GVADA	gayda
GVANG	gang
GVAN	evan
GVAN	evan
GVANYAV	guanyao
GVARD	edvard
GVBL	gabel
GVBYN	gabon
GVCAN	avian
GVDA	gayda
GVDA	gayda
GVDA	gayda
GVDAL	goudal
GVDARD	goddard
GVDATA	gudata
GVDAT	gudat
GVDAYNAF	adana
GVD	gd
GVDGR	goodger
GVDHV	gandhi
GVDL	gadil
GVDMAN	godman
GVDMN	godman
GVDNAF	bednar
GVDRAM	avram
GVDRAN	godman
GVDRV	godiva
GVDRV	godiva
GVDRYC	guidry
GVDSN	godson
GVDSVN	godson
GVDVYN	godewyn
GVDVYN	godewyn
GVDYNG	golding
GVDYN	godewyn
GVDYR	dayr
GVDYVAYN	dylan
GVDYVYN	godewyn
GVGAN	goegan
GVGR	gage
GVGVAN	galvan
GVHD	gohde
GVH	goh
GVHYN	gwyn
GVKYANV	guiyang
GVLAND	goland
GVLAN	golan
GVLDYNG	golding
GVL	gil
GVLSBY	gatsby
GVLT	agoult
GVLVMB	golomb
GVLY	gilby
GVMZ	gomez
GVMZ	gomez
GVNAR	genaro
GVNNA	gonna
GVNTVRP	ganter
GVNVT	genet
GVNY	gony
GVNZALS	gonzales
GVNZALS	gonzales
GVNZALV	gonzalo
GVNZALZ	gonzalez
GVPALA	gopala
GVPALAN	gopalan
GVPTA	gupta
GVPTH	garth
GVPVL	gopala
GVPYNAT	gopinath
GVRALAVALA	goralwalla
GVRAL	gural
GVRALP	guralp
GVRAN	goran
GVRAPARTAP	gurupartap
GVRASPY	grasty
GVRAV	gorav
GVRBRG	gorberg
GVRDF	gorde
GVRD	goverd
GVRD	goverd
GVRDN	gordan
GVRDYN	gordan
GVRGAN	garagan
GVRGANZ	garagan
GVR	ger
GVR	ger
GVRKY	gorky
GVRL	girl
GVRLY	gurley
GVRM	gorm
GVRMT	garms
GVRNAL	gornall
GVRNY	gurney
GVRTVN	gartin
GVRV	gorav
GVRVSAMY	gurusamy
GVRVYTZ	gorwitz
GVRY	gary
GVRYK	gary
GVRYNCM	garance
GVRYNDR	gurinder
GVRYNG	drying
GVRYNMN	glynn
GVRYS	averys
GVSF	avs
GVS	avs
GVSTAV	gustav
GVSTAVS	gustavs
GVSTAVVS	gustavos
GVSTLV	gastli
GVSVL	gastli
GVSVYL	gospel
GVSY	gipsy
GVTHARD	gotthard
GVTJS	gates
GVTLYB	gently
GVTY	getty
GVTYK	getty
GVVDGR	goodger
GVVDYNG	golding
GVVRD	goverd
GVVVSYS	gipsys
GVVYNDR	govinder
GVYAT	guyatt
GVYDV	gayda
GVY	gay
GVYKARYS	bovarys
GVYLAM	gillam
GVYL	gayle
GVYL	gayle
GVYL	gayle
GVYLRMV	gayler
GVYN	gwyn
GVYN	gwyn
GVYVDA	gayda
GVYYDV	gayda
GVYYJR	gayler
GVYYLYM	bayly
GVYYN	glynn
GVZVYTZ	gaetz
GYANASY	guyanas
GYAT	gat
GYBSN	gibson
GYBSVN	gibson
GYBVNY	lyubovny
GYBVNZ	benz
GYBVR	gabor
GYDRY	guidry
GYDV	gayda
GYDVN	ryden
GYDZ	gayda
GYFT	gift
GY	gay
GYGR	guyer
GYJSBRTAS	gijsbertus
GYJSBRTVS	gijsbertus
GYLAGLY	gillogly
GYLAM	gillam
GYLAM	gillam
GYLBAY	galbavy
GYLBRT	gilbert
GYLFRD	guilford
GYLFVRD	guilford
GYL	gayle
GYL	gayle
GYL	gayle
GYL	gayle
GYLMN	gilman
GYLMN	gilman
GYLMR	gayler
GYLN	dylan
GYLNR	gayler
GYLPYN	galpin
GYLR	gayler
GYLRM	gayler
GYLRMV	garms
GYLRVY	gilroy
GYLRY	gilroy
GYLSPAY	gaspar
GYLSPY	gypsy
GYLT	egypt
GYLVT	aylott
GYLYAM	gillam
GYLY	lyly
GYLY	lyly
GYLYS	gayles
GYLYS	gayles
GYLYTA	geleta
GYLYZ	allyz
GYLYZ	allyz
GYML	gamal
GYMNV	gayman
GYMNZ	gayman
GYN	gwyn
GYNKZ	genks
GYNSBRG	ginsberg
GYNTN	ginton
GYNTVN	ginton
GYPJH	gepje
GYPN	egypt
GYRARD	gerard
GYR	cyr
GYR	cyr
GYRHART	gerhart
GYRTRVYD	geertruyd
GYRTSN	gartin
GYRVLAYT	geervliet
GYRVLYT	garvey
GYSBRTVS	gijsbertus
GYS	guys
GYSH	gish
GYSYLDA	gayda
GYTARD	guitard
GYT	egypt
GYT	egypt
GYTGY	geitgey
GYTLMN	gatlin
GYTLYN	gatlin
GYTN	gatun
GYTNYK	gitnick
GYTS	egypts
GYTVMR	gitomer
GYTVND	govind
GYVF	goff
GYVLYTY	gallaty
GYVN	gavin
GYVVANY	galvan
GYVVN	gavin
GYVYN	gavin
GYVZ	gatz
GYYANKVLA	giancola
GYZAV	gaza
HABA	haba
HABRDR	habereder
HABR	haber
HABR	haber
HABRKAM	abram
HABRLC	haberlach
HABRMN	haberman
HABRT	habert
HABS	ahabs
HABVRA	habura
HABVRG	hamburg
HABYN	abyan
HABZ	haba
HACHALTR	hochhalter
HACYNSVN	hansen
HACYNZ	hacking
HACYSVN	alyson
HADGZ	cadiz
HADLND	hadland
HADLSTVN	alston
HADLY	hadley
HADRAMAT	hadramawt
HADRAMAVT	hadramawt
HADSN	chads
HADSVN	hadavi
HADSVN	hadavi
HADVBA	haba
HADYA	hadaya
HADY	haddy
HADYL	hadil
HAFBK	haba
HAFMN	haman
HAFMN	haman
HAFMN	haman
HAFNYLYNG	ayling
HAFR	hafer
HAFSAH	hafsah
HAFS	hafs
HAGA	haga
HAGAN	hagan
HAGARD	haggard
HAGARD	haggard
HAGDAL	hugdahl
HAG	haga
HAGKYNZ	hacking
HAGLR	hagler
HAGLYN	charlyn
HAGMN	hagan
HAGMN	hagan
HAGN	hagan
HAGR	hagar
HAGS	ags
HAGSVN	hagan
HAGTN	hagan
HAGYN	hagan
HAHTAHA	huhtala
HAJ	haj
HAJKYNZ	hacking
HAJR	hajar
HAJRZ	hajar
HAJS	haas
HAJYR	hajar
HAJZ	haj
HAKABAY	hathaway
HAKDT	hackett
HAK	hak
HAK	hak
HAKLY	hackley
HAKNYS	haneys
HAKSA	hakka
HAKSAV	hackshaw
HAKS	hanks
HAKSL	hanks
HAKSV	hanks
HAKVLYNN	hakulinen
HAKVYL	havel
HAKY	hak
HAKYNG	hacking
HALAM	hallam
HALAN	harlan
HALAT	halat
HALDR	haldre
HALFLDR	haller
HALGR	halar
HAL	hal
HAL	hal
HALKDYS	halkedis
HALK	chalk
HALKNR	chalker
HALM	halm
HALMN	halm
HALND	hadland
HALN	halon
HALPYN	halpin
HALR	halar
HALR	halar
HALRT	halat
HALSTD	halsted
HALST	halat
HALTGRN	hultgren
HALTSYNGR	holtsinger
HALTVN	healton
HALTZ	hiltz
HALVB	halab
HALYBRTVN	halliburton
HALYDY	haddy
HALYFYLD	alfeld
HALY	haley
HALY	haley
HALYMN	charlyn
HALYVL	hall
HALZR	halar
HAMACY	hamachi
HAMAH	hamah
HAMANS	hamans
HAMANZ	haman
HAMARKVYYST	hammarquist
HAMBYG	hamburg
HAMBYJ	hamburg
HAMD	hamad
HAMFRY	amery
HAMFRYZ	amery
HAMFRYZ	amery
HAMH	hamah
HAML	hamel
HAML	hamel
HAMMANZ	hammans
HAMNS	hamans
HAMPRYVN	hamparian
HAMPSAYR	hampshire
HAMPSYR	hampshire
HAMPTVN	hampton
HAMR	hamer
HAMSAYR	ramsay
HAMVND	hammond
HAMVNDZ	hammond
HAMY	amy
HAMYL	hamel
HAMYLTN	hamilton
HAMYLTVN	hamilton
HANAFVRD	hannaford
HANA	ghana
HANBVT	hanebuth
HANDL	handel
HANDRSVN	andersen
HANG	chang
HANGRFVRD	hungerford
HAN	han
HANKH	hank
HANKLR	bankler
HANKZ	hank
HANSAKR	hunsaker
HANSN	hansen
HANSN	hansen
HANSR	hans
HANSVN	hansen
HANSVN	hansen
HANT	thant
HANTYNGTVN	huntington
HANV	han
HANYA	hanaa
HANYFA	hanifa
HANY	handy
HANYH	handy
HANYMN	canyon
HAPKARFT	havarti
HAPKRAFT	hopcraft
HAPKRFT	hopcraft
HAPKYNZ	hacking
HAPR	apr
HAPSVN	hamson
HARALD	harald
HARALDSN	haraldsen
HARARY	harare
HARATZ	haratz
HARBD	harbud
HARBR	harber
HARBR	harber
HARBR	harber
HARBRN	harburn
HARBRYJ	charbray
HARBVD	harbud
HARBVR	harber
HARBYG	darby
HARBYJ	darby
HARDN	harden
HARDYMN	hardiman
HARDYNG	harding
HARDYN	harden
HARDYSVN	hardison
HARGRAVZ	hargreaves
HAR	har
HARKL	harald
HARKR	harker
HARKVM	harkcom
HARKYN	harkin
HARKYNZ	harkin
HARLD	harald
HARLD	harald
HARL	sharl
HARLND	harland
HARLN	harlan
HARLV	harv
HARMAN	harman
HARMANVS	harmanus
HARMN	harman
HARMNVS	harmanus
HARMVTV	haramoto
HARMZ	harms
HARNR	charng
HARP	harpe
HARPR	harper
HARPVLD	harpold
HARR	harry
HARRYG	harrig
HARSA	harsha
HARS	hares
HARS	hares
HARTAG	hartog
HARTAH	hurtah
HARTFYLD	hartfield
HART	hart
HART	hart
HARTL	hartel
HARTLP	hartlep
HARTLY	hartley
HARTMN	hartman
HARTR	harter
HARTVL	hartel
HARTVYL	hartel
HARTYGAN	hartigan
HARVARD	harvard
HARV	harv
HARVHYSA	haruhisa
HARVLD	harald
HARVL	harv
HARVN	harv
HARVN	harv
HARVNY	harvey
HARVY	harvey
HARYCN	aryan
HARYHARAN	hariharan
HARYKN	harkin
HARYNKAR	hardikar
HARYS	harrys
HARYSVN	hardison
HARYV	harv
HARYZ	haratz
HASAKAH	hasakah
HASAL	hasan
HASBRVK	hasbro
HASBY	husby
HAS	chas
HAS	chas
HASKAL	haskel
HASK	ask
HASKL	haskel
HASKL	haskel
HASKYNZ	baskin
HASLVM	haslum
HASMN	hasan
HAST	haste
HASTTLR	hostetler
HASTVN	aston
HASTYNGZ	hastings
HASYK	ask
HATAP	pratap
HATCSVN	atchison
HATCYNSVN	hutchinson
HATCYNZ	hatcher
HATCYSVN	atchison
HAT	hart
HATLNDNSYS	holtlandensis
HATLY	hartley
HATM	hatem
HATMYKR	hatmaker
HATR	har
HATRL	hatrell
HATVN	hatton
HATVN	hatton
HATVRY	hajery
HAVARD	havard
HAVDVN	hamdan
HAVGTAYLYNG	houghtailing
HAV	harv
HAV	harv
HAV	harv
HAVK	hack
HAVK	hack
HAVKR	hacker
HAVKYN	harkin
HAVKYNZ	hacking
HAVL	havel
HAVLY	hadley
HAVLZ	chavez
HAVN	haven
HAVN	haven
HAVS	avs
HAVSR	havard
HAVTVN	hatton
HAVTYLYNG	aveling
HAVTYN	hatton
HAVVLA	havola
HAVVNN	hann
HAVY	davy
HAVYS	hays
HAYBRD	hayward
HAYBZ	fayiz
HAYC	hay
HAYDAR	hadar
HAYD	haydn
HAYDMN	hayden
HAYDN	haydn
HAYGDAN	hagan
HAYKY	bayly
HAYLND	hadland
HAYLT	haylett
HAYLVRD	hayward
HAYLY	bayly
HAYM	halm
HAYNGH	haange
HAYN	haydn
HAYN	haydn
HAYNLY	bayly
HAYNS	haydns
HAYNS	haydns
HAYNY	handy
HAYNZ	haydn
HAYNZ	haydn
HAYPLY	bayly
HAYR	dayr
HAYRVNYMVS	hieronymus
HAYSLVP	hyslop
HAYSVN	ayson
HAYTR	hayter
HAYTS	hayes
HAYTZ	ghayth
HAYVARD	harvard
HAYVKYNSVN	hawkinson
HAYVKZ	chavez
HAYVL	havel
HAYZ	hay
HAYZ	hay
HAZN	hazen
HBNTVN	hebenton
HBRN	horn
HBRVQ	harv
HBVRN	barn
HBYBA	habiba
HBYBH	babah
HDAD	haddad
HDAK	hak
HDAVY	davy
HDAYA	hadaya
HDAYA	hadaya
HDAYDAH	hudaydah
HD	cd
HDLND	hadland
HDLND	hadland
HDLVND	hadland
HDLY	hadley
HDRAMAVT	hadramawt
HDRAMVT	hadramawt
HDRMAT	hadramawt
HDRYK	hedrick
HDSA	hasan
HDS	cds
HDYA	hadaya
HDYDA	hudaydah
HDYDH	hudaydah
HDYH	ghayth
HDYL	hadil
HDYN	dyna
HFRVN	efren
HFSA	hafsah
HFSAH	hafsah
HFS	hfs
HFSH	hafsah
HGARTY	hegarty
HGLND	hagland
HGTYLYNG	gatling
HGY	hay
HGY	hay
HGYR	hagar
HHMN	hehman
HJR	hajar
HJRY	hajery
HK	hak
HKR	har
HKR	har
HKSAV	hasan
HKSV	aksu
HKT	chet
HKTVR	harter
HKYM	hakim
HKYNG	hacking
HKZN	hazen
HLAB	halab
HLAL	helal
HLAN	hulan
HLAVYN	hlavin
HLB	halab
HLBLYNG	helbling
HLBYG	helbig
HLBYNG	helbing
HLD	child
HLDN	holden
HLFMN	helfman
HLGA	helga
HL	hal
HLKANT	hellekant
HLK	chalk
HLLR	haller
HLMN	helman
HLMN	helman
HLMNSTAYN	blanstan
HLMR	hilmer
HLMZ	halm
HLMZ	halm
HLNA	helena
HLND	hand
HLNDR	andr
HLN	halon
HLN	halon
HLR	halar
HLSTRVM	ahlstrom
HLT	helt
HLTLANDNSYS	holtlandensis
HLTLNDNSYS	holtlandensis
HLTVN	hilton
HLV	alva
HLVJ	alva
HLVM	halm
HLY	holy
HLY	holy
HLYNDN	lyndon
HLYVL	hall
HLZGNG	holzgang
HLZMN	holzman
HMAH	hamah
HMAM	hamam
HMANS	hamans
HMANZ	haman
HMAR	dhamar
HMBAYJ	bombay
HMBYJ	huby
HMDAN	hamdan
HMD	ahmad
HMH	hamah
HML	hal
HMP	hempe
HMPSAYR	hampshire
HMPSR	hampshire
HMRA	hamra
HMR	hamer
HMR	hamer
HMR	hamer
HMSTD	hemstede
HMSYRH	emyr
HMYD	ahmad
HMYLTN	hamilton
HMYLTVN	hamilton
HMZA	hamza
HMZ	hamza
HMZH	hamah
HNA	ana
HNA	ana
HNAN	hanan
HNCLYF	hinchley
HND	hand
HNDL	handel
HNDRSN	henderson
HNDRSVN	henderson
HNDRYCVZ	hendrica
HNDRYCY	hendrica
HNDRYKA	hendrica
HNDRYKAS	hendriks
HNDRYK	hendriks
HNDRYKH	hendriks
HNDRYKJ	hendrikje
HNDRYKJH	hendrikje
HNDRYKS	hendriks
HNDRYKS	hendriks
HNDRYKS	hendriks
HNDRYKSH	hendriks
HNDRYKSN	hendrickson
HNDRYKSVN	hendrickson
HNDRYKVS	hendriks
HNDRYKY	hendriks
HNDY	handy
HNDZ	hand
HN	han
HN	han
HNJ	haj
HNJY	handy
HNKL	henkel
HNKS	hanks
HNL	hal
HNLY	heinly
HNNFNT	hennenfent
HNRYK	henrik
HNRYT	henry
HNSLY	hensley
HNSN	hansen
HNT	hunt
HNTH	huth
HNTJ	hentje
HNTJH	hentje
HNTYG	hentig
HNYA	chunyan
HNYFA	hanifa
HNYFH	nayfeh
HNYGAN	henegan
HNYG	hong
HNY	handy
HNY	handy
HNYJ	enyo
HNYK	hank
HNYNGSN	henningsen
HNY	handy
HNZ	hinz
HPKRAFT	hopcraft
HPLR	hepler
HQYR	huyer
HRABY	araby
HRAK	horak
HRAN	horan
HRANYKY	hranicky
HRAYZYNG	ayling
HRBAYJ	charbray
HRBRT	herbart
HRBVRT	herbart
HRBYJ	huby
HRDASFYLD	herdsfield
HRD	herd
HRD	herd
HRDSFYLD	herdsfield
HRDZFYLD	herdsfield
HR	har
HRLAYNDYZ	harland
HRLNDYS	brandys
HRLVY	harley
HRLYNDYS	herlindis
HRMAN	harman
HRMAN	harman
HRMAN	harman
HRMAN	harman
HRMANS	hermans
HRMN	harman
HRMN	harman
HRMN	harman
HRMN	harman
HRMNVS	harmanus
HRMNYVS	germanys
HRMS	harms
HRMVSV	harms
HRMZ	hormuz
HRNAKY	hernacki
HRNANDZ	hernandez
HRNDVN	herndon
HRN	horn
HRN	horn
HRN	horn
HRNKR	horner
HRNSBAY	hornsby
HRRA	hera
HRSFAL	horsfall
HRT	hart
HRTLYNG	hertling
HRTVK	bartok
HRV	harv
HRVN	harv
HRVNYMVS	hieronymus
HRVS	chris
HRVY	harvey
HRYK	horak
HRYKN	aryan
HRYNG	drying
HRYNGSAV	herringshaw
HRYS	harrys
HRYSVN	bryson
HRYT	hart
HRYVL	cheryl
HSAKA	hasakah
HSAKAH	hasakah
HS	hs
HS	hs
HSH	harsh
HSKAH	hasakah
HSKH	hasakah
HSMANS	hamans
HSMNS	hamans
HSNA	hasna
HSN	hosn
HSN	hosn
HST	haste
HSTR	hester
HSTYNGZ	hastings
HSYMANZ	heymann
HSYN	hasan
HSYN	hasan
HSYN	hasan
HSYN	hasan
HTCR	hatcher
HTKVKS	hakkas
HTRYK	hetrick
HTZLR	hetzler
HVADLY	hadley
HVA	ava
HVAR	har
HVBR	haber
HVBRMN	haberman
HVBVRVG	hamburg
HVBVRV	haber
HVBVRVQ	haber
HVCYNSVN	evenson
HVDAYDAH	hudaydah
HVDGY	haddy
HVD	hviid
HVDKYNS	hodgkins
HVDKYNZ	hodgkin
HVDSN	hodson
HVDSVN	hodson
HVFGARD	hofgaard
HVFRD	havard
HVFRYN	ghufran
HVFT	hooft
HVGAN	hagan
HVGARD	hugard
HVGARD	hugard
HVGARTY	hegarty
HVG	hg
HVG	hg
HVG	hg
HVGLND	hagland
HVGNBVM	hoogenboom
HVGN	hagan
HVGS	hgs
HVGTAYLYNG	houghtailing
HVGTYLYNG	hertling
HVGV	haga
HVGVYN	evelyn
HVHNSVN	evenson
HV	av
HV	av
HVK	hak
HVKN	haven
HVLAND	hyland
HVLDN	holden
HVLDZVRS	holders
HVL	hal
HVL	hal
HVLKAMB	halab
HVLKNR	holkner
HVLM	halm
HVLMN	helman
HVLMZ	halm
HVLNDNSYS	hennessys
HVLRVYD	holroyd
HVLS	hals
HVLSTN	holsten
HVLTLNDNSYS	holtlandensis
HVLYMN	hollyman
HVLZN	holzen
HVLZVARS	bolivars
HVMAK	hak
HVM	ham
HVM	ham
HVMN	haman
HVNG	hong
HVNYGBRG	honigberg
HVP	chip
HVP	chip
HVPR	apr
HVQTYLYNG	hertling
HVQYM	hovey
HVRGAN	horgan
HVRKAN	horkan
HVRN	horn
HVRNR	horner
HVRSFVRD	horsford
HVRST	herst
HVRTMN	hartman
HVRTR	harter
HVRVAT	horvat
HVRVT	horvat
HVRVVYTZ	haratz
HVRVYTZ	haratz
HVRYGMV	horrigmo
HVRYHAN	hourihan
HVRY	avery
HVRYNG	charng
HVRYV	harv
HVS	avs
HVSMN	hasan
HVSTVN	heston
HVTN	haven
HVVART	havarti
HVVN	haven
HVVR	har
HVYA	divya
HVYBRG	hamburg
HVYD	haydn
HVYGN	haydn
HVYJN	haydn
HVYMAN	hoyman
HVYNG	hmong
HVYSR	huyser
HVYT	chevy
HVYTYNK	hoitink
HVYYSKN	hyson
HVZ	hz
HYBAX	haba
HYBRG	nyberg
HYBRT	habert
HYBVRN	harburn
HYCMN	hyman
HYCNS	haydns
HYDAJAT	hidajat
HYDLAND	hadland
HYDN	haydn
HYDN	haydn
HYDNR	haydn
HYDR	hydra
HYDRYC	hydra
HYDRYS	hydras
HYFA	haifa
HYFLR	hafer
HYFTZ	hafiz
HYGARTY	hegarty
HYGL	hegel
HYGN	hyun
HYGRMN	hageman
HYGVNT	huygens
'HYH	ghayth
HY	hay
HYJDAN	hamdan
HYJMN	hyman
HYKARV	harv
HYK	hak
HYKMN	hyman
HYKSVN	hyson
HYKV	hak
HYKY	cheeky
HYKY	cheeky
HYLBRY	hilary
HYLDBRAND	hildebrand
HYLD	hyland
HYL	hal
HYL	hal
HYL	hal
HYL	hal
HYL	hal
HYLKR	hilker
HYLMR	hilmer
HYLNBRND	hillenbrand
HYLND	hyland
HYLND	hyland
HYLNTH	elnath
HYLRY	hilary
HYLS	hals
HYLSNTYGR	hilsenteger
HYLSVN	hilson
HYLT	helt
HYLTH	ghayth
HYLT	helt
HYLTJ	heyltje
HYLTJH	heyltje
HYLTJH	heyltje
HYLTJ	heyltje
HYLTN	hilton
HYLYARD	hillyard
HYLY	holy
HYLYRSTYN	hellerstein
HYLYS	haleys
HYLYTH	blyth
HYLZ	hiltz
HYM	ham
HYMN	hyman
HYMN	hyman
HYMSTD	hemstede
HYNCLY	hinchley
HYNCY	chauncy
HYND	hand
HYNDRYKA	hendrica
HYNGAN	henegan
HYNG	hong
HYN	hyun
HYNJ	hynes
HYNLY	heinly
HYNR	henri
HYNS	hynes
HYNS	hynes
HYNS	hynes
HYNSVN	hansen
HYNTVN	hinton
HYNTZ	heintz
HYNV	hynes
HYNVNN	hyvonen
HYNVZ	hinz
HYNZ	hinz
HYNZ	hinz
HYNZ	hinz
HYNZ	hinz
HYNZ	hinz
HYPGRYV	hipgrave
HYP	chip
HYPS	gypsy
HYRAY	hydra
HYRDGN	harden
HYRD	byrd
HYRLY	harley
HYRN	horn
HYRNH	byrne
HYRN	horn
HYRT	hart
HYRVNYMAS	hieronymus
HYRVNYMVS	hieronymus
HYRVTA	hirota
HYSAN	hasan
HYS	hays
HYSKVKS	hoskins
HYSKVT	hesketh
HYSLAP	hyslop
HYSL	hyslop
HYSLVP	hyslop
HYSMANS	tysmans
HYSMNS	hymens
HYSR	huyser
HYTN	hyun
HYTR	hayter
HYTR	hayter
HYTS	ghats
HYTSVN	hitson
HYTVN	hyman
HYTZ	hitz
HYTZ	hitz
HYVARD	havard
HYVGN	haven
HYV	harv
HYVKYNZ	hyvonen
HYVM	halm
HYVNGAN	henegan
HYVNSV	haydns
HYVVYT	horvat
HYVZ	chavez
HYVZR	havard
HYYN	hyun
HYZ	hz
HYZMAN	hyman
HYZMANS	guzmans
HYZMNS	hymens
HYZMNZ	hyman
HYZYMNZ	heymann
HZLTVN	hazelton
HZMNZ	heinz
JABJH	babah
JAB	joab
JAB	joab
JAD	jan
JAD	jan
JAD	jan
JAGARD	jagard
JAG	jago
JAGR	jager
JAGV	jago
JAHMANH	jahmane
JAHNS	jans
JAKAMYNTH	jacomyntie
JAKSVN	jackson
JAKVAS	javas
JAKVBH	jacob
JAKVB	jacob
JAKVBJH	jacobje
JAKVBJ	jacobje
JAKVBS	jacobs
JAKVBSVN	jakobsson
JAKVBSVN	jakobsson
JAKVBY	jacoby
JAKVBZ	jacob
JAKVMYNTAY	jacomyntie
JAKVMYNTYH	jacomyntie
JAKVMYNTY	jacomyntie
JAKVMYT	hakluyt
JAKVS	jakes
JAKVYZ	jacklyn
JAKVZ	jake
JAKYVZ	jacky
JALA	jala
JALVNN	jalonen
JAMVNA	jamuna
JANA	jana
JANARDHAN	janardhan
JANATVN	jonathan
JANCS	janas
JANG	jang
JANG	jang
JANG	jang
JANGNYKL	jungnickel
JANGR	jang
JANGTAYY	january
JAN	jan
JAN	jan
JAN	jan
JAN	jan
JANK	bank
JANK	bank
JANKYNSVN	jenkinson
JANSH	jans
JANS	jans
JANSJH	jansje
JANSJ	jansje
JANSKY	jansky
JANSN	jansen
JANSN	jansen
JANSVN	jansen
JANSVN	jansen
JANTH	janet
JANT	janet
JANT	janet
JANTJ	jaantje
JANTVJ	jaantje
JANTYH	gantry
JANVTH	janet
JANVT	janet
JANVTJH	janotje
JANY	jan
JANYKA	janecka
JANZ	danz
JANZ	danz
JAP	gap
JAPJH	jaepje
JAPJ	jaepje
JARAS	jarash
JARBVT	jarbot
JARDYN	jardine
JARS	ars
JART	art
JARVALA	jarwala
JARVYS	jarvis
JARYTJN	marytje
JASCK	jack
JAS	jans
JASPR	jasper
JASPRZ	jasper
JASTAM	justham
JASTAS	shastas
JASTJH	justje
JASTJ	justje
JAST	east
JASTJY	justje
JASTYH	grasty
JASTYN	aston
JASTYN	aston
JASTYN	aston
JASTYN	aston
JASTYS	caseys
JASVA	java
JASVYNDR	jasvinder
JATJY	cathy
JATYNDR	jatinder
JAVF	java
JAVYD	javed
JAVYKA	jataka
JAVYR	javier
JAYAN	jayan
JAYANT	jayant
JAYARAM	jayaram
JAYN	jayan
JAYN	jayan
JAYNVR	gaynor
JAYP	jay
JBHH	john
JBH	job
JBYR	byer
JDY	jody
JF	cf
JF	cf
JFKK	jack
JFRY	fry
JFRYZ	fry
JHAMANH	jahamane
JHANG	jhang
JHAN	jehan
JHAR	johar
JHMANH	jahmane
JHRA	jahra
JKBS	jobs
JK	bk
JKMN	akman
JKMN	akman
JKSVN	jackson
JKVBS	javas
JKVBSVN	jakobsson
JKVBZ	java
JKYN	jacklyn
JLA	jala
JLAL	jalal
JL	jul
JLJ	jala
JLNY	jenny
JLTH	blyth
JLT	lt
JLTJH	jeltje
JLVMARK	jelvemark
JMAL	jamal
JMAL	jamal
JMAR	jamar
JML	jamal
JML	jamal
JMML	jamal
JMVLA	djamila
JMYLA	mylar
JMYLAH	jamilah
JMYLA	mylar
JMYL	jamal
JMYLH	jamilah
JMYLH	jamilah
JMYL	jamal
JNAH	jenah
JNA	jana
JNDRYAV	andra
JNDRYC	landry
JNG	jang
JNG	jang
JN	jan
JNK	junk
JNK	junk
JNKS	jenks
JNKS	jenks
JNKYNSVN	jenkinson
JNKZ	jenks
JNT	janet
JNTJS	entje
JNTRY	gantry
JNYFR	jenifer
JNYKH	jansky
JNYK	junk
JNYNGZ	enying
JNYRV	enyart
JNYSYLDA	gnishilda
JPSN	epson
JPY	jay
JRADA	jerada
JRALD	jerald
JRARD	erhard
JRARD	erhard
JRARDY	brady
JRGNZ	franz
JRHARD	erhard
JRMYAS	ermas
JRMY	jeremy
JRMYK	gromyko
JRMYS	jeremys
JRS	jrs
JRSTL	gerstl
JRTRVD	jarred
JRVNYMVS	jeronimus
JRVNYVS	jennys
JRVYS	jarvis
JRYNG	drying
JRYNGR	bryner
JRYTSMA	jorritsma
JRYTY	bruty
JRYTZVN	brutzman
JSF	josef
JSPR	jasper
JSTR	jester
JSTVN	justin
JSYKA	asoka
JSYK	psyko
JTRV	atri
JTSAM	jetsam
JVAB	joab
JVANA	jana
JVANDR	juvander
JVANG	jang
JVAN	evan
JVAN	evan
JVANYTA	juanita
JVAV	java
JVAY	jay
JVBAL	jubal
JVBJ	jobje
JVB	job
JVB	job
JVBYN	robyn
JVDAS	judas
JVD	javed
JVDY	jody
JVDY	jody
JVF	java
JVF	java
JVFL	jeff
JVGLA	jougla
JVHANA	johanna
JVHAN	jehan
JVHANSN	johansen
JVHANSN	johansen
JVHANSVN	johansen
JVHANSVN	johansen
JVHANSVN	johansen
JVHANY	jehan
JVHANZ	jehan
JVHANZ	jehan
JVLAY	clay
JVL	jul
JVL	jul
JVLTZ	hiltz
JVLYANTH	jayant
JVLYANTJH	juliaantje
JVLYANTJ	jayant
JVLYANT	jayant
JVLYANY	albany
JVLYF	joly
JVLY	joly
JVLY	joly
JVLY	joly
JVNAS	janas
JVNGAN	jungian
JVNGANZ	joungane
JVN	jan
JVN	jan
JVN	jan
JVNV	ivanov
JVNY	jenny
JVNYN	jann
JVNYVR	denyer
JVPRV	japura
JVRAH	jurah
JVRA	avram
JVRAN	jirman
JVRAVLV	jouravlev
JVRGNZ	jergens
JVRJ	burj
JVRJN	jirman
JVRJN	jirman
JVRJYA	arya
JVRJYV	jerry
JVRK	bjork
JVRVYTZ	bartz
JVRY	jory
JVRYNG	drying
JVRYSMA	jorritsma
JVRYTSMA	jorritsma
JVS	avs
JVSLYN	evelyn
JVSTH	josh
JVSTJ	justje
JVSTY	dusty
JVSVA	aviva
JVSVYG	josey
JVSYP	josip
JVTLYN	evelyn
JVVN	avon
JVYDYP	joydeep
JVYNR	joyner
JVYNR	joyner
JVYSF	joys
JVYS	joys
JVYT	ivy
JVYT	ivy
JVZA	juza
JVZF	jawf
JVZFVS	jeffs
JVZP	jeep
JVZY	ivy
JVZYH	ivy
JVZY	ivy
JVZY	ivy
JYAF	jawf
JYA	jayan
JYAKVB	jacob
JYAN	jayan
JYANY	jayan
JYAVRDANY	janardhan
JYBSVN	jebsen
JYBYNS	dobyns
JYGANG	jigang
JY	jay
JY	jay
JYJSBRTVS	gijsbertus
JYKMN	jackman
JYLAM	dylan
JYLBRT	albert
JYL	jul
JYLT	aylott
JYLYAN	dylan
JYLZ	elz
JYM	jim
JYML	jamal
JYMSVN	jameson
JYMY	jimmy
JYMYNY	jiminey
JYMZ	jame
JYMZ	jame
JYMZ	jame
JYNAKYRAMAN	janakiraman
JYNG	jang
JYN	ayn
JYN	ayn
JYN	ayn
JYN	ayn
JYN	ayn
JYNS	jans
JYNTVN	paynton
JYNYK	junk
JYNZ	jayne
JYPH	ayah
JYRARDYN	gerardin
JYRMASKA	germuska
JYRVSK	jarvis
JYSH	josh
JYS	joys
JYSR	joys
JYSTR	eyster
JYSVZ	jayson
JYTA	jitta
JYVK	eyck
JYVRDANV	jordan
JYVVANY	jovian
JYVVYL	jekyll
JYVYL	jekyll
JYZAN	jizan
JYZN	jayan
JYZSBRTVS	gijsbertus
JZYRH	jezire
KAB	kalb
KABRYLV	cabral
KACLYNG	jaclyn
KACV	kalev
KACVN	kayvon
KACY	katy
KACYH	bach
KADLASK	kailas
KADMN	kaden
KADMVS	cadmus
KADN	kaden
KADRYBYSYK	kadribasic
KADRYKYS	karyns
KADV	kado
KADYN	kaden
KAFRY	karty
KAFY	katy
KAFYN	karyn
KAGBVRN	pangborn
KAGL	kagle
KAGL	kagle
KAGLYN	kalyan
KAGSAL	faisal
KAGSVL	kagle
KAHAN	kahane
KAHVN	kahane
KAKALK	kacalek
KAKANDS	kacandes
KA	aka
KAKBRYD	ackroyd
KAKDKAR	kakodkar
KAKRAFT	kraft
KAKRYL	darryl
KAKSHD	bakshee
KAKTVS	kants
KAKY	kaki
KAKYVLA	kayla
KAKYVR	kakure
KALA	kalia
KALAFATAS	kalafatas
KALAFVT	kalafut
KALAHAN	calahan
KALANAN	callanan
KALATVR	kalathur
KALBAVT	galbavy
KALB	kalb
KALB	kalb
KALBRYJ	allbery
KALBYDA	kulbida
KAL	kalb
KALDL	kaldis
KALDVL	kaldis
KALDVL	kaldis
KALDYS	kaldis
KALHYN	kalyan
KALHYNH	kalyan
KAL	kalb
KALKAN	kalkan
KALKLASVR	balkhash
KALMAN	kalman
KALMN	kalman
KALMN	kalman
KALMYS	kalmyk
KALPAK	kalpak
KALPANA	kalpana
KALPS	alps
KALPYN	kalpana
KALR	kalb
KALRTY	karty
KALRY	kalmyk
KALSGH	kalish
KALSVN	balson
KALSYN	calsyn
KALT	kalt
KALTVN	alton
KALV	kalev
KALVM	kalev
KALVNLV	kalevala
KALVRT	calvert
KALVYN	kalyan
KALYA	kalyan
KALYAN	kalyan
KALYANY	kalyan
KALYARV	kalyan
KALY	daly
KALYGY	kalyan
KALYLA	kalila
KALYNSAN	kalyan
KALYNT	kalyan
KALYNZ	kalyan
KALYS	kalbs
KALYS	kalbs
KALYSYAK	kalisiak
KALYYVS	alyces
KAMACV	kama
KAMALA	kamala
KAMAL	kamal
KAMAMA	camama
KAMAR	kamdar
KAMAT	kamath
KAMB	kamb
KAMBS	kalbs
KAMBYTZ	babitz
KAMBYY	kamb
KAMBZ	kamb
KAMDAR	kamdar
KAMHVLZ	kamholz
KAM	kam
KAM	kam
KAML	kamal
KAMLN	kamelen
KAMLYS	kamlish
KAMN	kamen
KAMNS	kamens
KAMPAGNA	campagna
KAMPAR	kamdar
KAMPBL	kampala
KAMP	kampe
KAMPR	kamper
KAMPTVN	hampton
KAMPVS	campos
KAMPYLV	kampala
KAMPYVTR	kamper
KAMR	kam
KAMRVD	kamerud
KAMRVN	amran
KAMRVS	camrys
KAMSKAYA	kamskaya
KAMSTAK	amstadt
KAMYA	kamiya
KAMYNG	kamen
KAMYN	kamen
KAMYV	kalmyk
KANAKAKVRN	kanakakorn
KANA	kana
KANAK	kanak
KANAL	kanal
KANAL	kanal
KANAN	kannan
KANAVA	kanaka
KANBVY	galbavy
KAN	kan
KANDAYV	kanda
KANDLY	kandell
KANDV	kanda
KANDVYYT	vandivort
KANDY	andy
KANFR	kanpur
KANFYLD	canfield
KANG	kang
KANG	kang
KANG	kang
KAN	kan
KANKNT	anant
KANLN	kanal
KANLY	kanal
KANLY	kanal
KANN	ann
KANR	kan
KANRLY	carly
KANRVY	karty
KANSL	kanal
KANSTABARYS	constabaris
KANSTABV	konestabo
KANTARA	cantara
KANTH	kant
KANT	kant
KANT	kant
KANTRA	cantara
KANTR	kanter
KANTRL	kanter
KANV	kan
KANVRY	gantry
KANYA	kana
KANYF	kan
KANYG	kang
KANYNGHAM	cunningham
KANYS	kanes
KANYSNA	kannan
KANYTZ	kant
KANYVN	kayvon
KANZY	kanze
KAPA	kappa
KAPANGA	kapanga
KAP	kapp
KAPK	kalpak
KAPLAN	kaplan
KAPLN	kaplan
KAPLYNK	kaplenk
KAPNR	kapner
KAPRAL	kapral
KAPS	gaps
KAPSVN	kapson
KAPVR	kamper
KAPYLA	kapila
KARABVLVT	karabulut
KARAGR	kariger
KARAHR	caraher
KARA	kara
KARANJLV	karan
KARAN	karan
KARARA	karaca
KARASA	karaca
KARAS	karas
KARASKV	karak
KARASV	karas
KARAYL	karayel
KARBAJAL	carbajal
KARBALA	karbala
KARBN	karan
KARBVNLY	karbala
KARBVNYA	karbala
KAR	kar
KARDAL	kardal
KARDL	kardal
KARDL	kardal
KARDLYS	kardelis
KARDNAS	karinas
KARDYNALY	cardinali
KARGYL	argyle
KARHART	carhart
KARKARN	kalkan
KARKAS	farkas
KARLAYL	karayel
KARL	karl
KARL	karl
KARLKVYST	karlquist
KARLS	karls
KARLSVN	karlsson
KARLTVN	carlton
KARLTVN	carlton
KARLVS	karlas
KARLVT	arlet
KARLYN	karyn
KARLYN	karyn
KARMAN	karmann
KARMVDY	carmody
KARMVNA	carmona
KARMYCAYL	carmichael
KARN	karn
KARN	karn
KARNLYAN	kalyan
KARNR	karner
KARNRY	karner
KARNYA	karina
KARNY	karn
KARNY	karn
KARNZ	karn
KARP	karp
KARPLAS	karlas
KARPNTR	carpenter
KARPNTYR	carpenter
KARSTNSN	carstensen
KARSTNZ	carstens
KARSVN	carson
KARSVN	carson
KART	karty
KARTNR	karner
KARTRAYT	ararat
KARTR	karr
KARTVYZ	karty
KARTY	karty
KARTYK	kartik
KARTYR	karty
KARTYS	karty
KARVLYN	carolyn
KARVR	karr
KARVSV	karas
KARVSV	karas
KARVYN	karyn
KARYAGA	cariaga
KARY	karty
KARY	karty
KARYDA	karida
KARYDYAN	karridian
KARYH	karyn
KARYJR	karner
KARY	karty
KARYLV	daryl
KARYRA	karras
KARYS	karyns
KASAK	kanak
KASAMA	kasama
KASAM	kasama
KASANVVA	casanova
KASARA	kasahara
KASAT	kasat
KASGRVH	kasparov
KASL	karl
KASLMN	kalman
KASM	kam
KASMN	kasun
KASMYCY	kalmyk
KASNR	kastner
KASNYR	kastner
KASPRZAK	kasprzak
KASRTYNV	karty
KASRYL	darryl
KASTA	kast
KASTANV	astana
KASTLV	castle
KASTLV	castle
KASTNR	kastner
KASTNR	kastner
KASTRCM	kasterchem
KASTRGYN	kathryn
KASTR	kast
KASTRV	kastrup
KASTRYKAM	astrakhan
KASTRYKVM	kasterchem
KASTRYVM	kasterchem
KASTVL	kast
KASTVRY	kasturi
KASTY	kasaty
KASTYLV	kasaty
KASTYN	kasaty
KASVF	kasouf
KASVN	kasun
KASY	kasey
KASYNG	kang
KASYNLY	ascoly
KASYNSKY	kandinsky
KASYV	kasey
KATA	katta
KATALANV	catalan
KATAN	kattan
KATARYN	kathryn
KATB	kateb
KATBRT	kateri
KATCY	kathy
KATKART	patkar
KATL	karl
KATL	karl
KATLMN	katleman
KATLR	kanter
KATLYR	katelyn
KATN	katen
KATR	kanter
KATRNTJ	katryntje
KATRYJ	kathryn
KATRYJN	kathryn
KATRY	kathryn
KATRYNA	katrina
KATRYNA	katrina
KATRYN	kathryn
KATRYN	kathryn
KATRYN	kathryn
KATRYN	kathryn
KATRYN	kathryn
KATRYNTH	katryntje
KATRYNTJH	katryntje
KATRYNTJ	katryntje
KATRYNTY	katryntje
KATVALA	katwala
KATVPYS	kathys
KATY	katy
KATYNG	keating
KATZ	katz
KAVASYN	cavasin
KAVAYY	kasaty
KAV	kave
KAV	kave
KAVDLYNG	aveling
KAVDYL	kardal
KAVH	kaveh
KAVH	kaveh
KAV	kave
KAVLY	bally
KAVLY	bally
KAVLYNG	aveling
KAVN	kain
KAVRZ	kar
KAVS	avs
KAVSTN	kansan
KAVYTA	kavita
KAYA	kaya
KAYAK	kayak
KAY	kay
KAYK	kayak
KAYLAS	kaylas
KAYL	kayla
KAYN	karyn
KAYN	karyn
KAYNY	karyn
KAYPR	kamper
KAYRAS	karas
KAYRD	bayard
KAYRVF	kairoff
KAYSR	kayser
KAYT	kalt
KAYT	kalt
KAZDAN	kazdan
KAZGRYF	karyn
KAZMAYR	kazmaier
KAZVHYRV	kazuhiro
KAZVNVZY	kanze
KAZY	katy
KAZYR	khazar
KAZYRR	karr
KBAKYAN	kabakian
KBAKYBV	kabakibo
KBANYS	albanys
KBRG	ekberg
KBR	akbar
KBYR	akbar
KBYR	akbar
KCNG	kang
KDAVR	kedar
KD	kid
KDL	adel
KDL	adel
KDR	dr
KDYM	adam
KDYN	dyna
KDYRA	bdira
KDYR	dayr
KDYSYA	krystal
KDYSYH	dyson
KFART	kmart
KHV	kave
KK	kok
KLABVRN	claborn
KLAF	klan
KLAG	klan
KLAG	klan
KLAGSTVN	langston
KLAK	kalpak
KLAMN	klan
KLAMR	klammer
KLANFYLD	clanfield
KLANSY	klans
KLANTVN	clanton
KLARJH	klaartje
KLARK	clark
KLARK	clark
KLAR	alar
KLARTAY	karty
KLARTH	barth
KLARTJH	klaartje
KLARTJ	klaartje
KLARTJY	klaartje
KLART	klatt
KLARTY	karty
KLARYJ	karyn
KLASA	klassa
KLASJ	klans
KLASJH	klassa
KLASMYR	klammer
KLASN	klan
KLASNR	klausner
KLAT	klatt
KLATZ	blatz
KLAVDYA	chavda
KLAVDY	lavey
KLAVSY	klans
KLAVYTR	klawiter
KLAYN	klan
KLAYN	klan
KLAYR	layer
KLAYSJ	klans
KLAYSVN	clayson
KLAYSVN	clayson
KLAYTVN	clayton
KLAZ	blaz
KLAZVRA	klazura
KLAZYNG	kang
KLBAY	albany
KLB	kalb
KLBRN	claborn
KLBVRN	claborn
KLBVRN	claborn
KLBY	kilby
KL	akl
KLDNY	kolodny
KLDVL	kuldell
KLDVY	kidby
KLFLT	colfelt
KLKAR	kelkar
KL	akl
KL	akl
KLMANZ	kalman
KLMBV	kamb
KLMN	kalman
KLMP	klemp
KLNFYLD	alfeld
KLN	klan
KLN	klan
KLNR	kellner
KLRTAY	karty
KLRTY	karty
KLRVS	karas
KLT	kalt
KLTN	klan
KLTNR	keltner
KLVB	kalb
KLVBK	kloubek
KLVKYNAS	kloukinas
KLVLY	kelly
KLVMPNR	clumpner
KLVNFRV	clonfero
KLVSN	kelvin
KLVTH	blyth
KLVYNN	flynn
KLYBR	klyber
KLYBRN	klyber
KLY	ely
KLY	ely
KLYF	eklof
KLYFRD	alford
KLYFT	clift
KLYFTVN	clifton
KLYK	kalmyk
KLY	ely
KLY	ely
KLYLA	kayla
KLYMR	klyber
KLYMVF	kolyma
KLYNGRVT	klingler
KLYNK	klinck
KLYN	kalyan
KLYN	kalyan
KLYNSVRG	kleinsorge
KLYNZ	flynn
KLYR	klyber
KLYR	klyber
KLYR	klyber
KLYR	klyber
KLYRTYH	blyth
KLYS	eloys
KLYSH	kalish
KLYTVN	clayton
KLYVY	levy
KMA	kama
KMAL	kamal
KMAL	kamal
KMBRY	kimberey
KMBS	combs
KMBZ	kamb
KMDR	kamdar
KMFVYS	amways
KMFYLD	alfeld
KM	kam
KMKR	kemker
KMLLV	kalev
KMPASTR	kempster
KMPBL	kampala
KMP	kemp
KMP	kemp
KMPR	kamper
KMPSTR	kempster
KMPVS	kempis
KMPY	empey
KMR	kar
KMR	kar
KMR	kar
KMRVN	amran
KMSPTR	amster
KMSTR	amster
KMYLAH	kamilah
KMYLA	kayla
KMYLH	kamilah
KMYR	emyr
KNAMVRY	kanamori
KNAVAY	kennaway
KNDAL	kendal
KNDL	kendal
KNDRYK	kendrick
KNDV	kanda
KNDVLF	kandolf
KNDY	andy
KNDYG	kendig
KNDY	andy
KNG	kang
KNG	kang
KN	kan
KN	kan
KN	kan
KNNYNG	kenning
KNPVL	knel
KNRAD	konrad
KNRAD	konrad
KNRAD	konrad
KNRADVS	konrads
KNRAT	konrad
KNRDYNG	konerding
KNR	kar
KNSYNGTV	kensingto
KNTA	kenta
KNTARV	kentaro
KNVB	knob
KNVFYNKH	knufinke
KNVL	knel
KNY	keny
KNY	keny
KNYKRBKR	knickerbacker
KNYNGTVN	kennington
KNYN	kenyan
KNYSKY	kousky
KNYVN	kayvon
KNYVN	kayvon
KNZ	kenz
KPJH	kapje
KPL	pl
KPLY	kepley
KPR	apr
KPRT	kert
KPTAN	kapetan
KPYSTRAN	capistran
KRAB	krab
KRA	kara
KRACLY	bradly
KRACLY	bradly
KRACN	karaca
KRACR	karaca
KRAKART	krakatoa
KRAKFRD	bradford
KRAKFVRD	bradford
KRAK	karak
KRAK	karak
KRAKT	kraft
KRAMARY	kramer
KRAMHVRN	crumhorn
KRAMR	kramer
KRANDLMYR	crandlemire
KRANSVYK	cranswick
KRANSVYYK	cranswick
KRANZVYK	brandy
KRAP	krab
KRAPR	draper
KRAQTVN	crafton
KRARAS	karas
KRASBY	araby
KRAS	karas
KRASN	krasen
KRASYK	kraack
KRATR	kratzer
KRATRZ	katz
KRATYGR	krattiger
KRATZR	kratzer
KRAVFVRD	bradford
KRAVL	pravil
KRAVLY	bradly
KRAVN	craven
KRAVN	craven
KRAVSVN	krasen
KRAY	bray
KRAYDR	kramer
KRAYG	kraig
KRAYG	kraig
KRAYJ	kraaij
KRAYJ	kraaij
KRAY	bray
KRAYSVL	karayel
KRAZN	karan
KRAZYR	kratzer
KRBLA	karbala
KRBL	kerbel
KRBSR	krebser
KRBTRY	barbary
KRBVNYL	kerbel
KRBYT	kirby
KRC	kroc
KRDAL	kardal
KRDLA	karla
KRDL	kardal
KRDRY	kerry
KRFT	kraft
KRFTVN	crafton
KRG	krug
KRG	krug
KRGR	kerger
KRGR	kerger
KRHANG	kerhong
KRH	kr
KR	kr
KRK	kirk
KRKRAFT	kraft
KRKRAFT	kraft
KRLY	krey
KRLYVS	orlys
KRMR	kramer
KRMYK	kalmyk
KRMYT	kermit
KRNAY	anay
KRNFRD	cranford
KRN	karn
KRN	karn
KRN	karn
KRNL	kanal
KRNLYS	kennys
KRNLYVS	kennys
KRNS	kerns
KRNSVYK	kerensky
KRNVL	kanal
KRNYZ	krenz
KRNZ	krenz
KRPS	kips
KRRAY	karras
KRS	krs
KRS	krs
KRS	krs
KRSKYNTYH	forsyth
KRSLYK	kerslake
KRSN	krasen
KRSNR	krasner
KRSNR	krasner
KRSNV	kresna
KRSPV	krs
KRST	kast
KRSTN	kerstin
KRSTS	kristas
KRT	kert
KRTLND	cortland
KRTR	arter
KRTYN	karty
KRTZR	kratzer
KRVASH	karakash
KRVASZ	akivas
KRVB	krab
KRVCFVRD	crockford
KRV	kirov
KRVD	kurd
KRVG	krug
KRVKFVRD	crockford
KRVK	krok
KRVKN	irvin
KRVL	karl
KRVM	kram
KRVM	kram
KRVMH	kaveh
KRVM	kram
KRVM	kram
KRVMN	kriman
KRVMR	kramer
KRVMY	kram
KRVMYTS	kermits
KRVNHYM	arnhem
KRVNY	cerveny
KRVNZ	krenz
KRVPYK	kropik
KRVSBY	crosby
KRVSCN	krasen
KRVS	kris
KRVSH	kresh
KRVSN	krasen
KRVSN	krasen
KRVTYV	karty
KRVVD	kirov
KRVYL	karayel
KRVYN	kevyn
KRVYR	kevyn
KRVZ	krenz
KRVZYR	kratzer
KRY	kory
KRYCFYLD	krystal
KRY	kory
KRYDA	karida
KRYDR	ryder
KRYGAN	aryan
KRYG	krug
KRYG	krug
KRYGR	kriger
KRYGR	kriger
KRY	kory
KRYK	krok
KRY	kory
KRY	kory
KRYLA	kayla
KRYLAS	kaylas
KRYL	beryl
KRYLYZ	allyz
KRYM	kram
KRYMN	karyn
KRYN	karyn
KRYN	karyn
KRYN	karyn
KRYNZ	krenz
KRYPYV	krey
KRYQR	pryor
KRYR	karr
KRYSAN	krishan
KRYSAYNTAY	krystal
KRYS	korys
KRYSC	korys
KRYS	korys
KRYS	korys
KRYSH	kresh
KRYSJH	kresh
KRYS	korys
KRYS	korys
KRYSP	korys
KRYSPN	bryson
KRYSPYJN	crispijn
KRYSPYN	bryson
KRYSSAYNTYH	bryant
KRYSTA	krystal
KRYSTA	krystal
KRYSTAL	krystal
KRYSTAL	krystal
KRYSTAL	krystal
KRYST	krystal
KRYSTLR	kristler
KRYSTMN	kresten
KRYSTMN	kresten
KRYSTN	kresten
KRYSTR	krister
KRYSTV	krystal
KRYSTVF	krystal
KRYSTVFR	krister
KRYSTVFRSVN	kesterson
KRYSTVN	kresten
KRYSTVN	kresten
KRYSTYANA	kristian
KRYSTYAN	kristian
KRYSTYAN	kristian
KRYSTYANSN	krystals
KRYSTY	kristy
KRYSTY	kristy
KRYSTYJNTH	kristijntje
KRYSTYJNTJH	kristijntje
KRYSTYJNTJ	kristijntje
KRYSTYNA	kristina
KRYSTYN	kresten
KRYSTYNH	kresten
KRYSTYN	kresten
KRYSTYN	kresten
KRYSTYN	kresten
KRYSTYNTY	christyntie
KRYSVAYJN	krishan
KRYSVJYN	krisoijn
KRYSVYJN	krisoijn
KRYSVYN	rysavy
KRYSVZN	bryson
KRYSY	korys
KRYSY	korys
KRYSY	korys
KRYSZ	korys
KRYTR	kratzer
KRYVAS	grivas
KRYVASZ	grivas
KRYVN	karyn
KRYVSN	kayvon
KRYVVNVZ	kayvon
KRYYK	kayak
KRZNA	karina
KSAVAN	kesavan
KSAV	keshav
KSAY	kasaty
KS	ks
KSK	ask
KSKYN	keskin
KSL	kislo
KSL	kislo
KSLN	kasun
KSLR	esler
KST	kast
KSTLAK	kostelak
KSTL	kast
KSTLVT	astley
KSTNR	kastner
KSTRAP	kastrup
KSTR	kester
KSTRCM	kasterchem
KSTRSVN	kesterson
KSVAN	kesavan
KSVN	kasun
KSYDY	sydney
KSYM	syme
KSYM	syme
KTAN	ketan
KTARA	kotara
KTB	kateb
KTCAM	ketcham
KT	ket
KT	ket
KTLAR	cotlar
KTL	ketil
KTL	ketil
KTLT	kalt
KTLY	ketley
KTNZRV	kutuzov
KTSYMATYDS	catsimatides
KTVLA	ketola
KTVYN	kevyn
KTY	katy
KTY	katy
KTYL	katy
KTZ	katz
KVAAYNTN	paynton
KVAKNBAS	kansas
KVAKNBVS	kharkovs
KVA	akiva
KVAL	val
KVALSYK	kalmyk
KVANBAY	anay
KVANG	kang
KVANG	kang
KVANG	kang
KVAN	evan
KVANLAN	kannan
KVANRAD	konrad
KVANRAD	konrad
KVANRADT	vanzandt
KVANRADVS	kannadas
KVANRDT	brandt
KVANRYD	vandry
KVANTVN	kantian
KVARSKY	kovarski
KVARTZYTH	karty
KVASMAN	klansman
KVAST	kast
KVASYM	kasama
KVATRYN	kathryn
KVAVRYNG	karyn
KVAYLYSY	kaylas
KVAYMAN	ayman
KVAYNTANA	santana
KVAYNTVN	paynton
KVAYT	kuwayt
KVBA	kaaba
KVB	kalb
KVB	kalb
KVBLA	kubla
KVBN	keven
KVBSA	kobsa
KVBV	kibo
KVBV	kibo
KVBYB	kobb
KVBYLAH	kamilah
KVBYLA	kayla
KVCAR	kevlar
KVC	kave
KVCRAN	kevran
KVCY	ivy
KVCYH	koch
KVDAMAH	qudamah
KVDAMA	kama
KVDVGNV	advent
KVDY	kidby
KVGANDA	konganda
KVGLAN	kaplan
KVGLYN	evelyn
KVGVMA	kogoma
KVHAN	khan
KVHN	kuhn
KVJH	kaveh
KVJYAS	kenyas
KVKAL	kokal
KVKALYK	kalmyk
KV	av
KVKBRN	cockburn
KVK	kok
KVKFYLD	alfeld
KVK	kok
KVKNBAS	kansas
KVKNJ	keven
KV	av
KVK	kok
KVKRYL	avery
KVKSVN	kansan
KVKTAVAY	koktavy
KVKVNN	karvinen
KVKVRK	kakure
KVKYA	kaya
KVLASA	kolasa
KVL	akil
KVL	akil
KVLKA	kalkan
KVLMN	kalman
KVLN	keven
KVLN	keven
KVLN	keven
KVLNV	kalev
KVLR	kevlar
KVLSAR	kevlar
KVLS	kalbs
KVLSVN	kelvin
KVLT	kalt
KVLTY	kelty
KVLVL	kalev
KVLYCALA	kolichala
KVLY	kelly
KVLY	kelly
KVLYHA	koliha
KVLYN	evelyn
KVLYNG	aveling
KVLYNGVVD	klingler
KVLYNS	karyns
KVLYNZ	evelyn
KVLYR	kevlar
KVLYS	julys
KVMAR	kumar
KVMARV	kmart
KVMBR	kamb
KVMPTVN	compton
KVMR	khmer
KVMR	khmer
KVMVRV	kemerovo
KVMVRYTA	komorita
KVN	kan
KVNG	kang
KVNG	kang
KVNKA	kanaka
KVN	kan
KVN	kan
KVNRAD	konrad
KVNRAD	konrad
KVNRADVS	konrads
KVNRAT	konrad
KVNRAT	konrad
KVNRAYT	konrad
KVNRYAT	kenya
KVNT	kant
KVNV	ivanov
KVNVPKA	konopka
KVNVR	denver
KVNVVR	denver
KVNYNG	koning
KVPJANZ	kaplan
KVPJ	kapje
KVP	kip
KVPLN	kaplan
KVPLND	copland
KVPLS	karls
KVPNZ	kenz
KVPR	koper
KVPR	koper
KVPS	kips
KVRADYNY	kevran
KVRAM	avram
KVRAN	kevran
KVRAN	kevran
KVRAPATY	koorapaty
KVRBT	kert
KVRBYN	karyn
KVR	kar
KVRDAS	kordas
KVRDS	kordas
KVRDYK	cordy
KVRDZ	kurd
KVRKAM	avram
KVRKVL	kardal
KVRL	karl
KVRLY	beverly
KVRN	karn
KVRNLH	kornele
KVRNLVS	karlas
KVRNLYS	barneys
KVRNLYVS	barneys
KVRNLYVSN	karlsson
KVRNLYZ	kornele
KVRNVAL	bernal
KVRNYVL	karayel
KVRNZ	krenz
KVRP	karp
KVRSL	karl
KVRSLV	kislev
KVRSN	kevran
KVRSTN	kerstin
KVRT	kert
KVRTH	barth
KVRTL	karl
KVRTLND	cortland
KVRTLNT	bartelt
KVRTRAYT	kortright
KVRTZ	bartz
KVRVNLA	arvola
KVRVYN	karyn
KVRYA	arya
KVRY	kory
KVRY	kory
KVRYDVR	ryder
KVRYGAN	kerrigan
KVRY	kory
KVRY	kory
KVRYLA	karla
KVRYL	beryl
KVRZAYN	kevran
KVSADA	kasama
KVSAK	kusack
KVSAY	kasaty
KVSH	kish
KVSJH	kish
KVSJ	avs
KVSKY	kousky
KVSKYMAKY	koskimaki
KVSLV	kislev
KVSMANS	klansmans
KVSMANZ	kinsman
KVSMAS	cosmas
KVSMNS	kamens
KVSNKV	kosenko
KVSTA	kosta
KVSTA	kosta
KVSTANZA	costanza
KVST	kast
KVSTN	kosten
KVSTRMN	kusterman
KVSTYLV	kettyle
KVSTYS	kristys
KVSVGH	kaveh
KVSYN	kevyn
KVSYRA	assyria
KVSZ	avs
KVTA	kavita
KVTCAY	avichay
KVT	ket
KVTCY	kathy
KVTJANZ	kattan
KVTLA	kotla
KVTMAYR	katmai
KVTNY	kathy
KVTRVNYV	katrin
KVTY	katy
KVTZ	katz
KVVAR	kovar
KVV	kave
KVVS	kievs
KVYALSKY	kowalski
KVYALYK	kalmyk
KVY	ivy
KVYCY	kevyn
KVYK	kayak
KVYKNBAS	guyanas
KVYKNBVS	keynes
KVYL	kayla
KVYL	kayla
KVYL	kayla
KVYLYN	evelyn
KVYMN	kevyn
KVYN	kevyn
KVYN	kevyn
KVYN	kevyn
KVYN	kevyn
KVYN	kevyn
KVYN	kevyn
KVYN	kevyn
KVYNRAD	konrad
KVYNRAD	konrad
KVYNRAD	konrad
KVYNRAT	konrad
KVYNRAYT	koenraad
KVYNRDVS	konrads
KVYNRYDVS	konrads
KVYNRYT	kevyn
KVYNTANA	montana
KVYNTN	kenton
KVYNT	kevyn
KVYNTVN	kenton
KVYPR	kuyper
KVYRYN	karyn
KVYSMAN	kinsman
KVYST	kast
KVYT	kevyn
KVYT	kevyn
KVYYKL	kayak
KVYYLYN	evelyn
KVYYMAN	ayman
KVYYMN	kevyn
KVYYNLN	kevyn
KVYYNTANAR	quintanar
KVYYNTVN	kenton
KVYY	kevyn
KVYYST	kast
KVYYT	kevyn
KVYYTZ	katz
KVYZMN	kevyn
KVZN	kazan
KVZV	kazi
KVZY	ivy
KVZY	ivy
KVZYN	kevyn
KYALASA	kailasa
KYASVN	kasun
KYAT	keat
KYB	yb
KYBH	ayah
KYBL	kabal
KYBL	kabal
KYBLR	khyber
KYBLR	khyber
KYBV	khyber
KYCN	ayn
KYCRV	lycra
KYCYN	karyn
KYD	kid
KYD	kid
KYDL	kyle
KYDRA	hydra
KYF	kay
KYF	kay
KYFR	byer
KYFR	byer
KYGAN	keegan
KYGYNZ	karyn
KYHL	kohl
KYHV	keshav
KYJV	kaj
KYKBRD	byrd
KYKBRYD	ackroyd
KY	kay
KY	kay
KY	kay
KY	kay
KYK	kayak
KYKVMA	kikuma
KYLAN	dylan
KYLBAY	kilby
KYLBRV	aylor
KYLBY	kilby
KYLBYN	kilby
KYLG	kilg
KYLGVR	kilgore
KYLH	kyle
KYLHVRN	kielhorn
KYL	kyle
KYL	kyle
KYL	kyle
KYLPK	kalpak
KYLR	kyle
KYLR	kyle
KYLR	kyle
KYLRMT	klimt
KYLT	kalt
KYLY	kyle
KYLYVN	kalyan
KYLZ	kyle
KYMBAL	kimball
KYMBRLY	kimberly
KYMBRY	kimberey
KYM	kam
KYM	kam
KYMPA	kimppa
KYMV	kam
KYMVN	ayman
KYMVRA	aymara
KYMZ	kam
KYNA	dyna
KYNAN	kannan
KYNANN	keinanen
KYNARD	kinard
KYN	ayn
KYNCN	bynon
KYNGASTVN	kingston
KYNGFAY	kingfai
KYNGRY	kingery
KYNGSFVRD	kingsford
KYNGSTVN	kingston
KYNGZTN	kingston
KYNH	keyne
KYN	ayn
KYN	ayn
KYN	ayn
KYN	ayn
KYN	ayn
KYN	ayn
KYN	ayn
KYN	ayn
KYNKNN	keinknen
KYNKYD	kinky
KYNMN	kinman
KYNMN	kinman
KYNRSLY	kingsley
KYNSLA	kinsella
KYNSL	kanal
KYNSMN	kinsman
KYNSVN	kansan
KYNT	kant
KYNT	kant
KYNTL	kintel
KYNY	keny
KYNY	keny
KYNYNY	kenny
KYNYVN	kenyan
KYNZ	kenz
KYNZMAN	kinman
KYNZY	kanze
KYP	kip
KYP	kip
KYP	kip
KYPLYNG	kipling
KYPYNG	kapanga
KYRA	byra
KYRAN	karan
KYRAS	karas
KYRBAY	kirby
KYRBY	kirby
KYR	cyr
KYRK	kirk
KYRTA	barta
KYRTY	karty
KYRVN	byron
KYRYL	beryl
KYRYSY	korys
KYSA	kasai
KYS	katys
KYS	katys
KYS	katys
KYS	katys
KYSLV	kislev
KYSNRVS	kasparovs
KYSR	kayser
KYSR	kayser
KYSTVFR	eyster
KYSVN	ayson
KYSY	gypsy
KYSYDY	kasaty
KYSY	gypsy
KYSYNJR	kastner
KYSYN	ayson
KYTAGVCY	kitaguchi
KYTAMVRA	kitamura
KYTC	kyte
KYTCN	katen
KYT	kyte
KYT	kyte
KYT	kyte
KYT	kyte
KYT	kyte
KYTL	kyte
KYTLY	ketley
KYTS	kits
KYTY	katy
KYTYNG	tyng
KYV	kave
KYVCY	kayvon
KYV	kave
KYVK	kayak
KYVKYVLYS	beverlys
KYVMR	kovar
KYVNG	byung
KYVNG	byung
KYVNG	byung
KYVS	kayes
KYVSMATV	kamath
KYVYVALY	kivivalli
KYVZVN	kayvon
KYZR	kizer
KZMNZ	kenz
'LAALDYN	alaaldin
LABAT	labatt
LABDN	labdon
LABDVN	labdon
LABKYN	laban
LABLA	labella
LABL	lal
LAB	lamb
LABRAD	labroad
LABRYVLA	labriola
LABSR	labore
LABYN	laban
LACLN	lachlan
LACNS	lacys
LACYNY	lacey
LADASKY	ladasky
LADR	badr
LADRVT	laderoute
LADVN	labdon
LADVVYKA	hlavenka
LADVVYKVS	gladys
LADVYG	ladwig
LADYK	ladak
'LADYN	gladys
LADYVYL	advil
LAFAM	lapham
LAFAVNTYN	lafayette
LAFGRYN	lofgren
LAFVRKAD	labroad
LAFY	lacy
LAGRLYNG	lagerling
LAGRSTRVM	lagerstrom
LAGVMVRVF	lagomorph
LAGVN	lagoon
LAHLMA	lahelma
LAHYJ	lahij
LAJ	haj
LAJRBRG	lagerberg
LAKAY	laky
LAKH	laky
LAKLH	akilah
LAK	laky
LAK	laky
LAK	laky
LAK	laky
LAKR	laky
LAKS	blacks
LAKSV	laakso
LAKSYN	calsyn
'LAKVABAH	alaqabah
LAKVTVRH	laith
LAKVVD	akiva
LAKY	laky
LAKY	laky
LAKYSA	lakesha
LALKYN	allyn
LAL	lal
LALS	als
LALY	laly
LALYT	lalit
LAMARK	lamark
LAMASTVS	lamastus
LAMBARD	lombard
LAMBARDV	lombard
LAMBDA	lambda
LAMBLY	lamboley
LAMBRN	lamborn
LAMBRT	lambert
LAMBRVS	lambros
LAMBVLY	lamboley
LAMBVRN	lamborn
LAMBVRN	lamborn
LAM	lam
LAM	lam
LAMPLAYT	lamplight
LAMPN	lampen
LAMPY	lamp
LAMPYT	lampitt
LAMRS	lamars
LAMVRS	lamars
LAMYKYN	lamykin
LANA	lana
LANDAGR	landauer
LANDASTRVM	lundstrom
LANDAYR	landauer
LANDBRG	lindberg
LANDGRN	lindgren
LANDGRYN	landry
LANDKVYYST	landrys
LAND	land
LANDL	land
LAND	land
LANDMN	landman
LANDN	landen
LANDR	lander
LANDRS	landers
LANDRVM	landrum
LANDRY	landry
LANDRZ	landry
LANDYN	landen
LANDYN	landen
LANDYS	landrys
LANGDVN	langdon
LANG	lang
LANG	lang
LANG	lang
LANGLY	langley
LANGNZ	langnes
LANGSA	langs
LANGSAV	landsat
LANGSTVN	langston
LANGSV	langs
LANGV	lang
LANGYR	bangor
LANJ	lan
LANKA	lanka
LANKART	lonkart
LANKSTAF	blanstan
LANKTVN	lankton
LAN	lan
LAN	lan
LAN	lan
LAN	lan
LANR	elanor
LANR	elanor
LANSDYL	landahl
LANSFRD	lunsford
LANS	alans
LANSTZ	lantz
LANSYNG	lansing
LANTA	atlanta
LANT	lantz
LANTLVSAMAD	lantlosamade
LANTRMAN	lanterman
LANTZ	lantz
LANTZ	lantz
LANVM	lannom
LANVSY	lanas
LANY	lanny
LANY	lanny
LANZ	lanz
LAPASV	lapaso
LAP	lap
LAPLAYN	laplaine
LAP	lap
LAPVRD	laird
LAPVRS	aprs
LAPVRT	laporta
LAPVTA	laputa
LAPVVRS	laverns
LAPYDARY	lapidary
LAPYSKV	lacys
LARA	lara
LARALY	laralee
LARDYNGA	flardinga
LARJA	lara
LARJ	lara
LARN	barn
LARNS	laras
LARNS	laras
LARSN	larsen
LARSN	larsen
LARSVN	larsen
LARTR	larter
LARVC	alaric
LARVKVYH	barakah
LARV	harv
LARVRL	larurel
LARYF	lareef
LARYSA	larissa
LARYVYR	carver
LARZ	lanz
LASKALA	lascala
LASKA	laska
LASKARY	baskar
LASK	blask
LASKVS	laskos
LAS	las
LAS	las
LAS	las
LASNYK	lasnik
LAST	last
LASTRA	lastra
LASTR	lastra
LASTRY	lastra
LASTYNG	hastings
LASVN	lanson
LASYNGR	lansing
LATALA	latala
LATA	latta
LATAM	latham
LATBRY	lathbury
LATBVRY	lathbury
LATKYNZ	slatkin
LAT	flat
LATZ	blatz
LAVANDH	lawanda
LAVAYN	laan
LAVD	land
LAV	olav
LAV	olav
LAVLS	laval
LAVMN	hlavin
LAVNKA	hlavenka
LAVNYVS	lannys
LAVRAY	lavery
LAVRNS	laverns
LAVSTAD	lovstad
LAVTN	hlavin
LAVTVN	latin
LAVYGNH	lavigne
LAVYN	hlavin
LAVYT	lavey
LAVZAK	ganzak
LAYAN	jayan
LAYBS	lacys
LAYBZ	fayiz
LAYDVYNA	ladonna
LAYDYA	ayda
'LAYDYN	aladdin
LAYHV	laiho
LAYKZ	fayiz
LAY	clay
LAYL	layla
LAY	clay
LAYMAK	lamark
LAYMB	lamb
LAYND	land
LAYNG	laing
LAYN	ayn
LAYN	ayn
LAYRD	laird
LAYTBRN	clayton
LAYTMN	clayton
LAYTNYNG	clayton
LAYV	clay
LAYV	clay
LAYV	clay
LAYVLY	bayly
LAYVRYTSN	lauritsen
LAYVSAY	livesay
LAYVVY	lavey
LAYVY	lavey
'LAYYN	clayson
LAZARA	lazara
LAZARD	lazard
LAZARV	lazar
LBANRD	libannord
LBANVRD	libannord
LBDAN	aldan
LBDVN	labdon
LBN	laban
LBRYNYDYS	brandys
LBVN	laban
LBVR	alber
LBVRT	albert
LCLH	loch
LCMN	lymn
LCMR	alcmere
LCNR	lechner
LDFVRD	ledford
LDJ	aldo
LDK	ladak
LDVAYDJ	edvard
LDVYK	levy
LF	alf
LFLR	flor
LFTVS	loftus
LG	leg
LHAN	lehan
LHLH	lehle
LHMAN	lehman
LHMAN	lehman
LHMN	lehman
LHMN	lehman
LHNRR	lehnerer
LHRNTZ	lohrentz
LHRYAN	lehrian
LHYJ	lahij
LHY	leahy
LJ	j
LKAMBR	alhambra
LKRN	akron
LKRVS	kris
LKS	bks
LKSN	elkan
LKVST	kast
LKY	laky
LMBRN	lamborn
LMBRN	lamborn
LMBRT	lambert
LMBVRNH	lamborn
LMBVRN	lamborn
LMBVRN	lamborn
LMBVVRN	lamborn
LM	alm
LMP	lamp
LMPYNG	lamping
LMRZ	marz
LMVN	elman
LMYR	emyr
LNDAHL	landahl
LNDAVR	landauer
LND	land
LNDRY	landry
LNDRZ	landry
LNDVAY	lendvai
LNDY	lindy
LNDYN	landen
LNDYNV	landen
LNDZ	lodz
LNGLY	langley
LNGLYNG	lengeling
LNGMYD	langmaid
LNGMYD	langmaid
LNGSS	anguss
LNGSTN	langston
LNGSTVN	langston
LNKY	laky
LNLVSAMAD	lantlosamade
LNLVZAMYD	lantlosamade
LNNDN	landen
LNRT	lehnert
LNS	lens
LNSVN	lanson
LNTLVSAMAD	lantlosamade
LNTLVSAMYD	lantlosamade
LNTYN	lenten
LPARD	lepard
LPART	leppart
LPLA	lela
LP	lap
LPVRS	alperts
LPVRTA	laporta
LPVVRS	elvers
LRAP	lap
LRBZ	lerbs
LRD	lord
LRMN	lerman
LSARD	lessard
LSLY	laly
LSR	laser
LSR	laser
LST	last
LSYAK	lesiak
LTBRY	lathbury
LTJY	letje
LTRYJ	lory
LTV	lt
LVALAY	laly
LVATS	levants
LVAYNGH	laing
LVAYNJ	levant
LVAYN	ayn
LVBV	lvov
LVBVTYN	lambton
LVBYN	libyan
LVC	loc
LVDMN	lodman
LVDVRF	ludorf
LVDVVYKA	divya
LVDVVYKAS	dhakas
LVDVYJK	levavy
LVDVYKA	divya
LVDVYKAS	dhakas
LVDVYK	levavy
LVDVYKS	levys
LVDVYKVS	dykes
LVDVYSVS	levys
LVFARV	lofaro
LVFASV	lofaso
LVFBARV	lofaro
LVFR	alvaro
LVFSTRVM	lofstrom
LVGH	bligh
LVGNDRA	logendra
LVGZ	lanz
LVJYK	lavey
LVKA	alva
LVKARD	lockard
LVKAS	elvas
LVK	lok
LVK	lok
LVK	lok
LVK	lok
LVK	lok
LVK	lok
LVKN	alvin
LVKS	alves
LVKSTVN	galveston
LVKV	lvov
LV	alva
LV	alva
LV	alva
LVMAS	limas
LVMBARDV	lombard
LVML	laval
LVM	lam
LVMN	lymn
LVNAN	livian
LVNAV	lana
LVNDAN	landman
LVND	land
LVNDVN	landen
LVNJ	alvin
LVN	alvin
LVN	alvin
LVNLY	lively
LVNMV	lvov
LVNYG	lang
LVNY	lanny
LVNY	lanny
LVNY	lanny
LVNYNGDAL	lonningdal
LVNZ	lanz
LVNZ	lanz
LVPATKYN	lupatkin
LVP	lap
LVPR	luper
LVPRSTY	lopresti
LVPYN	lyn
LVPZ	lopez
LVRA	elvira
LVRA	elvira
LVRC	lorch
LVRD	lord
LVRJYV	larry
LVRNA	lorna
LVRN	lavern
LVRNS	laverns
LVRNT	levant
LVRNTZN	lorentzen
LVRNZ	lorenz
LVRNZN	lorenzen
LVRNZV	lorenz
LVRNZY	lorenz
LVRTVN	lorton
LVRTY	varty
LVRY	lavery
LVRY	lavery
LVRY	lavery
LVRY	lavery
LVRY	lavery
LVSANTVS	losantos
LVS	luvs
LVS	luvs
LVSMVR	lamar
LVSRV	lvov
LVSSKV	luvss
LVST	last
LVSTR	lastra
LVSTY	lusty
LVSYH	lash
LVSY	lavey
LVSY	lavey
LVSY	lavey
LVSYTV	last
LVTBG	luttbeg
LVTMPYV	lotempio
LVTR	alvaro
LVTYNZ	lanz
LVTZ	lutz
LVVRA	elvira
LVVRJAT	lauverjat
LVVT	lvov
'LVY	levy
'LVY	levy
LVYD	loyd
LVY	levy
LVY	levy
LVYNDN	lyndon
LVYNG	loyang
LVYN	lyn
LVYN	lyn
LVYNSVN	levinson
LVYS	levys
LVYSYLY	lyly
LVYSYVR	leviseur
LVYYNGH	loyang
LVYYNG	loyang
LVYYSALY	livesay
LVYYZV	lvov
LVYZ	allyz
LVZANV	lozano
LVZYR	lazar
'LYA	alya
'LY	ely
'LYA	alya
'LYA	alya
'LYA	alya
LYA	alya
'LY	ely
'LY	ely
LYAM	lam
LYANG	loyang
LYANZ	lanz
LYAV	alya
LYBANNRD	libannord
LYBANVRD	libannord
LYBCN	laban
LYBL	lebel
LYBLYT	liblit
LYBMN	lymn
LYBRCAK	lyrical
LYBRG	nyberg
LYBRN	lebrun
LYBRTY	liberty
LYBRYK	librik
LYBSKAMB	kamb
LYBSN	alyson
LYBVRN	claborn
LYBVYTZ	lyubovny
LYBYD	lebed
LYBY	lyly
LYCARSVN	licharson
LYCFYLD	alfeld
LYC	alyce
LYCMR	lycra
LYCTN	lection
LYCVRVYYS	lycurgus
LYDAL	lidal
LYDA	lydea
LYD	loyd
LYDMAN	lodman
LYDN	leyden
LYDN	leyden
LYDRAK	badrak
LYDRDRAP	leiderdorp
LYDRDRP	leiderdorp
LYDRDRVP	leiderdorp
LYDRDVRP	leiderdorp
LYDR	clyde
LYDVR	lidor
LYDVYNA	dvina
LYDYA	lydea
LYDYA	lydea
LYFAYV	lefaive
LYGYV	lyly
LYHY	lyly
LYK	lok
LYKYVRY	lavery
LYLA	layla
LYLA	layla
LYLA	layla
LY	ely
LYLBK	lilback
LY	ely
LY	ely
LY	ely
LY	ely
LY	ely
LYLY	lyly
LYLY	lyly
LYLYND	hyland
LYLYNTAL	lilienthal
'LYMA	kolyma
'LYM	lyme
'LYMA	kolyma
LYMBAX	lomax
LYMBVRG	limburg
LYM	lyme
LYMN	lymn
LYMR	lyme
LYMYNG	liming
'LYN	lyn
LYNAN	lyman
LYNARS	lenards
LYNDAL	lindal
LYNDAN	lynda
LYNDBK	lindback
LYNDBRG	lindberg
LYNDGARD	lindgard
LYNDGRN	lindgren
LYNDHLM	lindholm
LYND	lynda
LYND	lynda
LYNDL	lyndel
LYNDL	lyndel
LYNDMN	lyndon
LYNDMN	lyndon
LYNDN	lyndon
LYNDNMVT	lindenmuth
LYNDR	lynda
LYNDRMN	linderman
LYNDRVTS	landrys
LYNDSY	lynds
LYNDVN	lyndon
LYNDZ	lynda
LYNDZY	landry
LYNGAS	lyndas
LYNGLY	langley
LYNHAN	linehan
LYNH	lynch
LYNKH	lynch
LYNK	link
LYNKLN	lyndon
LYNKVLN	lankton
LYNKVYS	slinkys
LYN	lyn
LYN	lyn
LYN	lyn
LYN	lyn
LYN	lyn
LYN	lyn
LYN	lyn
LYNSTRAT	lysistrata
LYNVAL	laval
LYNVNN	lyndon
LYNVRA	lenora
LYPARD	lepard
LYPKYN	lipkin
LYPSKAMB	lipscomb
LYPSKMB	lipscomb
LYPSKM	elysium
LYPSKVMB	lipscomb
LYPSKVMP	lipscomb
LYPST	lipset
LYPYJ	lyly
LYR	lyra
LYR	lyra
LYRN	lymn
LYRYKAL	lyrical
LYRYK	lory
LYSBTH	lysbethje
LYSBTJH	lysbethje
LYSBTJ	lysbethje
LYSBTJY	lysbethje
LYSKANV	alaskan
LYSKMB	elysium
LYSKN	alyson
LYSKY	liskey
LYS	eloys
LYSN	alyson
LYSN	alyson
LYSTR	eyster
LYSTVN	blystone
LYSVN	alyson
LYSVN	alyson
LYSY	lyly
LYSYN	alyson
LYT	blyth
LYTL	lytle
LYTLTVN	littleton
LYTLY	lyly
LYTMN	lymn
LYTN	leyton
LYTRL	lytle
LYTV	blyth
LYTVN	leyton
LYTVN	leyton
LYTVYN	litvin
LYVA	lyra
LYVANDN	landen
LYVANDVN	landen
LYVAYN	lyman
LYVBVNY	lyubovny
LYVH	blyth
LYV	lye
LYV	lye
LYV	lye
LYV	lye
LYV	lye
LYVNARD	lenard
LYVNARDV	lenard
LYVNDVN	lyndon
LYVNGVD	livengood
LYVN	lymn
LYVNL	laval
LYVNSBRY	lounsbery
LYVNVRA	lenora
LYVNZ	lanz
LYVVH	lylah
LYVV	lvov
LYVY	levy
LYVYNGSTVN	livingston
LYVYN	kevyn
LYVYN	kevyn
LYVYS	levys
LYVYV	levy
LYVYVS	levys
LYVYVY	levavy
'LYYAH	aliyyah
LYYL	layla
LYYVVH	aliyyah
LYZA	liza
LYZA	liza
LYZARD	lazard
LYZARDZ	lazard
LYZBTY	buzby
LYZ	allyz
LYZN	lymn
LYZR	layer
LYZVT	liszt
MABANAG	mabanag
MABAY	malay
MABY	mawby
MAC	mac
MACTLD	machteld
MADABA	madaba
MADAKS	madras
MADJ	madej
MADLYN	madelyn
MADLYN	madelyn
MADLYN	madelyn
MADN	madon
MADRVN	madrone
MADSN	madsen
MADVN	madon
MADVRAY	madras
MADYGAN	madigan
MADY	mady
MADYS	mandys
MADYSVN	madison
MADYV	mady
MAFRY	maffray
MAFYN	martyn
MAGAGNA	magagna
MAGARD	maggard
MAGDALYNTH	magdaleentje
MAGD	magda
MAGLYRV	magliaro
MAGR	mager
MAGRVDR	magruder
MAGS	maggs
MAGVAYR	magyar
MAGVYR	magyar
MAGYL	magill
MAHADVAN	mahadevan
MAHAJAN	mahajan
MAHALT	mahault
MAHALY	mahaly
MAHA	maha
MAHAVLT	mahault
MAHTV	mahto
MAHVLT	mahault
MAHVT	mahto
MAJV	maj
MAJY	macy
MAJYV	macy
MAKARAYG	macaraeg
MAKAYVLY	mahaly
MAKK	mack
MAKLAQLYN	maclachlan
MAK	mak
MAK	mak
MAK	mak
MAKRYJ	mary
MAKSVL	makil
MAKSY	mackay
MAKSYM	lakshmi
MAKSYMYLYAN	ashmolean
MAKV	mak
MAKVMBR	macomber
MAKVNVCY	mackinac
MAKVSY	macvoy
MAKY	macky
MAKYNVN	maryann
MAKYRAS	mayras
MAKYSAK	maysan
MAKZYM	mackay
MALAMVD	malamud
MALAN	malan
MALBRG	malberg
MALD	malde
MALDN	malan
MALKVK	maldive
MALKVM	malcolm
MALN	malan
MALNR	malnar
MALRVNY	maloney
MALTYN	maltin
MALVN	malan
MALVNY	maloney
MALYGAN	malayan
MALYK	kalmyk
MAMA	mama
MAMFVRD	mumford
MAMN	maiman
MAMRT	mamet
MAMY	amy
MANAMA	manama
MANA	mana
MANA	mana
MANBR	manber
MANC	manca
MANDAL	mandal
MANDA	manda
MANDAR	mandar
MANDAVYL	mandal
MANDL	mandl
MANDR	mandar
MANDY	mandy
MANGAN	mangan
MANGLANY	manglani
MANGR	manager
MANGYN	mangan
MANJYT	manjit
MANJYT	manjit
MANKA	lanka
MANK	bank
MANKRT	munkert
MANKS	banks
MANKVS	banks
MANKY	macky
MANLY	manley
MANMA	manama
MAN	man
MANRV	marv
MANSN	manson
MANSTR	mansur
MANSYL	hansel
MANSYNGR	munsinger
MANTA	malta
MANTL	mantle
MANTNZ	lantz
MANTRAS	andras
MANTVR	mantor
MANTYKS	mandys
MANTY	mantey
MANVLY	manley
MANVLY	manley
MANV	man
MANV	man
MANV	man
MANV	man
MANVRY	manoury
MANX	manx
MANYJA	manija
MANYKS	mandys
MANY	many
MANY	many
MANYNG	manning
MANYSKAS	maniskas
MANYS	mandys
MANYT	manet
MANYV	many
MANZ	danz
MAPARTYDA	malpartida
MAPLZ	maple
MARALY	mahaly
MARANY	marani
MARAT	marat
MARAZAS	marazas
MARBAC	marbach
MARBL	marble
MARC	marc
MARCYNDV	maricondo
MARDR	marder
MARDVC	marc
MARFY	marcy
MARGALTA	margarita
MARGALYTY	margaret
MARGANTH	marregante
MARGANT	margaret
MARGARTA	margarita
MARGARYTA	margarita
MARGARYTAY	margarita
MARGARYTJH	margarietje
MARGARYTJ	margaret
MARGARYTJ	margaret
MARGARYTJY	margarietje
MARGARYT	margaret
MARGARYT	margaret
MARGARYT	margaret
MARGARYTY	margaret
MARGLYN	marilyn
MARGRTA	margarita
MARGRYJH	margery
MARGRYTA	margarita
MARGRYTH	margretha
MARGRYTH	margretha
MARGRYTJ	margret
MARGRYTJY	margrietje
MARGRYT	margret
MARGRYTYH	margretha
MARGVLYN	margolin
MARGVLYS	margerys
MARGVLYVKS	margerys
MARJNT	manjit
MARKHAM	markham
MARKLY	markley
MARK	mark
MARK	mark
MARKS	marks
MARKSN	marks
MARKSTYNR	marksteiner
MARKV	markov
MARKV	markov
MARKVM	markham
MARKVPVLY	markley
MARKVS	marks
MARKVS	marks
MARKVS	marks
MARKVYT	markey
MARKVYZA	maritza
MARKVZ	markov
MARKYL	markey
MARKY	markey
MARKYNGTVN	tarkington
MARKYYVS	marcys
MARLA	marla
MARLAT	marlatt
MARL	marla
MARLY	marley
MARLYN	marilyn
MAR	mar
MARN	marin
MARPL	marple
MARRL	marrs
MARSAL	marsala
MARSLA	marsala
MARSL	marisol
MARSLV	marsala
MARSLYNV	marilyn
MARS	mars
MARS	mars
MARSTVN	marston
MARSY	marcy
MARTL	martel
MARTLND	martland
MARTN	marten
MARTNTJY	martyntje
MARTYJN	martijn
MARTYJN	martijn
MARTYJNTJH	martijntje
MARTYJNTJY	martijntje
MARTY	marty
MARTY	marty
MARTYNH	martyn
MARTYNJ	martyn
MARTYNJ	martyn
MARTYN	martyn
MARTYN	martyn
MARTYNSN	martinsen
MARTYNTH	martyntje
MARTYNTH	martyntje
MARTYNTJH	martyntje
MARTYNTJ	martyntje
MARTYNT	martyn
MARTYNT	martyn
MARTYNV	martyn
MARTYNVS	martens
MARTYNZ	martyn
MARTYNZ	martyn
MARTYNZ	martyn
MARTYZN	martyn
MARTYZNTJ	martyntje
MARTZ	martz
MARVAHA	marwaha
MARVCY	marcy
MARV	marv
MARVN	marvin
MARVN	marvin
MARVNY	maroney
MARVYN	martyn
MARVYN	martyn
MARVYT	marvit
MARXAM	markham
MARYA	arya
MARYANA	mariana
MARYAN	maryann
MARYGANTH	marregante
MARYGANT	marregante
MARYH	march
MARYJH	marytje
MARYJH	marytje
MARYJKN	marijken
MARYJ	mary
MARYJNT	maryann
MARYKANDV	maryland
MARYKN	martyn
MARYLYN	marylynn
MARY	mary
MARY	mary
MARYN	martyn
MARYNV	martyn
MARYSH	marsh
MARYS	marys
MARYSVN	maryann
MARYTH	maratha
MARYTH	maratha
MARYTJ	marytje
MARYTJ	marytje
MARYTJY	marytje
MARYTJY	marytje
MARYT	marat
MARYT	marat
MARYV	marv
MARYVS	marys
MARYYANY	maryann
MARYZ	martz
MARZK	marek
MARZ	marz
MASAHYRV	masahiro
MASARA	masada
MASATAKA	masataka
MASATV	masato
MASAYV	masaryk
MASBRG	malberg
MASKARY	masaryk
MASKL	maskell
MASK	masek
MASKYAS	maniskas
MASLD	masud
MASLLY	malloy
MASNA	masna
MASNA	masna
MASRMN	masserman
MASTN	mastan
MASTYR	masters
MASVN	masin
MASYK	masaryk
MASY	macy
MASYMV	asimov
MASYN	masin
MATAKV	matako
MATA	mata
MATANA	matana
MATAR	matar
MATAY	malay
MATJKA	matejka
MATLV	mantle
MAT	mat
MATSVDA	matsuda
MATSVMVTV	matsumoto
MATSVN	matson
MATVLA	matula
MATV	marv
MATVR	matar
MATVS	mats
MATYNV	martyn
MATYS	martys
MATYS	martys
MATYV	marty
MATYVS	matyas
MAVBAY	mackay
MAVBY	mawby
MAV	marv
MAV	marv
MAV	marv
MAVN	main
MAVPYN	martyn
MAVR	mair
MAVRS	mavers
MAVSR	mansur
MAX	max
MAYFYLD	mayfield
MAYKLYS	barkleys
MAYKLZN	jacklyn
MAYK	mack
MAYKN	mayan
MAYKVHN	kayvon
MAYKVK	mayank
MAYLN	mayan
MAY	may
MAY	may
MAYMVN	ayman
MAYNDRT	maynard
MAYN	mayan
MAYN	mayan
MAYNR	mayer
MAYR	mayr
MAYR	mayr
MAYR	mayr
MAYR	mayr
MAYR	mayr
MAYRN	mayan
MAYRS	mayras
MAYRYK	masaryk
MAYRZ	marz
MAYSAL	maysan
MAYSA	maysan
MAYSL	mays
MAYSTYK	mayston
MAYTAG	maytag
MAYTHAM	latham
MAYT	mast
MAYT	mast
MAYTY	marty
MAYVHAY	mahaly
MAYV	marv
MAYZ	marz
MAZRA	mazera
MBARK	bark
MCLD	malde
MCTLD	machteld
MDABA	madaba
MDAVR	adar
MDBA	madaba
MDH	madah
MDLYN	madelyn
MDNYK	many
MDNYT	madinat
MDRK	mark
MDRR	dror
MDS	mds
MDSN	madsen
MDSVN	madsen
MDVNA	dvina
MDYNA	dyna
MDYNH	dyna
MDYNH	dyna
MDYN	dyna
MDYNNY	danny
MDYNT	dent
MDYSVN	dyson
MDYSVN	dyson
MFRG	marge
MFRK	mark
MFRVK	marek
MGDALNT	magdalena
MGDALYNTJ	magdaleentje
MGDALYYNTJH	magdaleentje
MGDA	magda
MGDAYNTJ	magdaleentje
MGLAGLYN	maclaughlin
MGLAT	aoglat
MGNAN	magnan
MGNASN	magnan
MGNH	magne
MGNY	many
MGR	mager
MGY	may
MGY	may
MGY	may
MGYNL	maginel
MGYS	mays
MGYSY	gypsy
MGYV	magyar
MHADVAN	mahadevan
MHAMA	mama
MHARAK	mubarak
MHL	mehl
MH	mah
MHMA	mama
MHRAH	mahrah
MHRA	mahrah
MHRG	marge
MHRH	mahrah
MHRK	mark
MHRM	arm
MHVYT	chevy
MJDL	majdal
MJ	maj
MJYA	maya
MJYD	majid
MJYKAL	majdal
MJYK	mack
MKAH	mah
MKALYR	malur
MKA	mika
MKARDL	kardal
MKDALN	medan
MKDRMVT	kermit
MKDVLND	midland
MKDVNALD	mcdonald
MKDVNALD	mcdonald
MKDVYL	advil
MKFARLND	mcfarland
MKFARLYN	marilyn
MKFRLYN	marilyn
MKGAVYN	mcgavin
MKGRAT	mcgrath
MKGVVAN	kevran
MKGVYRK	mcguirk
MKGVYR	magyar
MKGYRY	magyar
MKH	mah
MKH	mah
MKHNRY	mchenry
MKKAH	mekkah
MKKAN	mekkah
MKKARTY	karty
MKKARTY	karty
MKKAVN	keaven
MKKNA	mickna
MKKNY	keny
MKKNZY	kanze
MKKRKN	morken
MKLAGLYN	kalyan
MKLAQLYN	kalyan
MKLARN	mclaren
MKLAVLYN	kalyan
MKLAVLYN	kalyan
MKLAVVGYNG	lavigne
MKLYN	allyn
MKLYN	allyn
MK	mak
MK	mak
MKMAHAN	mcmahan
MKMAHVN	mcmahan
MKMAHVN	mcmahan
MK	mak
MKMANYS	mcmanis
MKMVLN	akman
MKMYLAN	maryland
MKNAT	keat
MKNYL	knel
MKNYL	knel
MKRA	mara
MKRAYH	mirach
MKRAY	moray
MKRDY	cordy
MKRVN	marvin
MKRYS	marys
MKSFYLD	mansfield
MKSN	masin
MKSYMV	moiseyev
MKTAVYS	koktavy
MKVC	mac
MKVTV	makoto
MKVY	davy
MKVY	davy
MKYL	mkel
MKY	macky
'ML	amal
MLA	ala
MLANDR	melander
MLANY	many
MLAYYR	layer
MLBAY	albany
MLCR	macra
MLCYR	cyr
MLKA	melka
MLKVLM	malcolm
MLKVM	melka
MLMN	melman
MLN	emlen
MLR	lr
MLTH	myth
MLV	melva
MLVN	melvin
MLVR	malur
MLYBV	klyber
MLYDY	melody
MLY	ely
MLYNGR	malnar
MLYN	lyn
MLYNY	flynn
M'MA	mama
MMH	mah
MMTA	mamta
MNAMA	manama
MNAMH	manama
MNARD	menard
MNDL	mandl
MNDL	mandl
MNDL	mandl
MNDR	andr
MNDVZA	mendoza
MNDYBL	mandible
MNDYK	mendyke
MNDY	mandy
MNDZ	mendez
MNFVL	manfull
MNGAN	mangan
MNGH	anghe
MNG	meng
MNGS	mangus
MNHART	menhardt
MNH	mah
MNJYVN	mayan
MNK	monk
MNKVSV	monks
MNKYVS	minskys
MNMA	mama
MNNYNG	manning
MNRV	marv
MNSA	mansa
MNSN	manson
MNSTRYNA	menestrina
MNSVR	mansur
MNSVR	mansur
MNSVR	mansur
MNSVRY	mistry
MNTL	mantle
MNT	mont
MNTQH	menth
MNTSR	mantor
MNTSYNN	mantsinen
MNTY	monty
MNTZR	mentzer
MNYJR	mayer
MNYKS	minsks
MNY	many
MNY	many
MNYNG	enying
MNYN	amnon
MNZR	mentzer
MNZS	mns
MNZYZ	mandy
MPL	maple
MPL	maple
MQBRH	moqbara
MQRBY	moreby
MQSVD	maqsood
MRANDA	maranda
MRDYS	gradys
MRDYT	mady
MRHAVS	marshas
MRJYNYV	bryony
MRKL	merkel
MRKLY	markley
MRKNT	brant
MRKR	mark
MRNDA	manda
MRNY	many
M'RQ	mafraq
MRSR	mrs
MRSRYA	misra
MRSRYV	masaryk
MRTN	marten
MRTNZ	martinez
'MR	mr
MRVAH	marva
MRVAN	moravan
MRYGAN	morgan
MRYJ	mary
MRYK	marek
MRYKS	marks
MRYMAN	ryzman
MRY	mary
MRY	mary
MRYMN	rymon
MRYNLY	bryony
MRYS	marys
MRYT	marat
MRZ	marz
MSALXY	malay
MSA	mesa
MSANDR	mesander
MSBARN	barn
MSKS	omsks
MSKYN	miskin
MSLYN	maslin
MSMAN	isman
MSR	mar
MSS	mass
MSTAN	mastan
MST	mast
MST	mast
MSTRZ	mistry
MS'VD	masud
MSYF	asif
MSYNA	masna
MSYNGR	synge
MSYN	masin
MSYVS	mayas
MTANA	matana
MTLYN	matlin
MT	mt
MT	mt
MTNA	etna
MTNA	etna
MTRNC	marc
MTRNYC	ternyck
MTRV	marv
MTRYNC	martyn
MTSGR	metzger
MTSVMVTV	matsumoto
MTSVN	matson
MTVR	matar
MTYN	martyn
MTYN	martyn
MTYV	marty
MTYV	marty
MTYV	marty
MTYVS	matyas
MTYVS	matyas
MTYVSVN	maysan
MTYVZ	matyas
MTZGR	metzger
MTZYNG	metzing
MVALR	malur
MVANZR	malnar
MVBAY	bombay
MVBLY	mobley
MVDGYL	gudgel
MVD	md
MVDY	mady
MVDY	mady
MVFAD	mead
MVGANTY	moganti
MVHAMA	muhamma
MVHAN	mohan
MVHR	mohar
MVKASA	mukasa
MVK	mak
MVKRYJ	avery
MVLANDR	melander
MVLDN	malan
MVLK	melka
MVL	mel
MVLN	malan
MVLR	malur
MVLR	malur
MVLVY	malay
MVLYGAN	malayan
MVLY	emily
MVLYNARY	malnar
MVMFVRD	mumford
MV	av
MVNAGAN	monagan
MVNAK	monack
MVNAKV	mintaka
MVNAZ	mana
MVNDFRANS	mondfrans
MVNDVR	mandar
MVNKAR	menkar
MVNK	monk
MVNKS	monks
MVNKZ	menke
MVN	man
MVN	man
MVNRV	marv
MVNS	mans
MVNTAG	montag
MVNTAGV	montag
MVNTALBANV	montalbano
MVNTA	monta
MVNTANARV	montanaro
MVNTANV	montana
MVNTGMRY	montgomery
MVNTGVMRY	montgomery
MVNT	mont
MVNTRAL	montreal
MVNTRV	mantor
MVNTVYA	montoya
MVNTYJV	montijo
MVNVLYT	manley
MVNYZ	many
MVNZLR	muenzler
MVRABYTV	morabito
MVRAD	murad
MVRAL	amaral
MVRALS	morales
MVRALT	muralt
MVRA	mara
MVRANDV	maranda
MVRAN	moran
MVRANV	marani
MVRAS	maras
MVRAVAN	moravan
MVRAY	moray
MVRAYNS	morans
MVRC	marc
MVRDAC	myrdal
MVRDAK	marduk
MVRFY	marcy
MVRHAVS	marshas
MVRHAVS	marshas
MVRKL	merkel
MVRKN	morken
MVRLAN	morlan
MVRL	marla
MVRL	marla
MVRL	marla
MVRLYJ	marilyn
MVRLY	marley
MVRMAN	amerman
MVR	mar
MVRNYNG	morning
MVRS	mars
MVRS	mars
MVRS	mars
MVRSTAD	maurstad
MVRTAN	martian
MVRTN	marten
MVRTVN	marten
MVRTYMR	mortimer
MVRTYMR	mortimer
MVRTY	marty
MVRTYMVR	mortimer
MVRV	marv
MVRVNY	cerveny
MVRVYL	marvell
MVRYL	beryl
MVRY	mary
MVRY	mary
MVRYN	martyn
MVRYSN	marys
MVRYSVN	bryson
MVRYSVN	bryson
MVRYTA	marta
MVSAL	missal
MVSANA	mana
MVSFYS	missys
MVSLA	ameslan
MVSMN	masin
MVS	avs
MVSVN	masin
MVSVY	missy
MVSYG	mansig
MVSY	missy
MVSYR	mayr
MVSYVN	masin
MVSZ	avs
MVTA	mata
MVTANA	matana
MVT	mat
MVTVR	matar
MVTVRZ	marz
MVTYSV	martys
MVVR	ivar
MVYL	beyl
MVY	ivy
MVYNYHAN	moynihan
MVYNZ	mayne
MVYR	mayr
MVYSAN	maysan
MVYS	mays
MVYSS	maviss
MVYSVN	maysan
MVYZ	ivy
MVYZVN	mayan
MVZYNA	mozina
MVZZ	marz
MYAV	marv
MYAYNDRT	maynard
MYCALYS	carlys
MYCA	myra
MYCAN	mayan
MYCAYLYS	carlys
MYCL	cl
MYCLTJN	micheltjen
MYCLTN	maclean
MYCLTYN	jaclyn
MYCLYS	macys
MYCN	macon
MYDLBRV	middlebro
MYDLTN	medlin
MYDLTVN	maltin
MYD	md
MYDR	myer
MYDY	mady
MYGN	magne
MYGNRAN	magnan
MYGNRY	mignerey
MYGR	myer
MYGR	myer
MYGVYL	magill
MYHALYK	mahaly
MYHAN	mohan
MYJR	myer
MYJRY	marjory
MYKAK	mak
MYKALK	mayall
MYKA	mika
MYKAS	myras
MYKAYL	mikael
MYKAYYL	mikael
MYKAYYLYZ	marylynn
MYKAYYLZ	kayla
MYKK	mikki
MYKLACLN	maclachlan
MYKLJN	mikulin
MYKLM	micklem
MYKLSN	mickelson
MYKLSVN	mickelson
MYK	mak
MYKNA	myrna
MYKR	myer
MYKS	amys
MYKS	amys
MYKS	amys
MYKT	myst
MYKVK	mayank
MYKVLYK	kalmyk
MYKV	mak
MYKYNG	mekong
MYKYNZ	dykins
MYKZ	mak
MYLAD	milad
MYLAM	milam
MYLAM	milam
MYLAN	dylan
MYLARA	melara
MYLARD	mylar
MYLAR	mylar
MYLASYS	malays
MYLBRT	milbert
MYLDRD	mildred
MYLGRAM	milgram
MYLKS	milks
MYLKV	melka
MYLKY	milky
MYLMAN	melman
MYLMAN	melman
MYLMV	mylar
MYLN	dylan
MYLNR	mylar
MYLNVR	malnar
MYLNYVM	smyley
MYLR	mylar
MYLSTVN	mayston
MYLT	milt
MYLT	milt
MYLTN	maltin
MYLVARD	aylward
MYLV	melva
MYLVS	myles
MYLVT	melva
MYLYANZ	malayan
MYLYGAN	malayan
MYLYKN	marylynn
MYLY	lyly
MYLY	lyly
MYLY	lyly
MYLYND	hyland
MY	amy
MYMAS	mimas
MY	amy
MY	amy
MYMY	emmy
MYNA	myrna
MYNA	myrna
MYNAMV	manama
MYNARD	maynard
MYNARD	maynard
MYNARYK	masaryk
MYNDRT	meindert
MYNGV	meng
MYNKY	minsky
MYN	ayn
MYN	ayn
MYN	ayn
MYN	ayn
MYN	ayn
MYNRAL	mineral
MYNR	myer
MYNRVA	minerva
MYNRZ	marz
MYNSR	mansur
MYNSTRL	minstrel
MYNSY	minsky
MYNTAKAH	mintaka
MYNTAKVA	mintaka
MYNTKA	mintaka
MYNT	mont
MYNTR	mantor
MYNTVN	minton
MYNTZ	mintz
MYNVARYNG	mainwaring
MYNYARD	minyard
MYNY	many
MYNZ	mayne
MYNZ	mayne
MYPL	maple
MYRA	myra
MYRA	myra
MYRANKR	miranker
MYRFLD	mayerfeld
MYR	emyr
MYRMAK	mirmak
MYR	emyr
MYR	emyr
MYR	emyr
MYRS	myers
MYRSY	myers
MYRTY	marty
MYRVA	marva
MYRVL	myrdal
MYRVT	marvit
MYRYDYT	myrdal
MYRZ	marz
MYRZ	marz
MYRZ	marz
MYSA	maysan
MYSA	maysan
MYSAN	maysan
MYSAT	myst
MYSLAV	mylar
MYSL	myst
MYSL	myst
MYSM	myst
MYSN	maysan
MYSRA	misra
MYSTRY	mistry
MYSTYK	misty
MYSVNR	masoner
MYSYK	masaryk
MYTAL	maytag
MYTAVA	amitava
MYTCL	mitch
MYTCM	mitch
MYTNYK	mayank
MYTRVVYK	mitrovic
MYTSL	mysts
MYTV	myth
MYTV	myth
MYTVN	matin
MYTVNN	hyvonen
MYV	amy
MYVS	amys
MYVSN	maysan
MYVVZ	martz
MYVZ	marz
MYVZR	myer
MYYH	myth
MYYR	mayr
MYYRS	myers
MYZ	amy
MYZ	amy
MYZVN	myron
MYZYRA	mayra
MZDH	mazdeh
MZYK	muzak
MZYVN	mayan
NAB	na
NABL	nabil
NABYL	nabil
NADAN	adan
NADANSVN	nathanson
NADVLNY	nadolny
NADYG	nadig
NAF	knaff
NAF	knaff
NAF	knaff
NAFZA	nafeeza
NAGASAKY	nagasaki
NAGASYVA	nagasiva
NAGNT	agent
NAGY	nagy
NAHAM	nahum
NAJR	nair
NAJYAH	najiyah
NAJYA	najya
NAKAGAKY	nakagaki
NAKAMVRA	nakamura
NAKASVRA	nakasora
NAKASYMA	nakashima
NAK	bak
NAKSVN	nansen
NAKVYYN	naveen
NAL	neal
NALYK	kalmyk
NAM	nam
NANDVANY	nandwani
NANLY	nancy
NAN	nan
NANS	nans
NANSY	nancy
NANTVN	naunton
NAP	gap
NAP	gap
NAPTVN	napton
NAPVLYTANV	napolitano
NARAD	narad
NARDN	nardi
NARDV	nardi
NARDY	hardy
NARLA	narla
NARSAVAG	narsavage
NARV	harv
NASAV	nassau
NAS	nas
NAS	nas
NATAN	nathan
NAT	nat
NATSN	nats
NAVAR	navarre
NAVARV	navarre
NAVAS	navas
NAV	nave
NAV	nave
NAVYA	najya
NAVYLV	naylor
NAYA	najya
NAYDV	ayda
NAYFH	nayfeh
NAYFLR	naylor
NAYKRBYKR	ackroyd
NAYKS	banks
NAYKS	banks
NAYKVLAS	ayalas
NAYLR	naylor
NAYLZ	naylor
NAYMAH	naimah
NAYRMN	ayman
NAYT	nat
NAYT	nat
NAZAHA	nazahah
NAZARYTYAN	nazaretian
NAZARYV	nazario
NBATAY	nabatiye
NBATYH	nabatiye
NBATY	nabatiye
NBL	nabil
'NBR	anbar
NBRS	brs
NDA	nida
NDKARNY	nadkarni
NDN	nan
NDVD	nedved
NDYN	andy
NFAN	enfant
NFDV	nd
NFJAN	neefjan
NFL	anil
NFYSA	nyasa
NFYZA	nafeeza
NFZA	afzal
NGTYV	nagoya
NGY	nagy
NHAVS	navas
NHNH	nahnah
NJAF	najaf
NJF	najaf
NJVA	neva
NJYAH	najiyah
NJYA	najya
NJYH	najiyah
NKLAS	niklas
NKLS	niklas
NKNZ	niknaz
NKV	nev
NKV	nev
NL	al
NLKYN	nelkin
NLS	nils
NLSN	nelsen
NLT	lt
NMAZY	namazi
NPAN	nan
NP	np
NPL	nepal
NPR	apr
NPTVN	napton
NPVRA	napora
NRAD	narad
NRDNFLT	nordenfelt
NRS	ars
NRTRVP	northrop
NRVP	norup
NRY	nery
NRY	nery
NSLY	ansley
NSNAL	snail
NSVA	neva
NSVM	anselm
NSYDA	ayda
NSYHA	nasiha
NSYH	nash
NSYRA	nasira
NTAKR	anntar
NTRTVN	norton
NTYFA	atifa
NTYHA	anthea
NVALA	narla
NVAR	invar
NVAYL	naylor
NVAZ	invar
NVBL	nabil
NVBL	nabil
NVDA	nevada
NVDYNG	nuding
NVF	enif
NVGNT	nugent
NVJANS	nevejans
NVJANZ	nevejans
NVJNANS	nevejans
NVJNS	nevejans
NVJNT	advent
NVKS	navas
NVKV	lvov
NVLAN	nolan
NVLD	nelda
NVLF	nolf
NVL	nevel
NVL	nevel
NVNYS	ninoys
NVP	np
NVRA	nora
NVRBAY	norby
NVRDA	neruda
NVRDBAY	nordby
NVRDBVRG	nordborg
NVRDDRAP	noorddorp
NVRDNSTVRM	nordenstrom
NVRDRAP	narendra
NVRDRVPH	noorddorp
NVRDT	nordt
NVRDVRP	noorddorp
NVRDVRP	noorddorp
NVRHA	norha
NVRKAT	barakat
NVRN	noren
NVRSRAP	aversa
NVRSVRP	northrop
NVRTKAT	barakat
NVRTVRPH	northorpe
NVRTVRP	northrop
NVRVVD	narad
NVRY	nery
NVSAK	nosack
NVSL	nevel
NVT	nat
NVTZN	knutzen
NVTZ	notz
NVVALA	nevada
NVVRDDRP	noorddorp
NVVSL	nevel
NVVYK	novik
NVYA	noya
NVYFL	nayfeh
NVYJANZ	nevejans
NVYK	novik
NVYL	nevel
NVYL	nevel
NVYLS	noyles
NVYNGTVN	newington
NVYS	andys
NVZ	inez
NYBY	newby
NYCVLAS	niclas
NYCVLS	nichols
NYDAL	nidal
NYDA	ayda
NYDH	ayah
NYDLZ	nadler
NYD	nd
NYFJAN	neefjan
NYFYN	nyman
NYGLY	lyly
NYG	nye
NYGRA	nigra
NYGT	night
NYHALANY	nihalani
NYKALAS	ayalas
NYKLAS	niklas
NYKLAS	niklas
NYKLAS	niklas
NYKLAS	niklas
NYKL	akl
NYKL	akl
NYKL	akl
NYKL	akl
NYKLS	niklas
NYKLS	niklas
NYKLS	niklas
NYKLS	niklas
NYKLSN	neilson
NYKLSN	neilson
NYKLSVN	neilson
NYKLV	niklas
NYKLZ	niklas
NYKLZ	niklas
NYK	nik
NYK	nik
NYK	nik
NYKRBAKR	knickerbacker
NYKRBKR	norbert
NYKRBYKR	norby
NYKRSVN	nickerson
NYKS	nyikos
NYKSVN	ayson
NYKVLA	nukala
NYKVLAS	niklas
NYKVLAS	niklas
NYKVLAS	niklas
NYKVLAS	niklas
NYKVL	anukul
NYKVLSAN	nickelsen
NYKVLS	niklas
NYKVLS	niklas
NYKVLS	niklas
NYKVLSVN	nickelsen
NYKVLYK	kalmyk
NYKVLY	nikolay
NYKVLY	nikolay
NYKVLZ	niknaz
NYKVLZ	niknaz
NYKV	nev
NYKY	funky
NYKY	funky
NYKY	funky
NYKY	funky
NYLBRY	allbery
NYLJH	lylah
NYLMG	analog
NYLND	hyland
NYL	nye
NYL	nye
NYLS	nils
NYLS	nils
NYLS	nils
NYLS	nils
NYLTH	lylah
NYLTJH	heyltje
NYLTJ	heyltje
NYLTJY	heyltje
NYLZ	elz
NYMAH	nyman
NYMA	nyman
N'YMH	naimah
NYMH	nyman
NYMRAD	narad
NYMTZ	nimtz
NYMY	nyman
NYNDK	lynda
NYNJA	ninja
NYN	ayn
NYN	ayn
NYNS	nans
NYNSTAR	ninstar
NYNV	ayn
NYNVYS	ninoys
NYPAN	nyman
NYPNBRG	nyberg
NYPTVN	napton
NYR	cyr
NYR	cyr
NYS	andys
NYS	andys
NYSN	ayson
NYSPL	knispel
NYSYLDA	gnishilda
NYTYN	nitin
NYVAN	nyman
NYVARK	newark
NYVAYNGTN	yangon
NYVAYNGTVN	naunton
NYVBAY	bombay
NYVBRY	newbery
NYVBRY	newbery
NYVKVLAS	nickolas
NYVKVYST	nevskys
NYVLND	hyland
NYVMAN	nyman
NYVMAN	nyman
NYVMN	nyman
NYVMYR	emyr
NYVSAM	nyasa
NYVTN	nyman
NYVVYNGTVN	newington
NYVYSVN	nevison
NYVYYNGTVN	newington
NYYVKAMB	kamb
NYYVTN	kayvon
'NYZH	ayah
NZAHAH	nazahah
NZAHA	nazahah
NZAHH	nazahah
NZYRAH	nazirah
NZYRA	byra
NZYRH	nazirah
PABLT	pablo
PABLV	pablo
PACVLKH	pacholke
PACYANV	pachiano
PADVA	padua
PADVLA	padula
PADYAL	padial
PADYLA	padula
PAGLAYS	paglias
PAGLYA	paglia
PAGLYS	paglias
PAGLYYARV	pagliaro
PAGT	page
PAJT	pant
PAKALA	pakala
PAKARD	packard
PAKNAS	pakenas
PAKS	paks
PAKS	paks
PAKT	pak
PAKVAT	akiva
PALAGY	palagyi
PALAK	palau
PALFVRD	alford
PALMRT	palmert
PAL	pal
PAL	pal
PALRMV	palermo
PALSKY	polsky
PALSN	paulsen
PALSYFR	palmyra
PALTJH	paultje
PALTJ	paultje
PALTJY	paultje
PALVMBV	palumbo
PALYDV	paley
PALY	paley
PALY	paley
PALY	paley
PALYS	carlys
PAMFRY	pumfrey
PAM	pam
PANAGS	panagos
PANAS	panas
PANC	pan
PANDA	panda
PANDR	andr
PANDVLFYNV	pandolfino
PANDYAN	pandian
PANDYT	pandit
PANDZ	panda
PANFYL	panfil
PANGBVRN	pangborn
PANJABY	punjab
PANKRAS	pancras
PANKRS	pancras
PANN	panon
PAN	pan
PANT	pant
PANVALKR	panvalkar
PANVN	panon
PANYKV	pandya
PANYSY	pansy
PAPALARDV	pappalardo
PAPAY	papay
PAPLASKAS	paplaskas
PAPLTVN	alton
PAPLY	papay
PAPN	pan
PAP	pape
PAP	pape
PAPVYK	papay
PAQ	pa
PARA	parra
PARAT	marat
PARAYL	parayil
PARDN	pardon
PARDYNGTN	pardington
PARDYNGTVN	pardington
PARDY	hardy
PARDZ	pardi
PARHAM	parham
PARK	park
PARKYN	parkyn
PARKZ	park
PARMAR	parmar
PARNS	pans
PARSANZ	parisian
PARSL	parsi
PARSN	parson
PARSVNS	parsons
PARSVNZ	parson
PARTVN	parton
PARTVS	partos
PARTY	karty
PARYNGTVN	pardington
PARY	parry
PARYS	marys
PASKAL	pascal
PASKV	pasko
PASKV	pasko
PAS	pas
PASTRNAK	pasternak
PASTVR	pasteur
PASYFYK	masaryk
PASYR	pansy
PATN	patna
PATR	paar
PATRSVN	paterson
PATRSVN	paterson
PATRVKLVS	patroclus
PATRYK	patrik
PATRYK	patrik
PATRYK	patrik
PATRYS	patsys
PATRYSYA	patrica
PATRYZYV	patrizio
PATS	pates
PATTA	gatta
PATVCY	pataky
PATVKSNT	patuxent
PATYL	patel
PAVL	pavol
PAVLSN	paulsen
PAVLS	pauls
PAVLTH	pavlik
PAVLT	pavlik
PAVLYK	pavlik
PAV	av
PAVV	pavlov
PAYJ	payne
PAYK	pack
PAYNH	payne
PAYN	payne
PAYNTVN	paynton
PAYNY	payne
PAY	day
PAYPR	paypal
PAYRAMYD	pyramid
PAYTH	ghayth
PAYTJ	payton
PAYTR	paynter
PAYTR	paynter
PAYTVN	payton
PAYVLSVN	paulsen
PAYVLTJ	paultje
PAYVTH	ghayth
PD	pd
PDRAM	pedram
PDRSN	parson
PDRSVN	parson
PDY	pd
PG	peg
PGRAM	pegram
PGT	pat
PK	pak
PKR	kr
PKYNGZ	peking
PLAK	plack
PLAMN	plamen
PLAMR	lamar
PLANK	planck
PLAN	alan
PLANT	plante
PLASTYNV	plastino
PLATFVRM	platform
PLAT	plat
PLAT	plat
PLATYV	plat
PLAYR	layer
PLC	pl
PLHAM	pelham
PLKCYA	alcoa
PLKY	polsky
PLNKNR	plencner
PLNTH	plath
PLTAYR	altair
PLTCR	pletcher
PLTFRM	platform
PLTKVS	platkus
PLTNN	peltonen
PLT	pelt
PLT	pelt
PLTYV	poltava
PLTYYR	plyler
PLVHN	ploehn
PLVMR	palmer
PLYGRYNY	almgren
PLYNSKYN	plinskin
PLYSKYN	pliskin
PLYT	plat
PLYV	alya
PNBAKR	anbar
PNDLTN	pendleton
PNDLTVN	pendleton
PNDYA	pandya
PNGADV	pengadu
PNG	pang
PNKRAS	ankaras
PNL	pal
PN	pan
PNS	pans
PNTVN	panton
PNYMAN	nyman
PNYNSVLA	peninsula
PNYNZVLA	peninsula
PNY	pansy
PPH	poh
PPLR	apple
PPYN	payne
PRABST	pabst
PRACT	pratt
PRADV	prada
PRAGV	prager
PRAHL	prahl
PRAKTYKVM	praktikum
PRAL	prael
PRALT	prall
PRAM	pram
PRAMVD	pramod
PRANAV	pranav
PRANGS	prongs
PRANK	pranke
PRAPYS	brays
PRASAD	prasad
PRASANA	prasana
PRASANT	prashant
PRASN	prasen
PRAS	aras
PRATP	pratap
PRAT	pratt
PRATS	prates
PRATVL	pratul
PRATYK	prateek
PRATYKS	pratiksh
PRATYKV	prateek
PRAVL	pravil
PRAVYN	praveen
PRAYB	arab
PRAYL	parayil
PRAYM	pram
PRAYVN	prasen
PRAYVYT	prakrit
PRBN	preben
PRC	percy
PRDYKARV	hardikar
PRDYKYS	perdikis
PRDYS	gradys
PRKAS	erikas
PRKS	parks
PRKYNS	parkyn
PRKYNZ	parkyn
PRLMAN	perlman
PRLMN	perlman
PRL	perl
PRLR	perler
PRLY	orly
PRMAL	premal
PRNT	pant
PRNTYS	montys
PRPK	perpk
PRSATTAM	purshottam
PRSKAT	prashant
PRSL	april
PRSLT	parsley
PRSTN	preston
PRSTRVD	prestrud
PRSTRV	prestero
PRSTVN	preston
PRSVN	parson
PRSYNV	parkyn
PRSYVAL	parsifal
PRVAMR	pram
PRVAN	provan
PRVGTV	private
PRVJT	projet
PRVMVNTVRY	promontory
PRVN	parvin
PRVPS	propes
PRVS	pres
PRVTRV	petrov
PRVTVS	prates
PRVV	provo
PRVVST	prevost
PRVYN	parkyn
PRVY	pruy
PRVYS	purvis
PRYA	priya
PRYAVLT	perrault
PRYBL	preble
PRYCARD	picard
PRYDY	preedy
PRYKLY	prickly
PRYKN	aryan
PRYKT	prakrit
PRYLV	prall
PRYMRV	pryor
PRYMV	pram
PRYMYVS	pygmys
PRYNG	prong
PRYN	bryn
PRYNS	aryans
PRYNSS	prensas
PRYNT	bryant
PRYNY	bryony
PRY	pery
PRYSKAT	prashant
PRYSLR	chrysler
PRYSTLY	priestly
PRYSTLY	priestly
PRYST	priest
PRYSTVN	preston
PRYSYLA	poosala
PRYSYNG	rysling
PRYTCARD	pritchard
PRYTY	pretty
PRYTY	pretty
PRYTZ	pritz
PRYVR	pryor
PRYVS	pryors
PRYVST	prevost
PRYYVTY	pretty
PRZ	perez
PSKYN	parkyn
PSNKV	pinky
PS	ps
PSTMA	postma
PST	post
PTCR	petcher
PTKR	patkar
PTLA	atila
PTRN	petren
PTR	peter
PTRSN	parson
PTRSN	parson
PTRSVN	parson
PTRSVN	parson
PTRVF	petrov
PTRVNLA	petronella
PTRV	petrov
PTRVV	petrov
PTRVYC	patric
PTRYC	patric
PTRYK	patrik
PTRY	petry
PTRZ	perez
PTSY	patsy
PTV	pt
PTYBN	patten
PTYBVN	paysan
PTYL	patel
PTYNS	paynes
PTY	patsy
PTY	patsy
PTY	patsy
PTYTJYN	payton
PTZVLD	petzold
PVALMA	adalma
PVA	ava
PVGA	puga
PVGLYS	peggys
PVG	peg
PVGVSYAN	pogosyan
PVHAN	puhan
PVHAR	pohar
PVHL	pohl
PVH	poh
PVKVRNY	pokorny
PVLAKVS	pavlovs
PVLGAR	pulgar
PVLK	pavlik
PVLMYTYS	almatys
PVLND	poland
PVLN	polen
PVLN	polen
PVLNT	polant
PVL	pal
PVL	pal
PVLSN	polson
PVLS	opals
PVLS	opals
PVLTR	pelt
PVLV	pavlov
PVLVVYN	pavlovian
PVLYNG	poling
PVLYPALY	paypal
PVLY	paley
PVLYS	pollys
PVLYT	pelt
PVLYYAM	khayyam
PVLZ	volz
PVMA	puma
PVMFRY	pumfrey
PVNA	pena
PVNT	pant
PVNVZ	panza
PVPAT	popat
PV	av
PVP	epp
PVP	epp
PVRAHV	prahl
PVRANYK	puranik
PVRJZ	perez
PVRKV	park
PVR	apr
PVRTNVY	portnoy
PVRTRFYLD	porterfield
PVRVS	purvis
PVRYNTVN	paynton
PVRYR	pryor
PVSALA	poosala
PVSARY	peary
PVSN	posen
PVS	avs
PVSTYL	postill
PVSV	avs
PVSY	pansy
PVTKVNN	putkonen
PVT	pat
PVTRY	petry
PVTYT	patt
PVTYT	patt
PVTZ	putz
PVVLZ	volz
PVV	lvov
PVYNT	pant
PVYNTYNG	poynting
PVYRYR	pryor
PVYSL	poisl
PVYV	ivy
PVZYVS	pavlovs
PYAK	pak
PYATJY	patsy
PYATK	piatek
PYBADY	badry
PYDH	ayah
PYD	pd
PYD	pd
PYJH	ayah
PYJT	pyotr
PYKAP	pickap
PYKARD	packard
PYKASV	dykes
PYKL	psyko
PYK	pak
PYK	pak
PYK	pak
PYK	pak
PYKRL	pearl
PYKS	paks
PYKVLBNY	kilby
PYKZ	psyko
PYLAR	mylar
PYLARZ	mylar
PYLATV	pilate
PYLAZV	blaz
PYL	pyle
PYL	pyle
PYLVSKY	polsky
PYLVYV	lvov
PYLY	lyly
PYLYSNRY	pillsbury
PYNAKL	paypal
PYNA	dyna
PYNCAZ	pancras
PYNCRA	pancras
PYNDAR	pindar
PYNDV	lynda
PYNGNVT	pingenot
PYNG	pang
PYNKVVYTZ	pinkowitz
PYNKY	pinky
PYN	ayn
PYN	ayn
PYN	ayn
PYNSN	pinson
PYNSVN	pinson
PYNTH	cynthia
PYNTN	paynton
PYNTR	paynter
PYNTR	paynter
PYNTR	paynter
PYNTVN	paynton
PYNTVN	paynton
PYNV	payne
PYNV	payne
PYNXAM	panama
PYNYAN	pinyan
PYNY	pansy
PYNZ	panza
PYPGRAS	pipgras
PYP	pype
PYP	pype
PYPR	pype
PYPVNY	epiphany
PYRAMYD	pyramid
PYRAN	piran
PYRANY	cyrano
PYRARD	pirard
PYRAVAT	pirawat
PYRKV	park
PYRLMAN	perlman
PYRL	perl
PYRMN	byron
PYR	cyr
PYRSN	parson
PYRSN	parson
PYRSN	parson
PYRS	pyers
PYRS	pyers
PYRSVN	parson
PYRT	port
PYRV	pyers
PYRVZ	perez
PYRY	pery
PYRYR	pryor
PYRYZ	perez
PYRZ	perez
PYSAH	paysan
PYSAN	paysan
PYSH	piyush
PYSLY	lyly
PYSNS	dysons
PYS	pas
PYS	pas
PYS	pas
PYSTVN	pistun
PYTAN	paysan
PYTA	patna
PYTH	myth
PYTJ	pyotr
PYTKV	pataky
PYTMN	payton
PYT	pat
PYT	pat
PYT	pat
PYT	pat
PYTR	pyotr
PYTR	pyotr
PYTR	pyotr
PYTRSVN	paterson
PYTRV	petrov
PYTRZ	pyotr
PYTS	pts
PYTYBVN	python
PYVMLY	pygmy
PYVN	ayn
PYVNYK	pivnick
PYV	pym
PYVRYNTN	paynton
PYVTR	pyotr
PYYK	psyko
PYYRY	parry
PYYV	pygmy
PYZA	panza
PYZLY	lyly
PYZS	puzos
PYZVLYTV	pavlov
PYZYALY	piziali
PYZYNY	payne
PYZY	pygmy
PYZYR	pyziur
PZARAYS	zaras
QADSYH	qadisiyah
QALYA	alya
QASAN	hasan
QASM	qasim
QAYD	ayda
QAYS	fays
QBYLH	qubilah
QDAMH	qudamah
QDYLA	dylan
QDYL	adel
QDYM	adam
QDYRA	qadira
QDYR	dayr
QDYSH	andys
QDYSYHA	alyosha
QLYA	alya
QLYBA	alba
QLYB	alya
QLYLA	layla
QML	amal
QMR	mr
QNTVN	anton
QRBYA	arya
QRYBYH	araby
QSAN	san
QSN	qun
QSYM	qasim
QSYM	qasim
QTRAN	tran
QVASYM	qasim
QVBYLH	qubilah
'QYLA	aqila
'QYLA	aqila
'QYL	aqil
'QYL	aqil
QYT	kyte
QYVN	ayn
RABKYN	rabkin
RABLD	rabold
RABL	rabel
RABNAV	grabnar
RABN	raben
RABN	raben
RAB	arab
RABRT	rabat
RABRTSN	rabats
RABRTSVN	robertson
RAB	arab
RABTM	rabat
RABVYL	rabel
RABYDYAKS	abidjans
RABY'H	rabiah
RABYJN	abyan
RABYN	raben
RABYN	raben
RABYNSN	rabins
RABYNSVN	rabins
RABY	raby
RABY	raby
RABYV	raby
RACL	oracle
RAC	ac
RADAK	ladak
RADBRG	rodberg
RADBVD	radboud
RADBVN	radbone
RADHA	radha
RADHYKA	radhika
RADKLYF	bradely
RADK	radek
RADMN	braden
RADNBRC	radenburch
RADNBRGARBRVK	radenburgerabroek
RADNBRGRABRK	radenburgerabroek
RADNBRGRABRVK	radenburgerabroek
RADNBRGRBRVK	radenburgerabroek
RADNYK	radek
RAD	rad
RADRAMVNY	rudramuni
RADRFRD	bradford
RADR	rader
RADR	rader
RADT	brandt
RADVA	radha
RADVF	radev
RADVLFS	adolfs
RADVLFVS	adolfos
RADV	radev
RADVYG	radig
RADYAH	radeyah
RADYH	radeyah
RADYNG	radig
RADY	brady
RAFALKV	rafalko
RAFAL	rafal
RAFALSKY	rafalski
RAFA	rafa
RAFAYL	rafael
RAFAYLY	rafael
RAFNR	fafnir
RAF	graf
RAFRTY	rafferty
RAFYKYV	rayya
RAFYL	rafal
RAFYN	raffin
RAFY	raby
RAGATZ	ragatz
RAGLND	ragland
RAGL	ragle
RAGNAR	ragnar
RAGNARSVN	ragnarsson
RAGNRD	fragonard
RAGNVALD	ragnvald
RAGRV	agra
RAGSDYL	ragsdale
RAHARJV	rahardjo
RAHBK	dahuk
RAHRR	rather
RAHRYG	cathryn
RAHVL	rahul
RAHY	raby
RAJCR	rajcher
RAJNDR	rajender
RAJN	radjen
RAJ	raj
RAJR	raj
RAJRZ	marz
RAJS	rajas
RAJV	raj
RAJYV	rajeev
RAKAH	barakah
RAKL	akl
RAKL	akl
RAK	bak
RAKVN	rabkin
RAKV	brake
RAKYKVT	prakrit
RALF	ralf
RALF	ralf
RALF	ralf
RAMA	rama
RAMBL	rambo
RAMBV	rambo
RAMPLZ	ramez
RAM	ram
RAM	ram
RAMR	ramer
RAMS	ramas
RAMSY	ramsay
RAMSYR	ramsay
RAMTAN	ramadan
RAMVLVS	pavlovs
RAMVS	ramas
RAMY	reamy
RAMYRV	ramer
RAMZ	ramez
RANA	rana
RANDL	randal
RANDR	rander
RANGL	range
RANKYN	rankin
RANN	erann
RAN	bran
RAN	bran
RAN	bran
RANR	ragnar
RANTGN	rontgen
RANY	randy
RANY	randy
RANY	randy
RANYV	pranav
RAPBRYK	bradbury
RAP	gap
RAPR	apr
RARK	ark
RASA	rasha
RASCN	krasen
RASDAL	ragsdale
RASD	prasad
RASFVRD	ashford
RASKH	rasha
RASK	ask
RASKYN	raskin
RASL	rasul
RASL	rasul
RASMN	krasen
RASNDAL	randal
RASNDYL	randal
RASNMAN	rosenman
RASPYNY	aspen
RAS	ras
RAS	ras
RAS	ras
RAS	ras
RASTN	rastin
RASTRAM	tristram
RAST	east
RASTYN	rastin
RASTY	grasty
RASVM	asim
RASV	ras
RASV	ras
RASV	ras
RASYD	prasad
RATCSVN	ratcheson
RATGRT	rutgert
RATJRT	rajat
RATKS	rutks
RATMN	dratman
RATRA	batra
RAT	rat
RATRFVRD	waterford
RAT	rat
RATSTRVM	ruthstrom
RAVBATM	rabat
RAVDAH	raidah
RAVDA	pravda
RAVDA	pravda
RAVLND	ragland
RAVLT	raoult
RAVNR	ragnar
RAV	ravi
RAV	ravi
RAV	ravi
RAVRDY	raverdy
RAV	ravi
RAVRT	ararat
RAVS	avs
RAVT	rat
RAVYAH	radeyah
RAVYH	ravey
RAVYNDRAN	ravindran
RAVYRAJ	raviraj
RAVY	ravey
RAVY	ravey
RAYBLT	rybolt
RAYDAH	raidah
RAYDJ	ayda
RAYDL	randal
RAYDN	haydn
RAYFL	rafal
RAYLH	rayle
RAYLY	bayly
RAYMVND	raymond
RAYNR	rayner
RAYP	ray
RAY	ray
RAYSL	brays
RAYS	brays
RAYSTLYN	raistlin
RAYT	rat
RAYTZ	ragatz
RAYVARD	bayard
RAYVLYNGZ	ayling
RAYV	ray
RAYVTYALA	rautiala
RAYZL	raizel
RAZDAN	razdan
RAZN	rain
RAZVRBK	razorback
RBHVLZ	rebholz
RBRTSVN	robertson
RBVK	rubik
RBVSV	rbs
RBYAH	rabiah
RBYH	raby
'RBYL	arbil
RBYS	rubys
RDAH	raidah
RDA	reda
RDBVN	raben
RDFYLD	redfield
RDLFVS	rodolfos
RDLVS	redlus
RDMN	redman
RDMYL	redmill
RDRYK	fredrik
RDVA	reva
RDVLF	rudolf
RDVNDV	redondo
RDYDH	riyadh
RDYH	radeyah
RDY	rudy
RFA	rafa
RFSNS	refsnes
RFSVN	refson
RF'T	rafat
RGD	gd
RGV	rev
RHLYNG	rehling
RHNY	rony
RHYMAH	rahimah
RHYMH	rahimah
RHYM	rahim
RJAS	rajas
RJAT	rajat
RJ	raj
RKAH	barkah
RKDAL	randal
RKKAH	mekkah
RKSTN	reksten
RKVG	ravi
RLF	ralf
RLYVS	orlys
RLYVZ	allyz
RMD	md
RMFR	ramer
RMLYNGR	remlinger
RMNCYK	franck
RMN	mn
RMNS	mns
RMPLYNG	rampling
RMVNY	romany
RMY	remy
RNALDZ	renalds
RNALT	renault
R'NA	rana
RNA	erna
RNAVD	renaud
RNBART	anbar
RNDHL	randhol
RNDR	andr
RNDY	randy
RNJ	raj
RNVYS	randys
RN	rn
RNY	rony
RNZLND	renzland
RNZ	franz
RPLAGL	replogle
RPRT	rupert
RPTVN	repton
RQAH	raqqah
RQA	ra
RQD	rad
'RRYFA	arrifa
RSA	rosa
RSL	rasul
RSL	rasul
RSNYK	resnick
RST	rest
RSVL	rasul
RSVLVYRT	resolveert
RSVNAT	resonate
RSVNDL	randal
RSYDA	ayda
RSYDH	riyadh
RSYD	riyad
RSYNH	forsyth
RSYNJH	resyntje
RSYNTH	forsyth
RSYNTJ	resyntje
RSYVYN	rosalyn
RTKLYF	brooklyn
RT	art
RVAN	evan
RVATR	aviator
RVAY	ray
RVAYZ	ray
RVAZNR	frazer
RVBRJ	raviraj
RVBR	ribar
RVBRTA	roberta
RVBRT	robert
RVBRTSVN	robertson
RVBRTV	robert
RVBVZ	roboz
RVBYN	robyn
RVBYNSVN	robinson
RVBYNZ	robyn
RVBY	raby
RVBY	raby
RVC	eric
RVC	eric
RVDA	pravda
RVDH	radha
RVDLV	radev
RVDNBRG	rodberg
RVD	rad
RVD	rad
RVDRYGV	rodrigo
RVDRYGZ	rodrigo
RVDVLFAS	rodolfos
RVDVLF	rudolf
RVDVLFVS	rodolfos
RVGALSKY	rogalsky
RVGVZA	rogoza
RVHAN	rehan
RVHL	brohl
RVHM	rohm
RVHN	rohn
RVHRR	rohrer
RVHR	ruhr
RVJAS	rajas
RVKAN	rukan
RVKA	erika
RVKN	irvin
RVKRY	avery
RVKSAN	roxsan
RVKSAN	roxsan
RVKV	lvov
RVKYKY	ricky
RVKZ	ritz
RVLAND	roland
RVLDAN	roldan
RVLFH	ralf
RVLF	ralf
RVLF	ralf
RVLND	roland
RVLS	orvals
RVLV	arvola
RVLY	orly
RVMFVRT	roumfort
RVMRV	marv
RVMYG	remy
RVMYV	remy
RVNALD	ronald
RVNDA	ronda
RVNDH	rand
RVNDL	randal
RVNDYN	randy
RVNGV	irving
RVNTRY	coventry
RVNY	rony
RVNY	rony
RVNYT	ronit
RVPKH	ralph
RVPRT	rupert
RVP	rep
RVRKH	barkah
RV	rev
RV	rev
RVR	river
RV	rev
RVRY	rory
RVRYS	rorys
RVSALYN	rosalyn
RVSAM	rosham
RVSAM	rosham
RVSANA	rosana
RVSA	rosa
RVSKV	rusk
RVSL	orval
RVSLYN	roslyn
RVSLYN	roslyn
RVSNAL	crystal
RVSNBLAT	rosenblatt
RVSNDAL	randal
RVSNDL	fresnel
RVSNFLD	rosenfeld
RVSN	arvesen
RVSNR	krasner
RVS	avs
RVS	avs
RVS	avs
RVSR	river
RVSTAD	rostad
RVSTND	rostand
RVSVLT	roosevelt
RVSVN	arvesen
RVSV	avs
RVSV	avs
RVSYALA	ayala
RVSYTR	forsyth
RVTABAGA	rutabaga
RVTGR	rutgers
RVTGRT	rutgert
RVTJ	raj
RVTJY	bruty
RVTRFRD	rutherford
RVT	rat
RVT	rat
RVT	rat
RVT	rat
RVT	rat
RVT	rat
RVT	rat
RVTS	arts
RVTZ	ritz
RVVLVRY	calvary
RVVTH	horvath
RVVT	horvat
RVVT	horvat
RVYAH	riyadh
RVYAL	royal
RVYAPA	royappa
RVYBL	royal
RVYDN	reyden
RVYH	ivy
RVYL	orval
RVYLY	bayly
RVYMATA	roimata
RVYN	bruyn
RVYN	bruyn
RVYPK	riopka
RVY	ivy
RVYS	roys
RVYS	roys
RVYS	roys
RVYTNBRG	roytenberg
RVYYZ	rayya
RVYZ	ivy
RVZMARY	rosemary
RVZMARY	rosemary
RVZNDAL	randal
RVZNFLDR	rosenfelder
RVZNJK	vonk
RVZN	irvin
RVZ	ariz
RVZ	ariz
RVZ	ariz
RVZVLT	raoult
RVZY	ravey
RVZYR	frazer
RVZYR	frazer
RVZYTA	avesta
RYAD	riyad
RYBAK	reback
RYBAR	ribar
RYBK	rubik
RYB	rb
RYBRN	rayburn
RYCARD	ricardo
RYCARDSN	richardson
RYCARDSVN	richardson
RYCAR	richar
RYCAV	rysavy
RYCMN	rymon
RYCMYR	richmeyer
RYC	bryce
RYCR	bryce
RYCY	bryce
RYCY	bryce
RYDA	ayda
RYDA	ayda
RYDA	ayda
RYDH	riyadh
RYDH	riyadh
RYDJ	bryde
RYDKVYST	rydquist
RYDL	bryde
RYDNBRC	radenburch
RYDNBRGYRBRAK	radenburgerabroek
RYDN	ryden
RYD	bryde
RYDR	ryder
RYDYG	radig
RYDY	rudy
RYFKAYND	rifkind
RYGAN	ragan
RYGARD	regard
RYGLR	rigler
RYG	reg
RYGV	bryguy
RYGYNZ	bryguy
RYHANA	rihana
RYHANH	rehan
RYHL	brohl
RYJKARD	rijkaard
RYJ	raj
RYJSVYJK	rijswijk
RYJSVYK	rysavy
RYJYNZ	marylynn
RYKARD	rickard
RYKARD	rickard
RYKR	pryor
RYKRT	prakrit
RYKSVN	bryson
RYKTZ	reetz
RYKVLSVN	revlon
RYKY	ryukyu
RYLND	rydland
RYL	beryl
RYLSBK	railsback
RYLY	lyly
RYMANT	bryant
RYMND	raymond
RYMNZ	rymon
RYM	pym
RYMRS	pryors
RYMVND	raymond
RYMVND	raymond
RYMVND	raymond
RYMVN	rymon
RYMYL	rymill
RYMY	remy
RYNAH	arunah
RYNALDA	reenalda
RYNALD	reynaldo
RYNALDS	renalds
RYNALDZ	reynaldo
RYNDNR	rindner
RYNDRT	rynders
RYNDRZ	rynders
RYNG	drying
RYNGST	ringuest
RYNGVVD	ringwood
RYNH	bryn
RYNKR	bryner
RYNLDA	lynda
RYN	bryn
RYN	bryn
RYNR	bryner
RYNR	bryner
RYNRT	bryant
RYNTVL	crystal
RYNVD	rand
RYNVLDA	reenalda
RYNVLD	ragnvald
RYNVLD	ragnvald
RYNVLDS	reynolds
RYNVLDSVN	reynoldson
RYNVLDZ	reynaldo
RYNVVD	ragnvald
RYPL	royal
RY	fry
RYRDAN	gordan
RYRDAN	gordan
RYRDN	ryden
RY	fry
RYRSVN	bryson
RYRZ	byra
RYSAH	rishah
RYSALVYRT	rysavy
RYSAR	rysavy
RYSAVY	rysavy
RYSJY	rysavy
RYSKAR	baskar
RYSLVRT	resolveert
RYSLYNG	rysling
RYSLY	risley
RYSNR	bryner
RYSNR	bryner
RYSNYK	bryony
RYSRC	bryson
RYS	roys
RYS	roys
RYS	roys
RYS	roys
RYS	roys
RYSR	pryor
RYSR	pryor
RYSTV	rostov
RYSTYNTJY	resyntje
RYSTY	rusty
RYSVLVRT	resolveert
RYSVLVVRT	resolveert
RYSVR	rysavy
RYSVYK	rysavy
RYSY	rysavy
RYTAKV	rysavy
RYTA	rita
RYTCY	rotch
RYT	rat
RYTSGRT	ritsgert
RYTVGR	hrothgar
RYTYSGRT	ritsgert
RYTZGRT	ritsgert
RYTZ	ritz
RYTZR	retzer
RYVARD	rivard
RYVBR	river
RYVDT	ruudt
RYVMLR	rymill
RYVNSVN	grinsven
RYVNVLD	ragnvald
RYVPKA	riopka
RYVR	pryor
RYV	rev
RYVRZ	pryor
RYVV	ravi
RYVYRH	revere
RYVYS	levys
RYYAD	riyad
RYYD	rayya
RYYNKS	reynas
RYYR	pryor
RYZ	rya
RYZR	pryor
RYZVLVRT	resolveert
RYZV	rizvi
RYZVY	rysavy
RZBRY	raby
RZNBAVM	rosenbaum
RZNFLD	ronald
RZNKRANS	rosencrans
RZNLF	ralf
RZNMN	rinn
RZNTJY	tryntje
RZVLVRT	calvert
RZYNT	bryant
SAARTJ	saartje
SABGLASYAL	subglacial
SABHANY	abhay
SABLT	sabot
SABRAMANYAM	subramaniam
SABRAMANYAN	subramanian
SAB	saab
SABTNS	sabinas
SABT	sabot
SABVRYN	sabourin
SABVS	saabs
SABYN	sabin
SABYNY	sabin
SACAT	sadat
SACK	sacks
SACR	saar
SADGRV	sadgrove
SADHA	shadha
SADLR	sadler
SADRBLAM	soderblom
SADYAH	sadah
SADYH	sadah
SADYK	sandy
SADYKV	sandy
SADYKVYH	sadah
SADYKYV	ladasky
SADYVP	sandy
SAFR	saar
SAF	sal
SAFT	sat
SAFTVR	salter
SAFTYN	martyn
SAGARS	sagans
SAGA	sagan
SAGAYY	sagady
SAGN	sagan
SAGRV	sadgrove
SAGRV	sadgrove
SAHASY	sahasi
SAH	sahr
SAHVLM	sahel
SAJN	san
SAJRV	harv
SAKAMVTV	sakamoto
SAKARY	sakari
SAKAYV	bakaya
SAKLAD	saklad
SAKLA	saklad
SAKSNA	sakinah
SAKSNM	isakson
SAKS	saks
SAKS	saks
SAKSVN	isakson
SAKSYM	saks
SAKTN	sackton
SAKT	saki
SAKYA	shakya
SAKY	laky
SALGA	salma
SALGVRV	alger
SALKRAS	sankaras
SALK	salk
SALMVND	salmond
SALMY	saley
SALTZMN	saltzman
SALTZ	salste
SALVMN	salsman
SALVM	salem
SALVMVN	salsman
SALYAN	kalyan
SALYGRAM	shaligram
SALYN	rosalyn
SALY	saley
SALYT	salyut
SALYVAN	galvan
SALZBRG	salzberg
SALZNBRG	salzenberg
SAMADAR	samaddar
SAMAH	samah
SAMAKR	samar
SAMAN	samman
SAMANTA	samantha
SAMANTA	samantha
SAMAR	samar
SAMAS	asamas
SAMBAT	shambat
SAMBVLYK	sambolec
SAMGYN	sagan
SAMH	samah
SAMK	salk
SAML	samel
SAMN	sam
SAMRAL	amaral
SAMR	samar
SAMR	samar
SAMRZ	samar
SAM	sam
SAMS	sams
SAMTYNG	samsung
SAMVLS	samuels
SAMVN	samman
SAMVSKY	samosky
SAMVYL	samel
SAMYR	samar
SAMYT	amyot
SAMYT	amyot
SAMZ	sam
SANAHAN	shanahan
SANANDV	anand
SANA	sana
SANBRN	sansburn
SANCTY	dancy
SANDAR	mandar
SANDHV	sandhu
SANDLYN	sandlin
SANDMAN	sandman
SANDRAM	sandra
SANDRM	sandra
SANDRNZ	sandra
SANDRS	sanders
SANDRSVN	sanderson
SANDRZ	sandra
SANDRZ	sandra
SAND	sand
SANDYP	sandy
SANDY	sandy
SANGLD	sangal
SANG	sang
SANG	sang
SANGV	sang
SANJAY	sanjay
SANJH	sancho
SANJSTR	sangster
SANKAR	sankara
SANKN	sanka
SANKR	sakr
SANKR	sakr
SANK	sanka
SANK	sanka
SANLA	sana
SANLY	sally
SANNAR	sanner
SANRANG	sansing
SANRAYZ	sanjay
SANRJH	santje
SANRTH	barth
SANRTJY	saartje
SANRT	saint
SANSAYN	kansan
SANSBRN	sansburn
SAN	san
SAN	san
SANSS	sanas
SANST	saint
SANSVN	sansing
SANTANA	santana
SANTA	santa
SANTH	santa
SANTJ	santje
SANTJY	santje
SANTRTJ	sannertje
SANT	saint
SANTSBRN	sansburn
SANTV	sanov
SANTVS	santos
SANTVSY	santos
SANTYK	sandy
SANTY	sandy
SANVNDV	anand
SANVN	sanov
SANV	sanov
SANYL	sandy
SANY	sandy
SANY	sandy
SANYT	saint
SANZBVRN	sansburn
SANZ	sanz
SAPRV	apr
SAP	gap
SARANN	saranen
SARA	sara
SARATY	sarathy
SARDGNA	sardegna
SARDLV	sardar
SARDV	sardo
SARJH	sarah
SARKNAS	sharknas
SARLVT	arlet
SARLY	carly
SARMA	sarma
SARNA	sarna
SAR	saar
SAR	saar
SARTAKSV	sarawaks
SARTH	barth
SARTJ	saartje
SARTJY	saartje
SART	sarto
SART	sarto
SARTZR	shartzer
SARVATH	sarathy
SARVK	shark
SARY	cary
SARYVL	daryl
SASAKY	kasaty
SASAN	sawsan
SASKA	laska
SASLAV	saslav
SASMN	salsman
SASNHYM	sassenheim
SASN	samson
SASTK	astik
SASTYK	astik
SASZH	sasze
SASZ	sasze
SASZY	sasze
SATFN	satan
SATFYN	satan
SATJ	santje
SATKAS	sankas
SATN	satan
SATR	satur
SATR	satur
SAT	sat
SAT	sat
SATVN	satan
SATVN	satan
SATVR	satur
SATV	sat
SAVAN	kesavan
SAVARAM	savaram
SAVARS	samars
SAVCVK	sacks
SAVDY	sandy
SAVFRD	sanford
SAVL	savel
SAVL	savel
SAVL	savel
SAVLZ	savel
SAVNDRZ	sandra
SAVSAN	sawsan
SAV	slav
SAVTR	salter
SAVTR	salter
SAVTZ	savetz
SAVVY	savoy
SAVYN	savin
SAVYR	savior
SAYBRMYJ	sprayberry
SAYBRT	sabot
SAYDA	ayda
SAYKS	sacks
SAYKV	sacks
SAYLR	sayer
SAYMKV	ayman
SAYM	sam
SAYMVN	ayman
SAYMVNS	caymans
SAYP	saiph
SAYRY	sayre
SAYTJ	santje
SAYT	salyut
SAYTV	saito
SAYTZ	savetz
SAYVRYNGLNT	sargent
SAYVYRDYNGLANT	siuuirdingelant
SAYVYR	sayer
SAZH	sachs
SBASTYN	sebastian
SBASTYN	sebastian
SBAYN	ayn
SBHAN	sobhan
SBRA	sabra
SBRT	osbert
SBRYANY	bryan
SBRY	abery
SBS	sbs
SBYRAH	sabirah
SBYRA	byra
SBYRH	byra
SBYSTN	sabiston
SBYT	sabot
SDAH	sadah
SDAH	sadah
SDA	seda
SDAY	day
SDGRV	sadgrove
SDHA	shadha
SDH	sadah
SDLR	sadler
SDRHLM	cederholm
SDRVV	sadgrove
SD	sed
SDS	seds
SDVAL	sedvall
SDVR	sadr
SDV	dov
SDYA	diya
SDYH	sadah
SDYK	slyke
SDYRA	sadira
SFARD	asgard
SFRD	ashford
SF	asif
SFYLD	sold
SGAL	segal
SGVRA	segura
SHA	shan
SHRAB	sohrab
SHR	sahr
SH	seh
SHYB	shub
SKANL	kanal
SKARP	karp
SKAR	sekar
SKLANY	saklani
SKMAN	akman
SKRNTN	scranton
SKSNM	skene
SKSPYR	skippy
SKSTN	isakson
SKSTVN	kosten
SKT	sat
SKVYRA	skaya
SKYVRYTY	karty
SLAMKY	slumkey
SLAMN	slan
SLAR	solar
SLARYR	slater
SLAT	slate
SLAY	clay
SLAYZ	allyz
SLBRG	selberg
SLBRG	selberg
SLDN	slan
SLDVN	slavin
SLF	alf
SLFY	sly
SLJ	sly
SLJ	sly
SLK	salk
SLMA	salma
SLMA	salma
SLMYDY	slumkey
SLMY	sly
SLNY	slaney
SLR	esler
SL	sal
SL	sal
SLT	slut
SLTH	seth
SLTJH	seth
SLTVN	salton
SLVA	silva
SLVD	blvd
SLVDVF	blvd
SLVN	slan
SLVN	slan
SLVVD	blvd
SLYJ	sly
SLYMANYH	sulaymaniyah
SLYMA	sloma
SLYMH	blyth
SLYM	slim
SLYM	slim
SLYNA	lynda
SLYPRY	slippery
SLY	sly
SLYTR	slater
SLYV	slav
SMAH	samah
SMAL	small
SMALYAH	shamaliyah
SMALYH	shamaliyah
'SMAN	isman
SMAR	samar
SMAR	samar
SMA	asma
SMA	asma
SMAT	smart
SMBHV	shambhu
SMBLNKS	banks
SMH	samah
SMKVVN	skaven
SMLY	sly
SMMA	samma
SMMR	sammer
SMPL	sample
SMPT	sept
SMRN	amran
SMR	mr
SMR	mr
SM	sm
SMSC	sms
SMSL	samsel
SMVTYVK	semotiuk
SMYAH	samiyah
SMYH	smythe
SMYLH	smyley
SMYM	syme
SMYRAH	samirah
SMYRA	myra
SMYRA	myra
SMYRH	smythe
SMYR	emyr
SMYR	emyr
SMYR	emyr
SMYS	amys
SMYTLY	smitley
SMYZ	semiz
SNAN	sinan
SNA	sana
SNA	sana
SNA	sana
SNDBRG	sandberg
SNDFVRD	sandford
SNDHYL	sendhil
SNDLYN	sandlin
SNDMN	sandman
SNDRS	sadrs
SNDRZ	sandra
SND	sand
SNDS	sands
SNDVYK	sandvik
SNDY	sandy
SNDZ	sand
SNFNG	shenfeng
SNFTLYBN	senftleben
SNGAL	sangal
SNGLVGLV	cengeloglu
SNG	sang
SNG	sang
SNG	sang
SNGVPTA	sengupta
SNGVTA	sengupta
SNHAL	snehal
SNJH	singh
SNKYAT	shenkiat
SNNRTJ	sannertje
SNNY	sonny
SNQAN	sinan
SNR	sir
SNSBRN	sansburn
SN	sn
SNTJ	santje
SNT	saint
SNTYAGV	santiago
SNVRY	convery
SNVTV	sanov
SNYRJH	north
SPARD	shepard
SPARNDAM	spaarndam
SPASTYN	spartan
SPHR	sphar
SPRD	sardo
SPRYNGR	springer
SP	sup
SPYNVAL	sandoval
SPY	sepoy
SRAB	sarab
SRAFYN	serafin
SRASVL	rasul
SRATVZA	bratina
SRAYNH	branch
SRCAK	sercan
SRDAR	sardar
SRHYR	serhir
SRJH	sarah
SRKAMB	kamb
SRKAN	horkan
SRK	ark
SRKS	saks
SRKYAH	barkah
SRKYH	sikh
SRLD	sold
SRL	sal
SRLYNG	serling
SRLY	orly
SRMAN	seman
SRMN	saran
SRPNT	serpent
SRQYH	sharqiyah
SRR	orr
SRR	orr
SR	sr
SR	sr
SR	sr
SRSTA	krista
'SRT	israt
SRTRYD	strydom
SRVADY	brady
SRVARY	bovary
SRVMBC	crumbach
SRVVD	pravda
SRVYC	survey
SRVYDYV	servadei
SRVYS	servis
SRVY	survey
SRYA	surya
SRYF	surya
SRYF	surya
SRYNGTVN	symington
SRY	fry
SRY	fry
SRY	fry
SRYT	israt
SRYVR	pryor
SSADRY	badry
SSANY	swany
SSDRY	badry
SSYL	sibyl
STARLVZN	stalin
STFANVS	stefans
STHVRAJAN	sethurajan
STLAYN	slan
STLND	eastland
STLR	star
STL	sal
STMF	stampf
STNT	saint
STRATVN	straton
STRYTR	strayer
ST	st
STVFL	savel
STVRAMAN	sethuraman
STV	st
STYVNSVN	stevenson
SVAFVRD	safavid
SVAGATV	swagato
SVAMY	swamy
SVAMY	swamy
SVANK	shank
SVAN	sivan
SVAN	sivan
SVANYK	sevanick
SVANY	swany
SVARMN	saran
SVART	smart
SVARYNGYN	swearingin
SVAS	sivas
SVA	siva
SVAYDA	suwayda
SVBHANDV	sobhan
SVBVTKA	sobotka
SVCAN	sercan
SVDAN	sudan
SVDAN	sudan
SVDARMV	sudarmo
SVDARSAN	sudarshan
SVDR	sadr
SVDYP	sudip
SVDYPTV	sudipto
SVDYR	sadr
SVDZ	lodz
SVFN	sven
SVFR	fr
SVFYH	savoy
SVFYLD	alfeld
SVFY	savoy
SVGN	sven
SVGRLF	sugarloaf
SVG	sage
SVHA	soha
SVHAS	suhas
SVHA	soha
SVHM	sohm
SVKK	saki
SVKLA	saklad
SVKVL	sokol
SVKVMAR	sukumar
SVLAR	solar
SVLAYMNYAH	sulaymaniyah
SVLDR	osvaldo
SVLD	sold
SVLFVR	silver
SVLK	salk
SVL	sal
SVL	sal
SVLTAN	sultan
SVLT	iselt
SVLTZ	savetz
SVLVMVN	salsman
SVLV	silva
SVLVVY	silvey
SVLVYR	silver
SVLVY	silvey
SVLY	sly
SVLYS	sallys
SVLYTAS	salyuts
SVMA	soma
SVMASYKAR	somashekar
SVMJY	sammy
SVMN	sven
SVMR	samar
SVMRVYL	sheryl
SVMVY	somvay
SVMYKR	emyr
SVNAR	sundar
SVNA	sana
SVNDARAM	sundaram
SVNDRZ	sandra
SVNGKRN	songkran
SVNGR	sanger
SVNGRVALA	songerwala
SVNG	sang
SVNJA	sonja
SVN	sven
SVN	sven
SVN	sven
SVNSN	svens
SVN	sven
SVNY	sony
SVNY	sony
SVPN	sven
SVPRATYK	supratic
SVPRYV	supriyo
SVP	sup
SVRAB	sarab
SVRAB	sarab
SVRAJ	suraj
SVRANA	surana
SVRK	shark
SVRL	savel
SVRNSN	sorensen
SVRN	severn
SVR	sir
SVR	sir
SVRS	srs
SVRSVN	severson
SVRTL	sarto
SVRTN	saran
SVRVALY	sorvali
SVRYNDR	surinder
SVRYN	shryne
SVSAL	missal
SVSA	sosa
SV	av
SVSH	sasha
SV	av
SVSN	sven
SV	av
SV	av
SV	av
SVSYA	sasha
SVSYL	sibyl
SVTAN	satan
SVTFN	satan
SVTN	sven
SVTR	satur
SVTR	satur
SVTS	sats
SVTV	lvov
SVYAK	soyack
SVYDA	ayda
SVYDH	riyadh
SVYFT	seyfert
SVYLR	sayer
SVYLR	sayer
SVYNGLR	spangler
SVYNRTVN	paynton
SVYN	sven
SVYN	sven
SVYR	sayer
SVYTNKY	switenky
SVYTV	savetz
SVYYNK	soyinka
SVZALYS	sallys
SVZANA	azana
SVZANH	savannah
SVZA	siva
SVZ	sanz
SVZV	lvov
SVZY	suzy
SYANDRA	sandra
SYANG	sang
SYANG	sang
SYANV	sanov
SYBACR	bacar
SYBL	sybil
SYBL	sybil
SYBLT	rybolt
SYBLY	sibley
SYBRT	osbert
SYDA	ayda
S'YDH	riyadh
SYDLR	sadler
SYDLR	sadler
SYDMN	lymn
SYDNY	sydney
SYDR	sadr
S'YD	boyd
SYD	sed
SYD	sed
SYDVR	snyder
S'YDY	sandy
SYFARD	seward
SYGL	segal
SYGL	segal
SYGLTVN	sylvan
SYGMN	sigman
SYGMN	sigman
SYGMN	sigman
SYGMVND	sigmund
SYG	synge
SYGS	sangs
SYHAN	shan
SYHN	schon
SYHSVBHVN	sihsobhon
SYHY	lyly
SYJH	sytje
SYJKV	psyko
SYJMN	sijmen
SYKAGV	ashikaga
SYKAR	sekar
SYKARV	sakari
SYKR	sakr
SYK	psyko
SYKVLV	sokol
SYKVRA	sekora
SYKY	sky
SYLA	scylla
SYLBRMAN	silberman
SYLBRMN	silberman
SYLDN	sylvan
SYLDZ	sold
SYLK	salk
SYL	sal
SYLVAN	sylvan
SYLVA	sylvan
SYLVD	sylvan
SYLVNN	sylvan
SYLVRBRG	silverberg
SYLVRMN	silverman
SYLVR	silver
SYLVRTVRN	silverthorne
SYLVRVD	sylvan
SYLV	sylvan
SYLVVD	sylvan
SYLVYA	sylvia
SYLVYA	sylvia
SYLVY	silvey
SYLVYV	sylvan
SYLYG	lyly
SYLYMAN	lyman
SYLYMN	lymn
SYLY	lyly
SYLY	lyly
SYLYT	salyut
SYLZMN	saltzman
SYLZ	soyuz
SYLZ	soyuz
SYMAL	small
SYMARD	simard
SYMAYH	samah
SYMBAB	siembab
SYMLR	simler
SYMNDS	simonds
SYMN	lymn
SYMN	lymn
SYMN	lymn
SYMN	lymn
SYMN	lymn
SYMNZ	lymn
SYMPLYSYTY	simplicity
SYMR	syme
SYMR	syme
SYMS	sams
SYMS	sams
SYMSYK	gypsy
SYMVDYNZ	simodynes
SYMVNA	simona
SYMVNDS	simonds
SYMVNH	sumanth
SYMVNH	sumanth
SYMVN	sylvan
SYMVN	sylvan
SYMVNSN	simonson
SYMVNS	hymens
SYMVNZ	sylvan
SYMVNZ	sylvan
SYMYNG	siming
SYMYNGTVN	symington
SYMYN	ayman
SYMYN	ayman
SYMZ	syme
SYMZ	syme
SYNA	dyna
SYNAN	sinan
SYNA	dyna
SYNAYN	sinan
SYNDLMN	sandlin
SYNDRH	sandra
SYNGLTVN	singleton
SYNG	synge
SYNK	sunk
SYNKLARY	sankara
SYNKLAYR	sinclair
SYNKLR	sunker
SYNK	sunk
SYNR	sync
SYN	sync
SYN	sync
SYN	sync
SYN	sync
SYN	sync
SYN	sync
SYN	sync
SYNTYA	santa
SYNV	sync
SYNVY	sydney
SYNYBALDY	sinibaldi
SYNYG	synge
SYNY	sony
SYPL	skype
SYPLVAYDN	sylvan
SYPLVYDN	sylvan
SYPLZ	sample
SYPMN	lymn
SYPN	skype
SYPRYANV	cyprian
SYP	skype
SYRAFYN	serafin
SYRAN	syrian
SYRANT	sierant
SYRA	syria
SYRAY	stray
SYRCNT	sprint
SYR	cyr
SYRKVYS	starkeys
SYRL	cyril
SYRLY	carly
SYRR	sayer
SYR	cyr
SYR	cyr
SYR	cyr
SYRS	sayers
SYRS	sayers
SYRVKA	sylvia
SYRVN	styron
SYRVS	servis
SYRVYZ	survey
SYRYF	surya
SYRYL	sheryl
SYRYLV	sheryl
SYRYNG	shryne
SYSABA	csaba
SY	sky
SY	sky
SY	sky
SY	sky
SYSK	sisk
SYSLVNZ	sylvan
SYSLV	saslav
SYS	sbs
SYSTMZ	systems
SYSZ	sasze
SYTARAM	sitaram
SYTA	sita
SYTAY	stacy
SYTH	myth
SYTH	myth
SYTJ	sytje
SYTJY	sytje
SYTLAYV	saslav
SYTLR	lytle
SYTRAH	sitrah
SYTRA	sitrah
SYTRH	sitrah
SYT	sat
SYT	sat
SYTS	sats
SYTV	sytje
SYTYA	scythia
SYTYH	myth
SYTY	stoy
SYTYZN	styron
SYTZ	seitz
SYTZ	seitz
SYVALD	osvaldo
SYVALV	sedvall
SYVA	siva
SYVAYRDYNGLNT	siuuirdingelant
SYVLA	savela
SYVL	savel
SYVMN	sylvan
SYVNG	synge
SYVNKA	soyinka
SYVN	sylvan
SYVNYS	sydneys
SYVRDYNGLNT	siuuirdingelant
SYVR	sayer
SYV	siva
SYV	siva
SYVSMNZ	salsman
SYVVD	sylvan
SYVYRDYNGLANT	siuuirdingelant
SYVY	savoy
SYVY	savoy
SYYVAYRDYNGLNT	siuuirdingelant
SYYVNYL	sydney
SYZNHYM	sydney
SZARV	sharov
TABVK	tabuk
TABYT	talbot
TAC	taco
TADR	badr
TAD	tad
TAFT	taft
TAFTZ	taft
TAFVN	staffan
TAGLV	tagle
TAHARA	tahara
TAHRYHA	tahara
TAHVN	tahoun
TAJH	ptah
TAKA	taka
TAKMN	akman
TAKR	sakr
TAKSBRY	gatsby
TAKV	tak
TAKY	laky
TALAN	tallan
TALBRG	thalberg
TALBVYZ	talboys
TALKVT	talbot
TALMAYR	thallmayer
TALMN	talman
TALMY	talmy
TALN	stalin
TALNV	kalev
TALS	als
TALVANN	tolvanen
TALYBAH	talibah
TALYS	italys
TAMANA	tammana
TAMARA	tamara
TAMAS	tamas
TAMATYVS	almatys
TAMAY	gamay
TAMBRVS	lambros
TAMB	kamb
TAMPAS	tampas
TAMPKYNZ	tompkins
TAMSN	hamson
TAMSVN	hamson
TAM	tam
TAM	tam
TAM	tam
TAMYNZ	tammuz
TAMY	talmy
TAMZ	tam
TANAK	tanak
TANA	tanak
TANG	tang
TANG	tang
TANJS	tanis
TANKN	rankin
TANN	ann
TANTVN	tanton
TANYS	tanyas
TAPA	tampa
TAPLYN	taplin
TAPR	apr
TAPSYN	calsyn
TAPTANY	taitano
TAPYK	capek
TAPYN	taplin
TAPYV	tanya
TARA	tara
TARDL	tardell
TARKL	stark
TARK	stark
TARML	tamil
TARN	barn
TARQ	tariq
TARS	stars
TARSVN	carson
TAR	star
TARVB	tarub
TARYK	stark
TASDYLR	tasdeler
TASKR	tasker
TATAM	tattam
TATARY	tartary
TATBAY	tatby
TATH	gath
TATJ	taatje
TATL	tat
TATL	tat
TATRVY	tartary
TATSVRV	tatsuro
TAT	tat
TAT	tat
TAT	tat
TATYH	tatby
TATYH	tatby
TATYL	tatby
TATZ	datz
TAVARS	tavares
TAVRNYNY	tavernini
TAVR	tarr
TAV	av
TAYBVT	talbot
TAYJMN	taejon
TAYLBRY	taylor
TAYLMANS	caymans
TAYLMNZ	talman
TAYLR	taylor
TAYLV	taylor
TAYMN	ayman
TAYNVR	traynor
TAYRAY	airay
TAYR	dayr
TAYRVN	bayern
TAYRY	badry
TAYSN	ayson
TAYSVN	ayson
TAY	tay
TAYT	taft
TAY	tay
TAYTY	tatby
TAYV	tay
TBT	tat
TBVK	tabuk
TBYB	toby
TBYT	tibet
TDL	tl
TFYLAH	tafilah
TFYLA	bayla
T'FYLH	tafilah
TGLBRG	tegelberg
TGL	tagle
THSYN	tahsin
TH	th
THYRAH	tahirah
THYRA	thara
THYRH	tahirah
TJAJH	thanh
TJATJ	tjaatje
TKS	bks
TK	tak
TK	tak
TK	tak
TKYAH	takiyah
TKYH	takiyah
TLANDR	lander
TLBRT	talbert
TLBVYS	talboys
TLBVYZ	talboys
TLFR	telfer
TLKVM	albom
TLLV	tell
TLNT	tent
TLR	lr
TL	tl
TLYBAH	talibah
TLYBA	alba
TLYBH	blyth
TLYB	talib
TMBRY	amery
TMPLMN	tempelman
TMPLR	templar
TMPLTVN	templeton
TMPST	tempest
TM	tm
TMYR	emyr
TNANT	anant
TNAYA	tenaya
TNBRVK	tenbrook
TNBV	anbu
TNDYRY	tandiary
TNKN	tunen
TNPV	tenpo
TNTS	tants
TNT	tent
TNVR	invar
TNVRYV	convery
TNYKN	anakin
TNYSAN	maysan
TNY	tiny
TPV	tupi
TQYH	tay
TRADA	estrada
TRAFTVN	trafton
TRAFVRD	trafford
TRAH	torah
TRAJKTNSYS	stravinskys
TRAKV	amtrak
TRAN	tran
TRANYTSA	turnitsa
TRAP	trapp
TRAPYN	terrapin
TRASH	trash
TRASTR	traster
TRA	tra
TRAVAJLYA	travaglia
TRAVN	tran
TRAVZY	ravey
TRAYKTNSYS	stravinskys
TRAYNTH	traynor
TRAYNTZ	traynor
TRAYNVR	traynor
TRAYSTNSYS	stravinskys
TRAYSTNYS	tristans
TRAYSY	tracys
TRAZ	taraz
TRBRY	terry
TRD	rd
TRFVRD	orford
TRLD	trudy
TRLDY	trudy
TRL	tl
TRLV	trull
TRMVYL	turmoil
TRMYNAL	terminal
TRNR	turner
TRNSH	trash
TRNS	trans
TRN	tern
TRNTN	trenton
TRNT	trent
TRNYK	ternyck
TRSA	teresa
TRS	ars
TRSTVN	tristan
TRTJY	tartary
TRTJY	tartary
TRTNH	trinh
TRTVAN	provan
TRTVN	triton
TRVB	tarub
TRVBY	trubey
TRVDL	trudel
TRVDSVN	troedson
TRVF	graf
TRVGTVN	trafton
TRVHYKV	teruhiko
TRVKS	travis
TRVL	orval
TRVL	orval
TRVLYNGR	traynor
TRVMBV	trumbo
TRVMYTR	trometer
TRVN	tran
TRVP	trapp
TRVRAYS	murrays
TRVR	trevor
TRVRYK	terry
TRVRYS	rorys
TRV	tra
TRVTR	trevor
TRV	tra
TRVT	tevet
TRVYLYGR	trevelyan
TRVYRYK	tartary
TRVYSDYL	truesdale
TRVYTH	truth
TRVYTJ	tryntje
TRVYT	tevet
TRVYYJH	tryntje
TRYBL	rybolt
TRYBL	rybolt
TRYDVY	trudy
TRYGS	torys
TRYJV	tryntje
TRYK	ternyck
TRYKTNSYS	arkansas
TRYKT	trent
TRYMSTAR	crystal
TRYM	trim
TRYNDAD	trindade
TRYND	strand
TRYNHAM	trainham
TRYNJH	tryntje
TRYNKL	trinkle
TRYNTH	tryntje
TRYNTJ	tryntje
TRYNT	trent
TRYNVR	traynor
TRYPS	torys
TRYQ	tariq
TRYS	torys
TRYSTNSYS	tristans
TRYSTRM	tristram
TRYSY	torys
TRYSY	torys
TRY	tory
TRY	tory
TRY	tory
TRY	tory
TRYTL	tritle
TRYTL	tritle
TRYTVRY	tartary
TRYVLV	travis
TRYVRAYS	murrays
TRYVR	trevor
TRYVYTZ	travolta
TRZH	tirza
TSKR	tasker
TSLA	tesla
TSLR	tesler
TSNR	tener
TSTA	testa
TS	ts
TSTR	tester
TSYMA	asama
TSYNK	tesink
TTJY	tatby
TTRAD	tetrad
TTR	otter
TTRV	tetro
TTRVYN	tetervin
TVAMA	tuama
TVARY	bovary
TVAYCL	vancil
TVB	tb
TVBVTYS	tibets
TVBYAS	libyas
TVBYN	robyn
TVDAR	adar
TVD	tad
TVFRY	avery
TVFTH	taft
TVHLA	avila
TVKR	ivar
TVK	tak
TVKYV	tokyo
TVLANY	tolani
TVLA	tula
TVLAY	clay
TVLDV	pavlov
TVLMN	talman
TVL	tl
TVLYN	evelyn
TVLY	italy
TVLY	italy
TVLY	italy
TVLYVR	helyar
TVLYV	evelyn
TVMANY	tomany
TVMAS	tamas
TVMAS	tamas
TVMATYVS	almatys
TVMBLY	twombly
TVMS	tims
TVM	tam
TVMY	talmy
TVMY	talmy
TVMY	talmy
TVMYTYVS	almatys
TVMZ	tam
TVNAR	tonar
TVNGA	tonga
TVNG	tang
TVNG	tang
TVNG	tang
TVNJS	tonjes
TVNR	tener
TVNS	avins
TVN	tin
TVNYS	tanyas
TVNYS	tanyas
TVNYS	tanyas
TVNY	tiny
TVRAD	tetrad
TVRAMBR	turambar
TVRAYA	tarawa
TVRBR	tarr
TVRDA	torda
TVRKAT	barakat
TVRKV	turk
TVRLDH	thurlede
TVRMALA	tormala
TVRMN	tern
TVRNBRG	tornberg
TVRNLY	thornley
TVRNR	turner
TVRN	tern
TVRN	tern
TVRNTVN	thornton
TVRP	tharp
TVRTL	turtle
TVRTN	turton
TVRTVN	turton
TVRVF	turoff
TVRVP	tharp
TVRYA	arya
TVRYN	bryn
TVRYSN	torys
TVRY	tory
TVRZ	taraz
TVSAR	tushar
TVSKANV	tasman
TVS	avs
TVSV	avs
TVSYNG	tusing
TVSYNK	tesink
TV	av
TV	av
TVTY	tatby
TVVYS	levys
TVYDA	toyoda
TVYDY	teddy
TVYH	ivy
TVYN	kevyn
TVYT	tevet
TVYT	tevet
TVYYDYL	tyndale
TVYYG	tyng
TVYYN	evelyn
TYBAT	bat
TYBL	sybil
TYBVT	tibet
TYCAVR	bacar
TYD	tad
TYF	ty
TYFVRD	tifford
TYGV	tyng
TYHAN	tehan
'TYH	ptah
TYJATH	strath
TYJMN	tijmen
TYLBRY	tilbury
TYLDN	tilden
TYLGNR	tilgner
TYLMANS	tysmans
TYLMNS	tysmans
TYLMNZ	talman
TYLN	dylan
TYLR	tyler
TYLR	tyler
TYLV	tyler
TYLVTSAN	sylvan
TYLYNG	ayling
TYMBVL	timbol
TYMKV	timko
TYMN	tymen
TYMN	tymen
TYM	pym
TYMVNYN	timonin
TYMVR	gymer
TYMYAN	ayman
TYMYNZ	tymen
TYMZ	tymen
TYNANT	tennant
TYNA	dyna
TYNDAL	tyndale
TYNDAL	tyndale
TYNGLY	tingley
TYNG	tyng
TYNG	tyng
TYNSL	tinsel
TYNSLY	tinsley
TYN	tyng
TYN	tyng
TYN	tyng
TYNY	tiny
TYPAL	paypal
TYPV	pype
TYRNY	tyrone
TYRVKS	turks
TYRYH	torah
TYRY	tory
TYRZA	tirza
TYSMNZ	tysmans
TYS	tys
TYSYNJR	tysinger
TYSZA	tisza
TY	ty
TYTAY	tartary
TYTH	myth
TYTMAS	tysmans
TYTS	tets
TYT	tat
TYT	tat
TYTY	tatby
TYVGA	tioga
TYVMYNN	tymen
TYVNA	dyna
TYVNYS	sydneys
TYVNYS	sydneys
TYV	ty
TYYVLN	kayvon
TYZ	ty
VADAPARTY	vadaparty
VADH	madah
VADRY	vandry
VADZN	vaduz
VAFA	afa
VAFYAH	ayah
VAFYA	vaya
VAGL	vail
VAGNR	vagner
VAGNR	vagner
VAGN	vaggen
VAH	mah
VAJDYK	vandyck
VAKFYLD	alfeld
VAKRDAYN	vardan
VAKVRN	akron
VALANS	alans
VALAS	salas
VALDMANYVNA	waldmanneuenna
VALDMNNA	alcmena
VALDMNNYVYNA	waldmanneuenna
VALDMNYVNA	alcmena
VALDRAM	waldram
VALDV	valdez
VALDZ	valdez
VALH	val
VALKA	valkila
VALKNAR	valkenaar
VALMN	avalon
VALNTYJN	valentijn
VALNTYN	valentin
VALN	avalon
VALRYN	allyn
VALTMN	altman
VALTN	alton
VALTR	valur
VALTRZ	valdez
VALTVN	alton
VALT	kalt
VAL	val
VAL	val
VALVM	valium
VALVRT	calvert
VALVR	valur
VALV	val
VALVYN	allyn
VAL	val
VALYHVR	valihora
VALYNGTN	alington
VALYNGTVN	alington
VALYN	allyn
VALYS	vals
VALYS	vals
VALY	daly
VALY	daly
VALY	daly
VALY	daly
VALYY	valley
VALZ	val
VAMBVL	gamble
VANANTVRP	vanantwerp
VANANVRP	vanantwerp
VANATVRP	vanantwerp
VANBRN	vanburen
VANBVRN	vanburen
VANDNBRQ	vandenburgh
VANDN	vanden
VANDRVYR	vanderveer
VANDRVYYR	vanderveer
VANDVSN	vanden
VANDVZN	vanduzen
VANDYK	vandyck
VANDZN	vanden
VANDZVN	vanduzen
VANG	vang
VANK	bank
VANKVRN	vankeuren
VANKVRN	vankeuren
VANSCVNHVN	vanschoonhoven
VANSK	evans
VANSKVNHVN	vanschoonhoven
VANSY	pansy
VAN	van
VANVLK	vanvleck
VANVRANKN	vanvranken
VANVRNKN	vanvranken
VAN	van
VANZANT	vanzandt
VANZNDT	vanzandt
VARBRG	barbra
VARBRTVN	warburton
VARBRVG	barbra
VARBRVQ	barbra
VARBVRVG	aberg
VARBVRV	arber
VARDY	hardy
VARGAS	vargas
VARGV	vargo
VARMA	varma
VARNR	garner
VARNR	garner
VARNS	varnes
VARN	barn
VARN	barn
VARNY	varney
VARTVN	barton
VARTY	varty
VARVL	varvel
VARYANS	aryans
VARYANTS	variants
VARYANTZ	variants
VARYVR	carver
VASALV	vasallo
VASKY	jansky
VASLV	saslav
VASM	asim
VASNGTN	washington
VASNGTVN	washington
VAST	east
VAST	east
VASVN	basin
VAS	avas
VAS	avas
VASYK	ask
VASYM	asim
VASYNGTVN	washington
VASYT	basit
VATANAB	watanabe
VATANYB	watanabe
VATKYNZ	atkins
VATRHAVS	atrias
VATRMN	katrin
VATRSVN	paterson
VATRZ	atri
VATS	ats
VATV	vato
VAT	vato
VAVDRAY	vandry
VAVDRY	vandry
VAYA	vaya
VAYB	vaya
VAYBY	abby
VAYDMN	hayden
VAYD	vaya
VAYGL	vail
VAYLDR	aylor
VAYL	vail
VAYMN	ayman
VAYNGRV	gaynor
VAYNTH	zaynah
VAYN	ayn
VAYPKJ	kayak
VAYSMN	ayson
VAYS	fays
VAYTHAVS	cathays
VAYTHRN	cathryn
VAYTHVRN	catharyn
VAYTHVS	antevs
VAYTVRS	ayers
VAYTYKR	hayter
VAYTYKR	hayter
VAYZAK	ganzak
VAYZ	vaya
VBR	br
VBSTR	buster
VB	b
VCNR	acuner
VDAD	vlad
VDBRG	edberg
VDLMVDY	vadlamudi
VDLYN	evelyn
VDMYR	dayr
VD	ved
VFA	afa
VFYAH	ayah
VFYH	vaya
VFYYH	wafiyyah
VGL	vogl
VGL	vogl
VGNR	vagner
VGNR	vagner
VHRA	vohra
VJDAN	vardan
VJYHA	vaya
VJYHH	ayah
VJYH	vaya
VKKYA	kaya
VKRFAS	vargas
VKRV	harv
VK	vik
VLADAK	vladack
VLADAN	vladan
VLADV	vlad
VLAM	elam
VLAN	alan
VLA	vela
VLA	vela
VLDMN	veldman
VLDMNVNA	ladonna
VLDMN	veldman
VLDN	velden
VLD	veld
VLFSVN	olafson
VLKMAN	volkman
VLK	volk
VLK	volk
VLMJH	almach
VLMN	elman
VLMTH	blyth
VLMTJ	almaty
VLMT	klimt
VLNTA	vinata
VLNTYJN	valentijn
VLNTYN	valentin
VLR	lr
VLSKY	polsky
VLS	vals
VLSY	vals
VLTMR	voltmer
VLTR	valur
VLTRYNG	strong
VLTRY	flory
VLTY	kelty
VLVDYN	vladan
VLVSV	lvov
VLYDH	blyth
VLYNGTVN	alington
VLYNK	blank
VLYS	eloys
VLYS	eloys
VLZL	vall
VLZ	volz
VLZ	volz
VNABLS	venables
VNANTVRP	vanantwerp
VNASCVNVN	anacin
VNBRN	vanburen
VNBVRN	vanburen
VNCVNHVVN	vanschoonhoven
VNC	inc
VNDAZN	vanduzen
VNDLND	wendland
VNDL	vandal
VNDL	vandal
VNDMN	vandeman
VNDRFVRD	vanderford
VNDRVR	vanderveer
VNDRVYR	vanderveer
VNDRY	vandry
VNDVSN	vanden
VNDVVSN	vandousen
VNDVZN	vanduzen
VNDVZN	vanduzen
VND	and
VNDYK	vandyck
VNDZL	vandal
VNG	vang
VNHF	vanhoff
VNKATA	venkata
VNKAT	venkat
VNKRN	anckorn
VNKRN	anckorn
VNKVRN	anckorn
VNKVRN	anckorn
VNKV	vinko
VNKYVRN	vankeuren
VNKYVRN	vankeuren
VNLK	volk
VNNTVRP	vanantwerp
VNRNKN	vanvranken
VNR	andr
VNRYPR	vanriper
VNSKVNHVVN	vanschoonhoven
VNSL	anil
VNS	avins
VNSVNHAVN	anshan
VNSVNHVVN	vanschoonhoven
VNTRLY	anatoly
VNTZ	bentz
VN	van
VNVLK	vanvleck
VN	van
VNVRANKN	vanvranken
VN	van
VN	van
VN	van
VNYK	vandyck
VNYLK	vandyck
VNYNGR	enying
VNYRNKN	vanvranken
VNZANDT	vanzandt
VNZANT	vanzandt
VNZND	vanzandt
VNZNT	vanzandt
VRBK	verbeck
VRBVRVF	arber
VRCYK	breck
VRDAN	vardan
VRHVST	verhulst
VRKMN	drukman
VRLV	volvo
VRLYND	verlinde
VRLYNG	arling
VRMASRN	vermaseren
VRMAS	ermas
VRMA	varma
VRMVLN	revlon
VRMVNT	vermont
VRMYLYYVN	marylynn
VRMYVLN	vermeulen
VRMZ	varma
VRNGRYN	vandry
VRNN	venn
VRNR	vern
VRSVVN	craven
VRVBL	varvel
VRVJH	varvel
VRVTH	frith
VRVVD	pravda
VRVVTJ	vrouwtje
VRVYJ	varty
VRYLAV	rysavy
VRYLV	argyle
VRYTY	varty
VRY	avery
VSAL	sal
VSLYAN	kalyan
VSLY	sly
VSLZ	volz
VSM	sm
VSTAL	vestal
VSTFAL	vestal
VSTLY	astley
VSTLY	astley
VSTMVRLND	westmoreland
VSTN	aston
VSTRHLM	westerholm
VSTRN	ostrin
VSTRVLDT	westerveldt
VSTRVLT	strait
VSTR	aster
VST	vest
VSTVN	aston
VSTVR	aster
VST	vest
VST	vest
VS	vs
VSYM	syme
VSYT	vest
VSY	vs
VSY	vs
VTMVR	otmar
VTR	vitor
VTR	vitor
VTS	ats
VT	at
VVDARD	darde
VVDBRN	dorn
VVDD	budd
VVDGYT	bridget
VVDHAVS	vedas
VVDN	avon
VVDRV	vader
VVDVARD	edvard
VVD	ved
VVGLR	vogler
VVGL	vogl
VVG	vang
VVJAK	vojak
VVK	vik
VVLARD	villard
VVLARD	villard
VVLMN	veldman
VVLTRNYNG	woltering
VVLY	daly
VVLZ	volz
VVN	van
VVN	van
VVRDN	vardan
VVRYLAV	berislav
VVRYLV	beryl
VVS	avs
VVTR	vitor
VYANN	vianen
VYBH	ayah
VYBKH	ayah
VYBRND	bernd
VYBVVV	bev
VYB	yb
VYBY	abby
VYCARD	picard
VYCVRA	lycra
VYDAD	ayda
VYDAL	vidal
VYDAL	vidal
VYDA	ayda
VYDD	ayda
VYDFANG	neufang
VYDMAN	veldman
VYDMN	lymn
VYDMR	ryder
VYDRY	vandry
VYDVN	ryden
VYD	ved
VYDYR	ryder
VYDY	addy
VYDYV	addy
VYFAL	rafal
VYGAND	hyland
VYGAND	hyland
VYGJYN	bygden
VYGLY	lyly
VYGMVR	gymer
VYGN	vigen
VYGRT	bogart
VYGSTVN	wigston
VYGTVN	bygden
VYG	ivy
VYGYNZ	vigen
VYJBRAND	wijbrand
VYJBRND	wijbrand
VYJDAN	vardan
VYJNAND	wijnand
VYJND	dymond
VYJNND	wijnand
VYJN	ayn
VYKAMP	kampe
VYKAS	vikas
VYKAVN	skaven
VYKFYLD	byfield
VYKHAM	vikram
VYKLVND	eklund
VYKNZ	dykins
VYKRAM	vikram
VYKRS	ayers
VYKRZ	vikram
VYKS	dykes
VYKS	dykes
VYKTVR	viktor
VYKTVR	viktor
VYKTYM	varty
VYK	vik
VYK	vik
VYK	vik
VYK	vik
VYLADVT	viladot
VYLARD	aylward
VYLARD	aylward
VYLASKV	alaska
VYLAS	vilas
VYLATZ	blatz
VYLA	vela
VYLA	vela
VYLBR	aylor
VYLDKAT	veldman
VYLDRMN	veldman
VYLDYNG	ayling
VYLFRD	alford
VYLFRD	alford
VYLHAYT	melhart
VYLHLMAS	valhallas
VYLHLMVS	valhallas
VYLHLM	vollum
VYLJV	viljo
VYLKAKS	balkans
VYLKANS	balkans
VYLKAS	velmas
VYLKNS	dylans
VYLKN	dylan
VYLKRSVN	fulkerson
VYLKYNSN	wilkinson
VYLKYNSVN	wilkinson
VYLKYN	evelyn
VYLKYNZ	evelyn
VYLLMVS	velmas
VYLMNTJY	valentijn
VYLMR	aylor
VYLMTJY	almaty
VYLMT	velma
VYLMVR	voltmer
VYLMVT	aylott
VYLMYNTH	belmont
VYLMYNTJH	valentijn
VYLMYNTJ	belmont
VYLMYNT	belmont
VYLMYNYTH	aliyyah
VYLND	hyland
VYLND	hyland
VYLNR	aylor
VYLR	aylor
VYLR	aylor
VYLSVN	sylvan
VYLS	vals
VYL	val
VYL	val
VYL	val
VYLYAM	alya
VYLYAMYNA	lamina
VYLYANY	albany
VYLYNGHAM	willingham
VYLYNGZ	ayling
VYLYR	aylor
VYLY	lyly
VYLY	lyly
VYLY	lyly
VYLZ	volz
VYLZ	volz
VYMAL	vimal
VYMAN	ayman
VYMAN	ayman
VYMBRLY	kimberly
VYMN	lymn
VYMPH	rumph
VYMPJH	rumph
VYMPJ	wimpje
VYMPJY	campey
VYMP	kemp
VYMPYJ	campey
VYMR	gymer
VYNATA	vinata
VYNBRG	nyberg
VYNCSTR	lancaster
VYNDN	lyndon
VYNDRZ	vandry
VYNDVM	lynda
VYND	lynda
VYNKLMAN	monkman
VYNKL	vinko
VYNKLZ	finkle
VYNKV	vinko
VYNLT	rybolt
VYNND	lynn
VYNN	lynn
VYNRT	enyart
VYNR	tynor
VYNSNT	vincent
VYNSN	vinson
VYNSR	tynor
VYNSTD	finstad
VYNSTRVM	winstrom
VYNSTVK	alnitak
VYNSTVN	dunstan
VYNSVN	vinson
VYNTH	cynthia
VYNTJH	eyntje
VYNTJ	eyntje
VYNTJY	eyntje
VYNTRFYLD	winterfeld
VYNTRMYVT	coventry
VYNTRR	paynter
VYNTR	paynter
VYNTRZ	bentz
VYNTVN	paynton
VYNT	advent
VYNTZ	bentz
VYN	ayn
VYNVKR	denver
VYN	ayn
VYNYBL	venable
VYNYKY	vandyke
VYNYNGR	venner
VYNYNGSTD	winningstad
VYNYZ	allyz
VYNZ	ayn
VYPKJH	wiepkje
VYPKJ	eyck
VYPKJY	gypsy
VYPK	eyck
VYPYN	vipin
VYRAF	viraf
VYRCVAL	lyrical
VYRJYL	beryl
VYRJYNYA	arjuna
VYRNDRA	virendra
VYRN	vern
VYRSMA	varma
VYRTANN	virtanen
VYRT	evert
VYR	cyr
VYR	cyr
VYR	cyr
VYRYANA	wiryana
VYRZ	byra
VYSAL	vestal
VYSKA	laska
VYSL	lysol
VYSPY	vispi
VYSR	ayse
VYSR	ayse
VYSTFAL	vestal
VYSTVN	mayston
VYST	myst
VYS	levys
VYSVN	ayson
VYSVN	ayson
VYSY	gypsy
VYSYVS	gypsys
VYTAKA	jataka
VYTAKR	altair
VYTAL	vestal
VYTFYLD	bottfeld
VYTKAMB	kamb
VYTKVS	vaitkus
VYTMR	vitor
VYTMVR	voltmer
VYTNBRG	roytenberg
VYTN	ayn
VYTN	ayn
VYTSH	ayush
VYTSVN	aitsen
VYT	ivy
VYTVL	lytle
VYTVR	vitor
VYTVRYA	victoria
VYTV	kyte
VYT	ivy
VYT	ivy
VYT	ivy
VYTYKR	vetter
VYTYK	vitek
VYTYNGTVN	symington
VYTZ	bitz
VYVA	viva
VY	ivy
VYVKS	eycks
VYVK	vivek
VYVLA	ayala
VYVR	byer
VYVVR	aylor
VYVYANH	vivian
VYVYAN	vivian
VYVYK	vivek
VY	ivy
VY	ivy
VY	ivy
VYYRS	ayers
VYZBRAND	brand
VYZNAND	anand
VYZNRY	vandry
VYZN	vizen
VYZRNR	byrne
VYZVN	vizen
VZDA	hvezda
VZYNA	vezina
XALDAH	walidah
XALYDH	aaliyah
XAN	xian
XAY	day
XLYDA	lydea
XLYDH	blyth
XLYLH	lylah
XRDL	aral
YAGLA	yagla
YAGR	yager
YAKVB	yacob
YAKVLTY	kelty
YAKVTAH	yakootah
YAKVTA	akita
YAMAHA	yamaha
YAMAHA	yamaha
YAMHA	yamha
YAMN	yan
YAMYNAH	yaminah
YAMYNA	yaminah
YANGR	yang
YANG	yang
YANGY	yang
YANSVN	yanson
YANVVYTZ	yanowitz
YAN	yan
YANYV	yaniv
YANZK	yanzek
YAP	yap
YARGR	yager
YARLA	carla
YARMAN	yarman
YARVN	yaron
YARVS	yaros
YARYAN	yaryan
YASAR	yasar
YASR	yasar
YASYN	yasin
YASYRAH	yasirah
YASYRH	yasirah
YASY	casey
YATS	yates
YAV	av
YAYN	ayn
YKVTAH	yakootah
YLND	hyland
YLYC	alyce
YLYF	lyly
YMHA	yamha
YMN	lymn
YMYNH	myth
'YN	ayn
YRBRY	yerbury
YRMYS	pygmys
YSRA	basra
YSRYH	yasirah
YSYRAH	yasirah
YSYRA	syria
YSYRH	yasirah
YTR	pyotr
YVBYRA	byra
YVFYNGTVN	uffington
YVHANS	chans
YVKYLV	jekyll
YVK	yok
YVLYN	evelyn
YVMANS	lymans
YVMN	yumn
YVMVRA	aymara
YVNAL	juvenal
YVNAS	yonas
YVNGSAP	yongsup
YVN	yan
YVNSVN	yanson
YVN	yan
YVNYZA	kenya
YVRANYM	avraham
YVRBANYK	burbank
YVRK	york
YVRMV	yermo
YVRYNA	myrna
YVSF	yosef
YVSTN	yasin
YVS	yves
YVSYV	gypsy
YVSY	gypsy
YVSY	gypsy
YVZF	yves
YVZR	ivar
YYKA	yeka
YYK	yok
YYTZ	bitz
YYTZ	bitz
YZAK	yzaak
YZK	yok
YZYD	yazid
ZABL	zabel
ZABZ	zabel
ZACARY	zachary
ZAFYNA	zafina
ZAGAR	zagar
ZAHD	zahid
ZAHYD	zahid
ZAKVB	zaki
ZAKVB	zaki
ZAKVMYNTAY	jacomyntie
ZAKYVS	akivas
ZAK	zaki
ZAKY	laky
ZALAN	zalan
ZAMVR	zamora
ZAMYT	amyot
ZANGRL	zangerl
ZAN	zand
ZANKH	zaynah
ZANKY	jansky
ZANK	bank
ZANS	zanes
ZANT	iant
ZAPARA	zapara
ZARA	zara
ZARRYTN	zjarritjen
ZARVS	zaras
ZARYA	arya
ZARYH	arch
ZARYTN	aryan
ZARYTZN	aryan
ZATRVVD	astrid
ZAYNAH	zaynah
ZAYNA	zaynah
ZAYRA	mayra
ZAYR	dayr
ZAZA	zaza
ZFRY	fry
ZFYNA	zafina
ZFYNH	zaynah
ZHRA	zahra
ZHRA	zahra
ZHRA	zahra
ZHYD	hyde
ZHYRAH	zahirah
ZHYRA	hydra
ZHYRH	zahirah
ZJARYTJN	zjarritjen
ZJARYTN	zjarritjen
ZKH	kazakh
ZKYAH	zakiyyah
ZKYH	sky
ZKY	sky
ZK	bk
ZK	bk
ZLA	zola
ZLR	lr
ZLTJ	aaltje
ZLYKAH	lylah
ZLYXA	alya
ZMANK	zemanek
ZMAN	zeman
ZMYRAN	amran
ZMYT	amyot
ZNG	zang
ZNK	zn
ZNTNR	zentner
ZNYKH	zaynah
ZN	zn
ZPKA	zepka
ZRA	ezra
ZRYA	arya
ZRYFA	zarifa
ZRYF	arya
ZRYH	arch
ZRYNK	zurink
ZRY	fry
ZVHANS	chans
ZVHANSN	hansen
ZVKA	zepka
ZVLD	zold
ZVL	zyl
ZVLMR	zolmer
ZVLY	daly
ZVLYKA	zuleika
ZVNTK	zontek
ZVRYNK	zurink
ZVRYSYKA	aversa
ZVTRVD	astrid
ZVTRVVD	astrid
ZVVAYTA	vaya
ZVVYTA	zuvieta
ZVYTA	evita
ZVYTRVVD	ayurveda
ZVZF	zaza
ZYGMVNT	zygmunt
ZYLT	zyl
ZYL	zyl
ZYMRAN	zimraan
ZYNAH	zaynah
ZYNA	dyna
ZYNB	ayn
ZYNH	zaynah
ZYNSR	zinser
ZYRA	byra
ZYRYLY	bayly
ZYR	cyr
ZYTV	kyte
ZYVRYNK	zoerink
ZYVTRVD	astrid
ZYZY	fuzzy
ZZA	zaza
ZZ	aziz
