aactay	mackay
aaltj	aaltje
aamyna	aamina
aarvn	aaron
aba	aba
abad	abad
abada	abad
abadhby	abad
abaja	abuja
abar	aabar
abcr	aabar
abdja	abuja
abdlrhman	abdalrahman
abdvn	abdul
abh	aba
abhay	abhay
abhy	abby
abla	aba
abl	aba
abl	aba
ablh	able
ablhyd	abley
ablj	able
ablt	able
abltj	aaltje
ably	abby
ablysn	abbys
abnd	abad
abnr	abner
'abr	aabar
abr	aba
abraham	abraham
abrahym	abraham
abrahym	abraham
abram	abram
abramsvn	abramson
abrapt	abrupt
abrayt	abhay
abrbac	abbas
abrg	aberg
abrg	aberg
abrkrvmby	abby
abrl	abel
abrly	abbey
abrmsky	abrams
abrt	art
abrt	art
abrvtr	abbate
abry	abby
abry	abby
abryn	bryn
abryny	bryn
abstgartn	obstgarten
abst	obst
abstrkt	abstract
abt	aba
abtyn	abby
abv	aba
abvba	aboba
abvdby	abby
abvdhaby	abudhabi
abvhbyb	abby
abvlyn	abolin
abvrymh	abery
abvt	aba
abvt	aba
abvtsmyt	abbotsmith
abya	aba
abyab	abiab
aby	aba
aby	aba
abyad	abad
abyan	abyan
abyd	abad
aby	aba
abyl	abel
abylak	abyan
abyna	aba
abyngm	abend
abyngn	abyan
acdl	abdul
ac	ac
acr	ac
acrnar	achernar
acty	acts
actyh	acton
acy	ac
acyls	abels
acysvn	alyson
acyt	ac
adab	adab
adam	adam
adamv	adam
adana	adana
adan	adan
adanl	adan
adara	adana
adb	ada
adbrg	aberg
adgrynglnd	adgeringelant
adgrynglnt	adgeringelant
adgyngtvn	addington
adh	ada
adkak	ada
adkk	adik
adkryk	abery
adkvk	adik
adkynz	adkins
adkyrk	adar
adla	ada
'adl	fadl
adl	ada
adlardv	adelardo
adlayd	allard
adlayd	allard
adlhyd	abley
adlma	adalma
adl	ada
adlr	adar
adlsvn	adelson
adly	addy
admvnd	amand
admvnds	armands
admvndz	amand
admvnz	aamina
admyraln	admiral
admyralz	admiral
admystvn	edmiston
adnams	adnams
adnamz	adnams
adnbrag	abram
adnbrg	aberg
adnbrv	abner
adnbrvg	aberg
adnbvrg	aberg
adry	addy
adry	addy
adryana	adriana
adryan	adrian
adryans	aryans
adryn	aaron
adrynklnt	adkins
adryns	adans
adryny	aaron
adryny	aaron
adrys	abbys
adsal	ada
adst	adit
adsvn	adan
adt	ada
advard	edvard
advard	edvard
advardsn	adars
advart	adar
advlf	adolf
advlfsvn	adelson
advlf	adolf
advncr	abner
advnl	advil
advnys	adans
advsvmaly	adusumalli
advvart	adar
ady	ada
ady	ada
ady	ada
ady	ada
ady	ada
adyh	ada
adyk	adik
adyks	adams
'adyl	adel
adyl	adel
adylrd	abelard
adyna	adana
adyngtvn	addington
adyngtvn	addington
adys	adas
adysak	adisak
adysvn	alyson
adyt	adit
afa	afa
afaf	afaf
afra	afra
afrdyt	abrupt
afrvdyt	abrupt
aftab	aftab
afv	afa
afvryl	abery
afycart	aymara
afyf	afaf
afygtn	abyan
afyngtn	alington
afys	amys
afysr	amys
afyvn	abyan
afzal	afzal
afzl	afzal
agaly	agali
agas	adas
agaty	agate
agbrn	agra
agbvrn	agsorn
ag	ag
aglstvn	agustin
agmn	adan
agmvz	ag
agndy	andy
agnv	agni
agnvyk	agndie
agpyan	abyan
agr	ag
agravala	agrawala
agrn	agra
agrtn	agren
agrtvn	agren
agrynglant	adgeringelant
agrynglnd	arnold
agvlv	agali
agvr	adar
agvstv	acosta
agvstyn	agustin
agvstynly	agostini
agvstyny	agostini
agvyrv	agoyo
agvyv	agoyo
agyla	adela
agyl	abel
agylsvn	abelson
agynst	against
ahay	abhay
ahland	ahmad
ahman	ahmad
ahmn	adan
ahrn	ahern
ahy	amy
ahyh	ahab
aj	a
ajast	adas
ajay	ajay
ajda	ada
ajlvs	ajaxs
ajnt	aint
ajraynglnd	arnold
ajyngtvn	alington
ajyntvn	anton
aka	aka
ak	a
akadmy	academy
akadmyk	akademik
akaks	adams
akapady	accapadi
akbrg	aberg
akbvrn	akbar
akdag	akdag
ak	a
akgan	akgun
akl	akl
akland	oakland
aklnd	abend
aklvf	akiva
akly	akl
akly	akl
akm	aim
akman	akman
akmandnsys	amandas
akmandsys	amandas
akman	akman
akmna	amna
akmn	akin
akmr	akar
akmvndnsys	ekmundensis
akmy	amy
akn	ain
ak	a
akr	air
akrm	arm
akrman	akman
akrmn	akron
akrsand	armand
akrslatv	ekerslato
akrslytv	akrill
akrstv	acosta
akrt	art
akrvyd	ackroyd
akryl	akil
aks	acs
aksayl	abhay
aksdlm	anselm
aksfrd	afra
aksfvrd	alford
aksfvrd	alford
akskrytya	ackroyd
akslsvn	abelson
aksly	akil
akss	aksu
akstrnd	astrid
akstyn	alston
aksv	aksu
aksyl	akil
akts	acts
aktvn	acton
aktvn	acton
akty	abby
aktyv	abby
akval	advil
akvayla	kayla
akvayl	abhay
akvdv	abad
akvks	akers
akvna	acuna
akvnr	akar
akvsta	acosta
aky	aka
aky	aka
akyf	afaf
akyhykv	akihiko
akyla	adela
akyla	adela
akylah	akilah
akyl	akil
akyl	akil
akylh	akil
akyls	abels
akym	adam
akyn	akin
akytvmv	akitomo
al'adyn	alaaldin
alahaydykya	alaaldin
alahdvd	aladdin
alaldyn	alaaldin
al	al
alam	adam
alamz	alamo
alana	alana
alangkv	alan
alapaty	alapati
alaqbh	alaqabah
alard	alar
alasr	alar
alasvrs	alars
alavay	alana
alavy	ajay
alayn	alain
alaysdyr	alaisdair
alays	alans
albahah	albahah
albha	alba
albhah	albahah
albljh	allah
albr	alar
albrayt	abhay
albrt	albert
albrtyny	albany
albry	abbey
albryj	abbey
albvn	alain
albvz	alba
albyngr	albinger
aldhayd	alphard
aldlhld	alfeld
aldn	alan
aldn	alan
ald	al
aldr	alar
aldrd	adri
aldryc	alaric
aldrydj	aldrich
aldryg	aldrin
aldryg	aldrin
aldryj	aldrin
aldryj	aldrin
aldryj	aldrin
aldryjh	aldrich
aldyn	aldan
aldz	aldo
alfa	afa
alf	alf
alfansv	alans
alfarv	alfaro
alf	alf
alfrd	alford
alfrdv	alford
alfrs	alars
alfryng	aldrin
alfvrd	alford
alfvrd	alford
algadv	alegado
algard	allard
algayn	alain
algrv	agra
algsan	aegean
algy	abby
algyngtvn	alington
alhdad	ahmad
alhdvd	alhudud
alj	al
aljh	al
alkan	alan
alkbah	akbar
alkbr	akar
alkbyr	akbar
alkk	alok
alkmr	akar
alkmrh	akar
alkmry	abery
alkr	alar
alkrtn	akron
alkrtvn	alkerton
alks	alps
alksandr	alesandro
alksandrvz	alesandro
alksndr	alcindor
alksy	aksu
alksyv	aksu
alkvab	alva
alkvk	alok
alkvr	akar
alkyngtn	alington
alkyngtvn	alington
alkyntn	alkerton
alladhkyah	alladhiqiyah
alladhykyah	alladhiqiyah
allahygyah	albahah
alldhykyah	aliyyah
alldykyah	aliyyah
allhyqyh	aaliyah
alm	alm
almar	alar
almas	almas
almatvn	almaty
almgrn	almgren
almkvast	almqvist
almkvyst	almqvist
almn	alan
almntaj	alana
almr	alar
almrs	alars
almrvt	alar
almvd	ahmad
almvdyvar	almudevar
almv	alm
almvman	allman
almvr	alar
almynakah	almintaqah
almyntagah	almintaqah
almyntakah	almintaqah
almyntakva	almintaqah
almyntkh	alioth
almyral	admiral
aln	ain
aln	ain
alnd	and
alndr	andr
aln	ain
alnvr	abner
alny	abby
alpn	alan
alprt	alpert
alpvrt	alpert
al'qbh	alaqabah
alrbk	alba
alrd	aird
alrtn	aaron
alrtvn	alston
alrvy	airay
alry	abby
alrygh	aaliyah
alryj	aliya
alsandry	alesandro
alsan	alan
alsan	alan
alsap	alsop
alsap	alsop
alsap	alsop
alsndrv	alesandro
alsn	alan
alsn	alan
alsnr	alan
alsp	als
alsp	als
alspd	alpo
alsr	alar
alstrvm	ahlstrom
alsvn	alain
alsvn	alain
alsvn	alain
alsvp	alsop
alsvp	alsop
alsvrs	alars
alsvrt	albert
alsvz	allyz
alsy	als
alt	ait
altanyn	albany
alt	ait
altayr	altair
altman	altman
altmn	altman
altmn	altman
altrvayd	ackroyd
altrvd	alfred
altrvyd	ackroyd
altrvyyd	ackroyd
altsvn	aitsen
altv	alta
altyr	alar
altz	alta
alva	alva
alvan	alan
alvarv	alvaro
alvarvs	alvaros
alvarz	alvarez
alvay	alva
alvf	alf
alvkal	alukal
alvk	alok
alvld	alfeld
alvrs	alars
alvsa	alisa
alvvd	alva
alvvd	alva
alvy	alva
alvy	alva
alvyn	allyn
alvyn	allyn
alvyn	allyn
alvyn	allyn
alvyn	allyn
alvys	alves
alvz	alva
alxzna	alana
'alya	alya
alya	alya
'aly	daly
a'ly	aali
aly	al
alya	alya
alya	alya
a'lyah	aaliyah
alyah	allah
aly	al
aly	al
aly	al
alyan	abyan
alyas	alias
alyasvn	alyson
alyby	abby
aly	al
aly	al
alyfas	alanas
'alyh	alya
alyj	alya
alyks	alans
alylyvnas	alelyunas
alyma	alima
al'yn	allyn
alyn	alan
alyn	alan
alyn	alan
alyn	alan
alyngr	abner
alyngtvn	alington
alyngtvn	alington
alyn	alan
alynyk	alan
aly	al
alysa	alisa
alys	alps
alys	alps
alys	alps
alysn	alyson
alystvn	alston
alystyr	aleser
alysvn	alyson
alysvn	alyson
alysvn	alyson
alysvn	alyson
alysya	alyssa
alyva	alva
alyvrya	alberta
alyvt	aleut
alyvt	aleut
alyvy	alexy
alyya	aliya
alyza	alya
alyzabt	alya
alyz	allyz
alyzr	alar
alz	al
alzna	alana
alzn	alan
alzvrs	alars
ama	ama
amadvr	amador
amagyv	ajay
a'mal	amal
amal	amal
amand	amand
amanval	amanda
amanv	amand
amanvl	amal
amanvyl	amal
amany	amand
amanyvl	amal
amara	amara
amaral	amaral
amardyv	amardeo
amarnt	amarit
amaryt	amarit
ambar	aabar
ambasy	abbas
amblr	amber
ambrly	amberle
ambrly	amberle
ambrlyng	arling
ambrvss	abrams
ambrvsvs	ambrosio
ambrvsyv	ambrosio
ambrvsyvs	ambrosius
ambvs	abbas
ambyj	abby
amdyv	addy
amfn	amin
amlak	amlak
aml	akl
amlk	amlak
amln	amin
amlya	alya
amna	amna
amn	ain
amnvn	amnon
ampn	amin
amprvr	amador
ampsvn	amphon
ampt	amit
ampth	ampte
ampy	amy
amrald	amal
amr	air
amrjyng	amran
amrman	amerman
amrvsyv	afros
amry	amery
amry	amery
amry	amery
amryka	arya
amrykn	amran
amrykn	amran
amryta	amritha
ams	ams
amstat	amstadt
amstd	amand
amstr	amster
amsy	ams
amt	ait
amtysta	amethysta
amvna	amina
amvndsyz	amundsen
amvrvsv	amarus
amvry	amery
amvs	amos
amy	amy
amy	amy
amyh	amy
amyhay	abhay
amykvs	amys
amyly	amal
amyly	amal
amylyyv	smyley
amyna	amina
amyna	amina
amynh	amand
amyra	amara
amyr	amir
amyr	amir
amyt	amit
amytava	amitava
amyt	amit
amyt	amit
amyvt	amyot
amyvt	amyot
amyzvta	amyot
anagram	anagram
anakyn	anakin
analvg	analog
ananda	ananda
anand	anand
an	a
anansa	ananda
anant	anant
anas	anas
anastasya	anastasia
anatvly	anatoly
anaty	anay
anay	anay
anaylyn	allyn
anayza	ananda
anaz	ana
anaza	adana
anbar	anbar
anbr	anbar
anbv	anbu
ancy	anay
andamz	adam
and	and
and	and
andns	andes
andra	andra
andr	andr
andr	andr
andrbrg	anderberg
andrbvrg	anderberg
andrby	andr
andr	andr
andr	andr
andrr	ander
andrs	andes
andrs	andes
andrsn	andron
andrsn	andron
andrsvn	andersen
andrvs	andras
andrvz	andr
andrya	andra
andry	andr
andry	andr
andryas	andras
andrys	andras
andrys	andras
andrys	andras
andrysn	andras
andrysn	andras
andryvz	andr
andryya	andra
andryz	andr
andsvrs	adars
andsvrt	adsett
andsvvrt	vandivort
andvlsn	andolsen
andysl	andys
andyyvrans	aldebarans
anfant	anant
anfyld	alfeld
angbrtsn	angoras
angh	anghe
angland	england
anglandr	england
anglasma	anglesea
anglhard	abelard
anglhlm	anello
anglhvrn	angevin
anglnd	anand
angls	angels
angls	angels
anglsma	anglesea
anglsvn	abelson
anglth	angle
angltj	angle
angltjh	aaltje
anglyna	angelina
anglys	angles
anglz	angle
angrsvl	angel
angvlv	angel
anh	ana
anhld	anhold
anjbrtsvn	andersen
anjl	anil
anjljy	ansley
anjls	abels
anjlt	anant
anjltja	aaltje
anjlv	angle
anjlyna	ajlun
anjlys	andys
anjlysya	alyssa
anjy	anay
anjylyny	ajlun
ankny	anand
ankr	andr
ankrly	abery
ankstad	acosta
ankvrn	anckorn
anpyngkv	unpingco
anq	ana
anqh	ana
anrah	abram
anr	air
anryk	anay
anrykv	anay
anrykyv	airay
anrykyyvz	afrikaans
ansar	anbar
anskamb	anscomb
ansl	anil
anslm	anselm
anslmv	anselm
ansly	ansley
anslyn	allyn
anspac	anspach
ansr	andr
anstytv	antti
ansy	anay
ansy	anay
ansyh	anay
ansykr	ainsaar
antal	antal
antanaytys	antanaitis
antaramyan	antaramian
ant	aint
anth	acts
antna	anna
antrapy	entropy
antrv	andr
antrvsyv	antevs
antrykyn	entrikin
antstl	antal
antsytl	ansell
antvn	anton
antvn	anton
antvn	anton
antvnvglv	antonoglou
antvnvvyc	antony
antvny	antony
antvny	antony
antvny	antony
antvnys	antonys
antvnys	antonys
antvnyv	antony
antvnyvs	antonys
antvs	antevs
anty	anay
antyla	antila
antypds	antipas
antystl	andys
antystlh	anthistle
anv	ana
anv	ana
anvar	anbar
anvcyn	anacin
anv	ana
anv	ana
anvjyt	anujit
anvkvl	anukul
anvn	ann
anvpam	anupam
anvp	alva
anvr	andr
anvr	andr
anvr	andr
anvrs	anvers
anvs	anas
anvs	anas
anvtyyadys	alvarados
anvvy	anay
anyart	enyart
anyjma	abuja
anyl	anil
anyl	anil
anyl	anil
anyma	alima
anyng	anand
anysa	anisa
anys	amys
anysh	amish
anystyn	agustin
anyvrsry	anderer
anyvs	amys
anyyv	anay
anzalvny	anzalone
anzlvar	anzlovar
anzyngr	enzinger
apcrc	accra
ap	a
apl	akl
apl	akl
aplbay	alba
aplbrg	aberg
aplby	abby
aplby	abby
aplmn	aplin
aplnds	laplands
aplyby	appleby
aplyby	appleby
aplyn	allyn
apndys	andys
aprayt	airay
aprly	airay
aprsvn	aperson
apryl	april
apstn	alston
apstvn	alston
apstyn	alston
apsylvn	aplin
apvnth	aponte
apvrva	apoorva
apydal	ayda
apystyn	agustin
aqbal	iqbal
aram	abram
arand	amand
aran	adan
ararkh	ararat
aras	aras
aras	aras
arasmvs	erasmus
aray	airay
arayz	airay
arbanas	arbanas
arbr	arber
arbvr	arber
arbyd	abad
arby	abby
arbyl	arbil
arby	abby
arcal	aral
arcalh	aral
arc	ac
arcard	allard
arcdaly	archdale
arcdl	aral
arcdyl	abdul
arcr	arce
arcybald	archibald
ardalyc	ardalich
ardmn	arden
ardn	arden
ardrz	adri
ardys	andys
ar	ar
arfanakys	orfanakis
arfvrd	alford
arfyvs	abbys
argan	aryan
argan	aryan
argar	orgar
arhard	erhard
arkard	akar
arkdyl	arkell
arktyky	arktiki
arlayj	abhay
arl	akl
arl	akl
arl	akl
arlt	arlet
arly	carly
arlyj	allyn
arlyndh	allende
arlyng	arling
armand	armand
arm	arm
armastrang	armstrong
armatv	armato
armny	amna
armry	abery
armsrvng	armstrong
armstrang	armstrong
armvntrvt	armontrout
armvr	amir
armyn	aiman
armytaj	armato
armyt	amit
armytaz	armato
arn	ain
arnat	arnot
arnd	and
arndt	arendt
arnfyld	arnfield
arnh	arch
arnld	arnold
arnst	arnot
arnt	aint
arnt	aint
arnt	aint
arnts	arnos
arnvld	arnold
arnvt	arnot
arnvt	arnot
arp	ar
arpyn	arpin
ars	ars
arskat	arafat
arskayn	alaskan
arsnalt	arsenault
arsy	ars
arsyd	arend
arsykr	amster
artl	aral
artr	art
artrs	arts
artrz	ariz
artvt	arlet
artys	arts
artyz	allyz
arval	aral
arvma	alima
arvn	aron
arvnacalam	arunachalam
arvnah	arunah
arvnd	arend
arvnn	alvin
arvrkh	ararat
arvsn	alvin
arvyng	arling
arvyvla	arviola
arya	arya
arya	arya
ary	amy
aryc	arya
aryfa	arya
aryj	arya
aryka	arya
aryka	arya
aryk	ark
aryk	ark
aryksn	aryan
aryksvn	alyson
aryksvn	alyson
aryksvn	alyson
aryn	aron
aryngtn	alington
arys	amys
arys	amys
arys	amys
arystvtl	aristotle
aryz	ariz
aryz	ariz
arzat	arzate
arz	ar
asakvl	assakul
asbl	aba
asbrn	agsorn
asbrynk	asbrink
asbvrn	osborn
ascafyld	alfeld
ascagn	asian
ascrvvyc	ascoly
ascvfyld	alfeld
ascvylar	ascella
ascyplvdn	sylvan
ascyplvydn	ascoly
ascypn	aachen
asds	abes
asfar	aabar
asfyld	alfeld
asgvryan	algerian
askadz	akkad
askagn	asian
askahan	skahan
askajn	asian
askalant	askanas
askal	afzal
askalyk	ascoly
askaly	ascoly
askanl	asian
askanyl	askanas
askarp	akar
askars	adars
askartsys	skartsis
askary	akar
ask	ask
askatv	abbate
askatya	skaya
askaty	almaty
askavn	asian
askaya	skaya
askaylr	akar
askay	abhay
askayt	skaya
askldsvn	eskeldson
askltn	abolin
askltvn	alton
asklvyr	ackley
asknl	akil
askns	adans
askp	ask
askrab	arab
askrantvn	austranten
askrayz	ackroyd
askrntn	akron
askrntvn	akron
askrvyc	ackroyd
askryblyng	arling
askrybnr	akbar
askryc	abery
askry	abery
askrys	averys
askryv	abery
askvayrl	akar
askvayr	akar
askvfyld	ackroyd
askvgan	akgun
askvly	ascoly
askvlyng	allyn
askvlyn	allyn
askvly	ascoly
askvlyz	allyz
askv	ask
askvrr	akar
askv	ask
askvtvny	antony
askvylr	advil
askvyvyl	ackley
askyba	skiba
askyls	abbys
askynr	adkins
askyn	aiken
askyn	aiken
askypladn	assyrian
askyplvydn	sylvan
askypn	skype
askyp	ask
askypy	skype
askyrs	akers
asky	ask
askytr	akar
aslankard	slankard
aslan	alan
aslan	alan
aslan	alan
aslatkyn	slatkin
aslatkyn	slatkin
aslatr	alar
aslatry	alar
aslatvbr	slater
aslavk	amlak
aslavmyz	alamo
aslavnbrg	slavenburg
aslavyn	slavin
aslayk	amlak
aslbvtnn	albany
asld	auld
aslmn	ajlun
aslngzvald	slangsvold
aslp	aali
aslr	aali
asls	als
aslsyng	allyn
asltn	ajlun
asltr	adler
aslvan	alan
aslvkam	alukal
aslvka	alva
aslvmn	alvin
aslvn	ajlun
aslvn	ajlun
aslvp	alva
asly	sly
aslygrz	allegra
aslyman	allman
aslyny	allyn
aslypr	adler
aslyp	allyn
aslyty	ablett
aslyvpas	alyssas
aslyv	allyn
asma	asma
asmadj	ahmad
asmal	amal
asmaly	almaty
asmart	asmara
asmayt	asma
asmdly	ascoly
asmln	aiman
asmvky	smoky
asmvlyk	amlak
asmvlyn	allyn
asmvr	amir
asmvt	amit
asmyd	ahmad
asmykla	smikla
asmyl	amal
asmyly	ascoly
asmyrnv	asmara
asmyt	amit
asmytsvn	aitsen
asmytvyk	almaty
asmytz	adametz
asmytz	adametz
asnag	akdag
asnaydr	anand
asndn	amnon
asnl	abel
asnl	abel
asnlyng	allyn
asnr	abner
asnvdn	alvin
asnvfyld	alfeld
asnvgrs	anvers
asnv	agni
asnyd	and
asnyl	anil
asnysl	abbys
aspanglr	spangler
aspardam	amsterdam
asparks	sparks
asparndam	spaarndam
aspar	caspar
asparv	amparo
asparza	esparza
aspatafvra	spatafora
aspat	asaad
aspatsvvd	abbasid
aspatz	spatz
aspavldyng	spaulding
aspaydr	asaad
aspaydrz	amparo
aspayk	abhay
aspayks	sparks
aspaynyng	spinning
aspayrz	amparo
aspayz	spatz
asplmn	aplin
asplyd	allyn
asplyntr	splinter
aspnsr	aspens
aspns	aspens
asprag	sprag
aspr	apr
asprvt	alpert
asprybry	appleby
aspry	abery
aspvlaryc	alaric
aspvlaryx	abelard
aspvr	apr
aspvry	abery
aspvsta	acosta
aspvsytv	esposito
aspvtys	almatys
aspydn	aspen
aspylmn	aplin
aspynak	spinak
aspyndryft	spindrift
aspyn	aspen
aspyras	assyrias
aspyr	apr
aspyr	apr
aspyrv	alpert
aspyrv	alpert
aspyryng	asbrink
aspyrz	allyz
aspyrz	allyz
aspysak	spisak
aspysyk	spisak
aspyt	aspen
aspytzr	aster
aspyvak	spivak
aspzytv	alpert
asrat	israt
asrayyl	airay
asrmn	aaron
astabrt	astaire
astabz	aftab
astad	asaad
astad	asaad
astafl	antal
astafvrd	asgard
astag	aftab
astajanv	stajano
astakmn	actaeon
astakr	altair
astakslajr	alaisdair
astaks	altais
astaky	astana
astaky	astana
astalkh	antal
astampr	stamper
astam	assam
astangyr	astana
astanvl	astana
astaplyc	staples
astarbak	amtrak
astargs	antares
astargyl	astarte
astark	stark
astarkyp	astarte
astarky	astarte
astar	aster
astar	aster
astartld	astarte
astart	astarte
astartz	astarte
astaryngr	staringer
astarz	asgard
astas	asias
astatm	assam
astatrz	astaire
astatzmn	staten
astaylz	antal
astaynls	astanas
astaynmn	astana
astayn	asian
astayr	altair
astbay	astley
astcnyk	antony
astdlr	aster
astdmn	aston
astdyna	astana
astfans	altmans
astfan	altman
astfan	altman
astfanvs	astanas
astfanv	astana
astfanz	astana
astfn	aston
astfnsvn	stinson
astgn	aston
astk	ask
astlr	aster
astly	astley
astlyk	astik
astly	astley
astnfrd	asgard
astnfvrd	ashford
astnfvrt	stenfort
astnkamb	adnams
astnsl	acts
astnsrad	assad
astn	aston
astntjy	astley
astpkn	aspen
astpk	astik
astrabryj	araby
astradr	astrid
astrakmn	astrakhan
astrak	amtrak
astrandr	ostrander
astrap	amtrak
astr	aster
astrasym	atram
astravb	straub
astrlyng	arling
astrmlr	aster
astrn	aston
astrnd	astrid
astrn	aston
astrvk	amtrak
astrvm	astrid
astrvs	antevs
astrvstrap	stroustrup
astryan	aryan
astrybl	astrid
astryd	astrid
astrydm	astrid
astrydr	astrid
astrym	astrid
astryn	aston
astryngr	stringer
astrynjr	asbrink
astryn	aston
astryny	anthony
astryr	aster
astry	abery
astryty	astarte
asts	acts
astvard	asgard
astvart	astarte
astvbryj	astaire
astvdvla	stodola
astvfl	advil
astvklas	stoklas
astvk	astik
astvk	astik
astvkvl	assakul
astvky	astik
astvlk	astik
astvlr	aster
astvl	antal
astvn	aston
astvnbrayj	astana
astvnsn	alstons
astvn	aston
astvn	aston
astvr	aster
astvrga	astoria
astvrlyr	ascoly
astvrmz	astarte
astvrr	aster
astvrym	astarte
astvry	aster
astvry	aster
astv	acts
astvval	antal
astvy	aster
astyansn	altmans
astybl	aftab
astybr	aster
astyd	asaad
astygbrg	stigberg
astygmn	aston
astygrs	arthers
astyg	aster
astyjh	aetje
astyk	astik
astyklmn	aitken
astylr	aster
astyl	antal
astyl	antal
astyl	antal
astyly	ascoly
astylz	allyz
astyn	aston
astynbrg	stenberg
astynsn	alstons
astyn	aston
astyn	aston
astynsvn	stinson
astynth	ashanti
astyntjh	martyntje
astyntj	ashanti
astynz	astana
astyplz	allyz
astyp	aster
astyrn	aster
astyrnz	assyria
astysy	astley
astysy	astley
astyt	aster
astyvdnt	advent
astyvn	aston
astyvnsvn	atkinson
astyvs	antevs
astyvz	active
asvalap	aswalap
asvald	asaad
asvanay	askanas
asvk	ask
asvlt	iselt
asvrs	adars
asvsky	nevsky
asvysr	abbys
asya	alya
asy	amy
'asyf	asif
asyf	asif
asymylyt	amyot
atansyv	adans
ata	aba
ata	aba
ataras	ataras
ath	at
atjh	aetje
atka	atka
atkynsn	atkins
atkynsvn	atkinson
atkynz	atkins
atkynz	atkins
atl	akl
atls	als
atmsfr	aleser
atmz	aim
at	at
atram	atram
atr	air
atrtn	aaron
atry	atri
atrysps	ariss
atrz	atri
attly	antley
atv	at
atvatr	atwater
atvd	abad
atv	at
atvl	atul
atvl	atul
atv	at
atv	at
atvsan	atman
atvs	ats
atvsy	athey
atvvd	abad
atvvl	advil
atvyl	advil
atya	alya
aty	amy
atyg	ag
atylrd	abelard
atylrdh	abelard
atylyv	allyn
atyngr	tyng
atyny	antony
atynzvn	etinzon
atys	amys
atyvl	atul
atyya	atiya
avaca	adana
avad	abad
avadya	acadia
avald	aali
avan	adan
avanz	adan
avasty	avas
avbaja	abuja
avbrayan	abraham
avbrdvrfr	anderer
avbrhvlz	averell
avbrhym	abraham
avbr	aabar
avbrtas	albertas
avbry	avery
avbry	avery
avbyd	abad
avbyngm	abby
avcard	allard
avcar	aabar
avclnd	abend
avcz	ac
avddy	addy
avdkryk	avery
avdkyrk	adar
avdl	abdul
avdly	addy
avdra	andra
avdrgv	aberg
avdvak	aviva
avdvn	adan
avdv	ada
avdyvm	adam
avfnr	avins
avfyngtvn	addington
avgar	aabar
avgbvrn	agsorn
avglt	angle
avgnh	agni
avgnyv	agnes
avgvr	alger
avgvry	avery
avgvst	august
avgvstv	august
avgvstyn	augustyn
avgynh	ageno
avhalvran	achaean
avhrmn	aaron
avjn	avon
avklnd	abend
avkly	ackley
avkr	ack
avkrayn	ackroyd
avkr	ack
avksly	ackley
avkstvn	agustin
avksvl	akil
avkt	ack
avkts	acts
avktz	savetz
avkynz	adkins
avkyts	abbys
avlafsvn	olafson
avla	ala
avl	akl
avlayvvla	layla
avld	auld
avldkvrn	aldan
avldrayt	abstract
avldryj	aldrin
avldz	aldo
avlmn	ajlun
avl	akl
avlsn	ailsa
avlsn	ailsa
avlsvn	abelson
avlsvn	abelson
avlvstad	avesta
avlyma	alima
avlyng	allyn
avly	aali
avly	aali
avlyvyh	aaliyah
avlyvyr	abley
avmaky	almaty
avmbrgr	amber
avmga	alma
avmlas	avilas
avmr	adar
avnat	aint
avn	ain
avnayza	ananda
avnayz	anay
avnglysta	anglesea
avng	ag
avnsty	avesta
avnsvn	anson
avnvskv	agnes
avnyl	anil
avnyl	anil
avnz	agni
avqvaq	aviva
avraham	avraham
avram	avram
avrayl	airay
avrays	abrams
avrayz	airay
avrayz	airay
avrbn	aaron
avrcard	abelard
avrdaln	aurdalen
avrfyvs	averys
avrgan	adrian
avrhan	adrian
avrhan	adrian
avrhart	carhart
avrhrt	abrupt
avrhv	aurho
avrklyvn	aurkleven
avrkny	aaron
avrlandv	armand
avrl	abel
avrlynz	allyn
avrma	adria
avrm	arm
avrmspvrdn	armstrong
avrn	avon
avrnvpn	aurnupen
avr	air
avrsbrg	augsburg
avrslr	akrill
avrts	arts
avrtyz	airay
avrvm	avram
avrv	adri
avrvyl	advil
avry	avery
avryga	arya
avryk	ark
avryl	april
avryl	april
avrynts	advents
avrys	averys
avrys	averys
avrys	averys
avry	avery
avryvly	airay
avryvn	aryan
avryvrdan	aryan
avryz	allyz
avsal	afzal
avsbvrn	agsorn
avsbvrn	agsorn
avslandr	auslander
avslyna	alana
avsn	avon
avsn	avon
avsnz	avins
avstbann	austbanen
avsthamarn	austhamaren
avstlyc	astley
avstndvrp	oostendorp
avstrandr	ekstrand
avstrndr	astrid
avstvlyn	allyn
avstvryn	austern
avstyn	alston
avsyvn	abyan
avsyz	allyz
avtagvrv	altair
avta	alta
avth	acts
avtjh	aetje
avtj	acts
avtlv	atle
avtlv	atle
avt	ait
avt	ait
avtry	avery
avtvlyny	allyn
avtv	acts
avtys	abbys
avvlyv	allyn
avvrdal	overdal
avvrpk	amtrak
avyan	abyan
avyars	adars
avycay	avichay
avyk	ack
avynas	alanas
avyng	avins
avynz	avins
avyrsa	aversa
avys	amys
avysna	alyssa
avyva	aviva
avyvn	abyan
avzbrn	agsorn
avzgvr	alger
avzmn	avian
avzvnys	albanys
ayala	ayala
aybac	aabar
aybar	aabar
aybl	aba
aybyrvnk	asbrink
aycas	abbas
aycbvrn	anckorn
aycyrv	accra
ayda	ayda
ayda	ayda
aydan	adan
aydmn	adan
aydnbvrg	rydberg
ayd	and
ayds	ayda
aydvaysvz	adametz
aydvry	abery
aydyd	addy
aydy	addy
ay	a
ayf	alf
ayfjh	ayah
ayfj	afa
ayfvfl	advil
ayfv	afa
aygan	ayman
ayglastvn	agustin
ayglstvn	agustin
ayglv	angle
aygly	angle
aygrt	agra
aygrtvn	agren
aygv	ag
aygvr	alger
ayjh	ayah
ayjlstvn	alston
ayjvyn	ajay
ayk	ack
aykam	abram
aykarvs	ankaras
aykbrn	agsorn
aykbvrn	akbar
aykh	ayah
ayklvzan	sylvan
aykn	ayn
aykvk	ack
aylana	alana
aylan	alan
aylka	ailsa
aylmyn	allman
aylpv	alpo
aylr	aylor
aylsa	ailsa
aylth	allah
aylvard	aylward
aylvr	aylor
aylvt	alva
aylvt	alva
aylvyza	aliya
aylya	alya
aylydyv	abley
aylyn	allyn
aylyn	allyn
aylyn	allyn
aylyng	ayling
aylyn	allyn
aylys	abbys
aylys	abbys
aylz	aali
aym	aim
ayman	ayman
ayman	ayman
aymantz	ayman
aymar	ayman
'aymn	ayman
aymn	ayman
aymn	ayman
aymry	abery
aymvn	ayman
aymy	amy
aynac	amna
ayn	ayn
ayna	amna
aynana	adana
aynan	ayman
aynarynv	aaron
aynat	aint
ayn	ayn
aynayn	anay
aync	ayn
ayndalys	andys
ayndayrsn	adars
ayndra	andra
ayndrajyt	indrajit
ayndranyl	indranil
ayndrly	andr
ayndsvrs	rynders
ayndvy	andy
ayngalz	agali
ayng	ayn
ayng	ayn
ayng	ayn
ayngld	angle
aynglf	angle
ayngl	angel
ayngls	angels
aynglys	angles
aynglys	angles
ayngmar	ingmar
ayngmar	ingmar
ayngraham	ingraham
ayngram	anagram
ayngrm	abner
ayngrsvl	abners
ayngrya	agra
ayngryd	ingrid
ayngrysl	abners
ayngrysvl	abners
ayngvar	ingvar
ayngyjd	aeneid
aynhv	ayah
aynjh	ayah
aynjjnry	ankeney
aynkh	ayah
aynkvgnyta	incognita
aynly	ainley
aynmn	amnon
aynr	ayn
ayns	anns
ayns	anns
aynsr	abner
aynt	aint
ayntayr	anntar
aynt	aint
aynth	aint
ayntj	aint
ayntjh	eyntje
ayntlsat	intelsat
ayntrnt	anant
ayntrnt	anant
aynvksn	anakin
aynvn	amnon
aynvsnt	advent
aynysa	anisa
aynz	ayn
aynzhnry	anchor
aynz	ayn
aynz	ayn
ayprsvn	amerson
ayprt	alpert
ayr	air
ayrardy	airay
ayray	airay
ayrbyd	abad
ayrd	aird
ayrdv	aird
ayr	air
ayr	air
ayrlaynz	adriaen
ayrl	abel
ayrlnd	arend
ayrnst	arnot
ayrnvt	arnot
ayrp	adri
ayrs	aprs
ayrvn	aaron
ayrvn	aaron
ayrvnsvn	aronson
ayrvvd	aird
ayrvyng	arling
ayrvyn	aaron
ayrvyn	aaron
ayrvyyn	aryan
ayry	abby
ayryk	ark
ayrys	ayres
ayryzary	airay
ayrz	adri
'aysa	ayda
aysa	ayda
'aysa	ayda
aysa	ayda
ays	acs
aysa	ayda
aysak	adisak
aysak	adisak
aysaks	assads
aysama	asama
aysan	ayman
aysask	abbas
aysbl	ayse
aysfalz	ayala
'aysh	ayah
aysh	ayah
'aysh	ayah
aysh	ayah
ays	acs
ayskandr	askanas
aysk	ask
ayslt	ayala
ayslyk	allyn
aysman	ayman
aysmn	ayson
aysnstat	aisenstat
ayspvrt	allport
aysrat	ararat
aysrt	art
aysrt	art
aystbrn	austern
aystlnd	alston
aystmas	asamas
aystmn	alston
aystmvs	alstons
aystragv	abstract
aystrbrvk	abstract
aystr	amster
aystr	amster
aystvvd	astrid
aystvy	rysavy
aystyk	astik
aystyn	alston
aysvn	ayson
aysvn	ayson
aysy	ayse
aysyzaky	rysavy
ayt	ait
ayt	ait
aytamar	itamar
aytcv	ac
aytcvn	active
ayth	ayah
ayth	ayah
aytj	acts
aytj	acts
aytjy	aetje
aytkn	acton
aytr	acts
aytsn	acton
ayva	alva
ayvald	ayala
ayvanz	ayman
ayvar	aabar
ayvayng	ayling
ayvgnh	advent
ayv	av
ayvjnh	advent
ayvlyn	allyn
ayvnd	abend
ayvns	adans
ayvrs	ayers
ayvrsvn	amerson
ayvry	abery
ayvs	avs
ayvs	avs
ayvstys	acostas
ayvsv	avs
ayvsyn	ayson
ayvtyk	astik
ayvyn	allyn
ayzak	afzal
ayzaksvn	abramson
ayzcyl	afzal
ayzdy	addy
ayz	ayn
ayzl	abel
ayzmn	ayman
ayzrvda	ayurveda
ayzv	av
azad	azad
azalya	azalea
azaly	aali
azana	azana
azar	adar
azbvrn	aabar
azcyl	zyl
azhr	azhar
azla	ala
azln	azlan
azr	air
azvr	adar
azycl	alyce
baabar	baabar
baafj	baal
baba	baba
baba	baba
babah	babah
babar	babar
babar	babar
bab	ba
bab	ba
bab	ba
babk	baba
babk	baba
babl	baal
babr	baba
babt	baba
babv	baba
babvrav	baburao
babvskyn	babushkin
baby	baba
baby	baba
baby	baba
babykv	babak
babyrl	babar
babytz	babitz
bacaltr	bacall
bacarac	bacar
bacas	bacar
bac	ac
bacldr	bacar
bad	abad
bad	abad
badkk	adik
badkvk	badrak
badlvc	adler
badmn	baden
badnyk	badrak
badr	badr
badrmn	badami
badryk	badrak
badvyn	baden
badvyyn	baden
bady	badr
badyg	baden
badyn	baden
badyn	baden
badyngtn	baldington
badyngtvn	baldington
badyvn	baden
badz	badr
badzyak	badrak
bafl	baal
bafy	afa
bafy	afa
baga	baba
bagam	adam
bagarly	baggarly
bagay	bugay
bagdan	adan
bagham	balham
bagly	bagley
bagly	bagley
bagm	baum
bagsav	bagga
bagvly	bagley
bagyd	bagade
bagz	baez
bagz	baez
bahyh	baath
bajva	bajwa
bajyk	babak
bakar	akar
bakas	backas
bakaya	bakaya
bakly	bally
baknr	baker
bakr	badr
bakr	badr
bakska	bakaya
baksr	baker
baksy	aksu
bakvm	bak
bakvs	bakos
baky	bak
bakyr	baker
balak	babak
balandr	badlands
balans	alans
balard	ballard
balary	alar
balas	balash
balast	balash
bal	al
bal	al
balbyr	balbir
balcvnas	balchunas
bald	bald
baldrd	baldred
baldvr	balder
baldyngtn	baldington
baldyngtvn	baldington
balfnz	balfanz
balga	bagga
balham	balham
balka	balkan
balkvsky	bilinsky
balma	balma
balmasda	balmaseda
balmr	balma
balndra	balendra
balny	bally
balsam	balsam
balsara	bulsara
balsk	alok
balsly	bally
balsvn	balson
baltaks	baltais
baltays	baltais
baltazar	balthazar
baltzl	ball
balv	bald
baly	bald
balyga	baliga
balyk	alok
balyn	balin
balyn	balin
balystyk	bialystok
balyt	balit
bambrgr	amber
bamn	bain
bamsv	bamse
bana	ana
banabyv	barnaby
ban	ba
ban	ba
band	and
bandd	banded
bandyrdy	badry
bandz	bandi
bangartz	bongarts
bang	bang
bangrz	bang
banklr	banker
bankraft	bancroft
bankrvft	bancroft
banks	banks
bankvala	bankwalla
banl	baal
banr	badr
bantvn	banton
banty	bandy
bantyng	banting
bany	bandy
bany	bandy
bany	bandy
banyta	anita
banytv	bantu
banyvra	andra
bap	ba
baptysta	baptista
baptyst	baptist
barakvta	barakat
baras	aras
barasv	barash
barat	baral
barbagalv	barbagallo
bar	bar
barbas	barbas
barbr	barb
barbvrak	barborak
barbvr	barber
barby	barb
bard	bard
bardvlvmz	bardell
bardyk	bandy
barf	bar
barfrd	barford
barfvrd	barford
barfyt	barff
barg	bang
bargs	bargh
bargvs	bargus
barh	bach
barjyl	banjul
barkalv	baikal
barkasfyld	barksfield
barkay	barkah
bark	bark
barkly	barkley
barkraft	barcroft
barkr	bark
barksdyly	barksdale
barksfyld	barksfield
barkvlv	barkell
barkvs	barkus
barlas	barlas
barl	baal
barl	baal
barlv	baal
barnaby	barnaby
barnam	barnas
barnard	barnard
barnas	barnas
barn	barn
barnd	bard
barnsa	bains
barnsav	barnas
barnsv	bains
barnt	barn
barny	barn
barnyk	bank
barqard	barnard
bars	ars
barsy	barry
barta	barta
bart	bart
bart	bart
barthvlvmyvs	bartholomeus
bartk	bark
bartkvr	barker
bartl	baral
bartl	baral
bartlmas	barlas
bartlmvs	bartelmus
bartlt	bartelt
bartlt	bartelt
bartly	bartle
bartmvs	antevs
bartn	barn
bartn	barn
bartvk	bartok
bartvlvmvs	bartelmus
bartvlvmyvs	bartelmus
bartvlyny	bartley
bartvn	barton
bartvnykv	bartley
barty	barry
barty	barry
bartyh	barth
bartys	martys
bartz	bartz
barva	barta
barvc	bajic
barvn	barn
barvn	barn
barvns	arons
barvnya	baronia
barvz	bartz
baryaks	aryans
bary	badry
bary	badry
bary	badry
bary	badry
baryngr	bryner
baryngtn	barents
baryngtvn	barrington
barys	barrs
basa	baba
bas	bas
bas	bas
baskar	baskar
baskrvyl	ackroyd
basky	bosky
basl	baal
basma	basma
basn	bain
basr	badr
bassa	basha
bassn	basin
bastard	bastard
bast	bart
bastyk	astik
bastylvs	basels
bastyn	aston
bastyn	aston
bastyn	aston
bastyvn	bastien
basval	baal
basv	bas
basv	bas
basvm	basem
basyl	basel
basylyka	basilica
basylysk	basilisk
basylyvs	babylons
basyn	basin
batals	baals
batan	banan
bat	bat
batl	baal
batlr	atle
batnat	banan
batn	bain
batra	batra
batrby	badry
batrs	barrs
batrss	barros
batrst	baptist
batrvrs	barrs
batrys	badry
batrz	batra
baty	bat
batyl	batel
batyng	bang
bava	ava
bav	av
bavcmp	bacar
bavdn	avon
bavdn	avon
bavdvyyn	bauduyn
bavdyn	baden
bavdyn	baden
bavdysyn	bauduyn
bavgmn	akgun
bavkam	avram
bavkvs	backas
bavm	baum
bavmgartnr	baumgartner
bavprs	aprs
bavry	badry
bavs	avs
bavyz	baez
baxvm	axum
bayard	bayard
bay	ba
bayda	bayda
baydn	bayda
bayfyld	alfeld
baykrastaf	amerasian
baykrztaf	barta
bayla	bayla
bayls	baals
bayly	bayly
baylyngsly	billingsley
baylyngtvn	alington
baylyv	bayly
baylz	bayla
baynvn	banan
bayprt	bart
bayr	badr
bayrd	baird
bayrn	barn
bayrn	barn
bayrtay	barta
bayrtyh	barth
bayrvn	barn
baysvt	basit
bayz	baez
bazby	buzby
bazby	buzby
bazt	bart
bbkak	babak
bbyt	abbot
bcldr	badr
bclr	bacar
bdal	baal
'bdalh	bdale
'bdallh	abdullah
'bdalrhman	abdalrahman
'bdalrhman	abdalrahman
'bdalrhmn	abdalrahman
'bdalrhmn	abdalrahman
'bdal'zyr	balzer
'bdal'zyz	abdulaziz
'bdhby	abby
bdkk	adik
bdkvk	adik
'bdl	abdul
bdlak	amlak
bdl	abdul
bdlvc	blvd
'bdl'zyz	abdulaziz
bdmy	addy
bdnar	bednar
bdrk	bark
bdryk	badrak
'bdval'zyz	abdulaziz
'bdvl	abdul
'bdvlrhmn	abdalrahman
bdyn	bryn
bdyra	bdira
bdyr	adar
bfj	afa
bgdad	baghdad
bgly	bagley
bgnvld	bagnold
bgvyl	beryl
bgyr	badr
bhamnd	brand
bhara	behara
bhnam	behnam
bhrv	bahro
bhst	best
bhyja	bahija
bjly	ajay
bka	aka
bkar	akar
bk	bk
bk	bk
bk	bk
bkdvr	badir
bkhvrst	amherst
bkmn	akin
bkmn	akin
bkmyr	emyr
bkr	bar
bkr	bar
bkr	bar
bkr	bar
bks	bks
bkt	bat
bkva	aka
bkvf	bev
bkvk	back
bkvy	bev
bkvyt	bakaya
bkvyyr	bayer
bky	bk
bky	bk
bkyngsal	bengal
bkyngsl	bengal
bkyngsyl	bengal
bkyr	akar
bkys	bks
bla	ala
blac	black
blaf	blal
blafs	blas
blaha	blaha
blak	bak
blaksvm	bakkum
blalak	babak
blal	blal
blal	blal
blam	blal
blamkh	black
blamy	alamo
blancard	blanchard
blanch	blanca
blansdan	blanstan
blansdn	blanstan
blanstan	blanstan
blanzdvn	blanstan
blas	blas
blasdn	basin
blask	blask
blasr	blair
blasy	blas
blasyvs	blasius
blavadnyk	blavatnik
blavyz	blatz
blayt	blatt
blaz	blaz
blazk	black
blazkyyvz	blazquez
bl	al
bldn	alan
bldrd	badr
bldvyjn	boldwijn
bldvyn	aldan
bldvyyn	aldan
bldyng	belding
bldyngtvn	baldington
blga	olga
blka	aka
blk	bak
blklnd	blokland
blkly	bally
blkmn	baken
blkmn	baken
blksvm	bakkum
blksyr	aleser
blkvl	blal
blnk	bank
blnkhvrn	blenkhorn
blnkv	bank
blnky	bandy
bls	als
bltbrg	barbra
bltrav	batra
blv	bev
blvc	blvd
blvhm	blohm
blvksvm	alves
blvm	blom
blvmbrg	bloomberg
blvmn	alvin
blvmnfld	blumenfeld
blvnsdvm	blunsdon
blvnsdvn	blunsdon
blvnzdm	blvd
blvrnj	alvin
blvskvm	blask
blvyn	allyn
blvz	blaz
blvzvm	blaz
blyk	alok
blyk	alok
blyn	bryn
blyn	bryn
blynda	lynda
blyngasly	baggarly
blyngtn	alington
blynkv	blank
blynkv	blank
blynkvv	blank
blyr	alar
blystvn	blystone
blyta	blyth
blyvys	levys
blyz	blaz
bnaksy	aksu
bnamar	benamar
bnan	banan
bnary	anay
bn	b
bndang	bandung
bndastvn	andaman
bndk	and
bndly	andy
bndr	andr
bndrvb	andr
bndy	andy
bng	bang
bng	bang
bng	bang
bngt	bengt
bnh	ana
bnjyman	benjiman
bnkr	abner
bnkr	abner
bnks	banks
bnr	bar
bns	bas
bnsn	ann
bnsn	ann
bnsvn	anson
bnt	bat
bnt	bat
bnt	bat
bntly	antley
bntn	ann
bntn	ann
bntv	bantu
bntvn	anton
bntz	bentz
bntz	bentz
bnya	alya
bnyamyn	andaman
bnyfasyvs	belfasts
bnyn	bryn
bnz	benz
bnzn	ann
bqyr	badr
brabant	brabant
braby	araby
bracmn	bacon
brad	brad
brad	brad
bradly	bradly
bradr	badr
bradrtn	braden
bradrtvn	barton
bradsav	brads
brady	brady
bradys	bradlys
brafvrd	bradford
bragham	braham
braham	braham
brahym	braham
brak	bak
brakly	bradly
brakny	brackney
brambav	baabar
bram	bram
bramr	bram
bran	bran
bran	bran
bran	bran
brandl	brand
brandy	brandy
brann	brain
bransav	brans
bransdvn	branden
branskvmb	branscombe
bransvyk	brandy
brant	brant
brant	brant
brardy	brady
brasard	brassard
brasayr	baabar
brasrz	basra
brasyrz	basir
brat	brat
bratlt	blatt
bratr	brar
bratyna	bratina
bravn	brain
bravn	brain
bravnfyld	bagnold
bravnr	beaver
bravnyng	brannen
bravtvn	banton
bravv	bravo
bravyc	brady
brayan	bryan
bray	bray
brayd	brad
brayn	brain
braynklr	banker
brayr	brar
brays	brays
brays	brays
brayslav	bayla
braysvn	brays
brayt	brant
braytn	braden
braytvn	banton
braytvyt	baptist
brazvn	braden
br	br
brbvr	arber
brca	ara
brcr	brar
brd	bard
brd	bard
brdly	bradly
brdly	bradly
brdly	bradly
brdn	bran
brdn	bran
brdn	bran
brdsang	birdsong
brdsav	badian
brdy	brady
brdyk	brady
brdyt	brady
brfvrd	barford
brganty	brandy
brgard	asgard
brgaylv	argyle
brg	berg
brg	berg
brgdan	bergman
brgland	berglund
brgl	aral
brgmn	begin
brgr	brar
brgs	borgs
brgs	borgs
brgsvn	bergson
brgyvt	argyle
brhan	behan
brj	br
brkah	barkah
brkaspyr	bakaya
brkat	brat
brkat	brat
brk	ark
brk	ark
brk	ark
brkly	bally
brksfyld	barksfield
brkt	brat
brkvl	bokel
brkvvyc	bakaya
brky	bray
brlacr	black
brl	br
brlnd	brand
brlsvn	balson
brlv	bald
brlyn	bruyn
brlyng	arling
brlyng	arling
brml	aral
brmn	bran
brmn	bran
brnadvs	bernadus
brnal	bernal
brnan	banan
brnard	barnard
brnard	barnard
brnardv	barnard
brnardy	barnard
brnardyn	bernardin
brnardz	barnard
brncavd	barnard
brnc	brno
brncly	bradly
brndan	brendan
brnd	bernd
brnd	bernd
brnd	bernd
brndl	bandi
brndl	bandi
brnds	bonds
brndvn	braden
brndy	bandy
brndy	bandy
brndys	brandys
brnhard	bernhard
brnhart	barnhart
brnhr	bernher
brnr	brar
brnsav	balsam
brnsv	bens
brnt	bernt
brnt	bernt
brnt	bernt
brnv	brno
brnvl	bernal
brny	bray
brny	bray
brnyr	bonar
brnz	benz
brq	br
brsav	barsai
brs	brs
brsfvrd	barford
brslav	berislav
brslr	basir
brsmn	basin
brsvn	basin
brsy	bray
brt	art
brtlsvn	balson
brtn	bran
brtrand	bertrand
brtr	brar
brts	arts
brtvn	barton
brtvn	barton
brtvn	barton
brty	bray
brty	bray
brtyh	barth
brvanhat	braham
brvark	bark
brvda	broda
brvd	blvd
brvdfyld	bradford
brvdhast	buddhas
brvdly	bradly
brvdr	badr
brvdrtvn	barton
brvhl	brohl
brvkav	brokaw
brvk	ark
brvk	ark
brvk	ark
brvk	ark
brvkn	bevan
brvknr	backer
brvkr	brake
brvks	banks
brvksl	baikal
brvkvl	baikal
brvkz	brake
brvmbrg	bromberg
brvmbrgr	bromberg
brvmfyld	brumfield
brvmly	bradly
brvmyj	brady
brvnl	bran
brvnr	bran
brvnvyyn	branden
brvnyyv	brandy
brvr	brar
brvsrd	baird
brvstr	brest
brvsyav	berislav
brvty	bruty
brvtzmn	brutzman
brvvr	brar
brvyk	bray
brvylv	argyle
brvyn	bruyn
brvyns	brains
brvynyng	browning
brvyr	brar
brvyr	brar
brvz	broz
brxard	bard
bryan	bryan
bryan	bryan
bryant	bryant
bry	br
bry	br
bry	br
bry	br
brybr	bayer
bry	br
bry	br
brydlav	bayda
brydvl	bryde
brydy	brady
brydyng	bandung
brygvy	bryguy
bryj	brij
bryj	brij
bryjmn	bryan
brykaspyr	backas
brykspyr	breakspear
bryl	beryl
brym	bram
brymr	bayer
brymstvn	brampton
bryn	bryn
bryn	bryn
bryndan	brendan
brynd	brand
bryndl	brand
bryngardnr	bringardner
bryngtn	bengt
bryngtvn	brenton
brynk	brink
brynkmn	brinkman
brynr	bryn
brynsn	brans
bryr	brar
bryr	brar
brys	brays
brys	brays
brysbyn	brisbin
brysbyn	brisbin
brysnv	bryan
brystvl	bristol
brysynda	brisinda
bryta	brita
bryt	brat
brytlyng	beutling
brytv	blyth
brytvn	breton
brytys	bettys
bryvn	bryan
bryvny	bryony
bryvr	bayer
bryvry	bryguy
bryykpr	breyer
bryytvn	brenton
bryza	arya
brza	ara
bsak	bak
bsam	besam
bs	bs
bsbrys	besbris
bskt	ask
bskv	ask
bsl	bs
bsma	asma
bsmy	amy
bst	bat
bsval	baal
bsvl	baal
bsvn	bain
bsyl	beyl
bsym	asim
bsyra	byra
bsyt	bart
btan	bean
btcldr	bacar
bthvn	behan
btl	btu
btmn	atman
btrys	barrs
btsy	betsy
btvl	atul
bty	btu
bty	btu
btyg	bang
btyyv	atiya
btza	betza
bvaly	baal
bvas	avas
bvay	bray
bvay	bray
bvayvyn	bayern
bv	av
bvby	abby
bvbys	abbys
bvca	ava
bvca	ava
bvc	bic
bvcga	bagga
bvda	beda
bvda	beda
bvdapaty	bodapati
bvdar	adar
bvd	blvd
bvd	blvd
bvd	blvd
'bvdhaby	abudhabi
bvdla	bodla
bvdn	avon
bvdn	avon
bvdnmylr	bednar
bvdra	andra
bvdrv	badr
bvdv	badr
bvdvr	badir
bvdvyn	baden
bvdy	addy
bvdyvn	baden
bvdyvyn	babylon
bvfalv	baal
bvgard	asgard
bvgham	balham
bvgs	bugs
bvhl	buhl
bvhr	bohr
bvjy	bray
bvkl	akl
bvkl	akl
bvkly	bally
bvkr	badr
bvksy	bekesy
bvkvn	baken
bvla	bela
bvlard	abelard
bvl	abel
bvldn	bald
bvldt	boldt
bvldvyjn	boldwijn
bvldzr	balder
bvlf	alf
bvln	avon
bvlr	badr
bvlr	badr
bvltan	balkan
bvltn	balin
bvltvn	bolton
bvlv	bald
bvlvc	blvd
bvlvs	balis
bvlvyjn	belvin
bvlyng	allyn
bvmbr	bambi
bvmbrgr	bomber
bvm	bum
bvmgardnr	bumgardner
bvmhard	bomhard
bvmn	avon
bvnandr	bonander
bvnar	bonar
bvnavglya	bonavoglia
bvn	ben
bvn	ben
bvngard	bongard
bvnstra	boonstra
bvntn	banan
bvnvmv	bonomo
bvnvnv	banan
bvny	bandy
bvnyfass	bunyans
bvnyfasyvs	beaufays
bvnyfkyvs	bangkoks
bvnyfyss	bennys
bvnyn	banan
bvnytz	bentz
bvqam	avram
bvra	byra
bvrad	brad
bvrap	avram
bvrascy	barack
bvr	bar
bvrcrt	barbra
bvrdr	badr
bvrdyk	bandy
bvrga	bagga
bvrg	berg
bvrgv	bargh
bvrgyvys	barbarys
bvrjya	arya
bvrkval	baikal
bvrkvl	baikal
bvrkvyl	barkell
bvrky	bark
bvrl	burl
bvrl	burl
bvrln	barn
bvrm	borm
bvrml	baral
bvrmn	barman
bvrsl	baral
bvrst	borst
bvrsyr	barber
bvrvs	barrs
bvryj	beryl
bvryl	beryl
bvryllv	berilla
bvrys	averys
bvryvn	bryan
bvryz	bartz
bvrz	baez
bvsa	busa
bvsal	baal
bvsart	bart
bvsarv	babar
bvsaysn	bayse
bvs	avs
bvs	avs
bvs	avs
bvs	avs
bvs	avs
bvs	avs
bvsca	basha
bvscga	boschga
bvsga	bagga
bvska	basha
bvsk	ask
bvsly	bally
bvsnl	basel
bvsny	benny
bvstak	bostak
bvstamnt	bustamam
bvst	best
bvstram	bertram
bvstrvm	bostrom
bvstvn	boston
bvstyk	bostak
bvsval	aviva
bvsvl	basel
bvsvm	basem
bvsvn	basin
bvsvr	basir
bvsvysn	averys
bvsy	avs
bvsy	avs
bvsyk	bosak
bvsysn	basin
bvsyvysn	boshuysen
bvtary	botari
bvtays	betsys
bvt	bat
bvt	bat
bvtcr	butch
bvtlr	butler
bvtrl	batel
bvtrs	barrs
bvtsyh	betsy
bvtvn	acton
bvtz	bitz
bvvdvyn	bauduyn
bvvn	avon
bvvy	bev
bvxny	benny
bvy	ivy
bvykv	boyko
bvyln	bayla
bvyr	badr
bvyrkvyl	barkell
bvys	abbys
bvys	abbys
bvysvyks	betsys
bvysyv	bayly
bvyvn	bryan
bvyzy	bayly
bvzancyv	bandy
bvz	av
bvzkart	bozkurt
bvzman	barman
bvzva	aviva
bvzval	afzal
bvzvva	aviva
bvzvvyl	beryl
bvzydar	bayda
bvzyd	boyd
byakv	bak
byan	abyan
byang	bang
byangtay	byungtae
byatlyng	beutling
byavys	beavis
by	b
bybl	baal
bybr	byer
bycam	bacar
byc	bic
bycly	bally
bycmp	bacar
bycyngsyl	byungse
bycz	bach
byda	ayda
bydl	ayda
'byd	abad
bydv	ayda
bydvl	abdul
bydy	addy
byf	alf
byfjh	ayah
byfrast	bifrost
byg	big
byglhl	bagley
bygnd	bernd
bygnvald	ragnvald
bygv	bev
bygvrdan	bigourdan
bygz	baez
byhan	behan
byhyv	bahai
byj	ayn
byjh	ayah
byka	byra
bykard	bard
byk	bak
byk	bak
byk	bak
byk	bak
bykly	bally
bykn	abyan
byknst	bains
bykrastaf	krista
bykrastafy	bastard
bykrastf	ballast
bykrastyf	grasty
bykr	byer
bykrstf	borst
bykrtn	byron
bykslr	baker
bykvl	bokel
bykvn	baken
bylal	bilal
bylany	billany
byl	beyl
byl	beyl
byl	beyl
bylhar	bilhar
bylky	bally
bylngtvn	byungtae
bylr	byer
bylr	byer
bylr	byer
byls	byles
bylv	bald
bylykvk	balike
bylyngaslay	billingsley
bylyng	ayling
bylyngsly	bilinsky
bylyngtvn	alington
bylyngz	ayling
bylynsky	bilinsky
bylyr	byler
bylz	baez
bylzybab	balzac
bymn	lymn
bymyng	byung
byn	ayn
byn	ayn
byn	ayn
byn	ayn
byndmn	bygden
bynfng	bynon
byng	bang
bynh	ayah
bynjn	bynon
bynmdart	bainmedart
bynqam	annam
bynr	byer
byns	bens
byns	bens
bynvd	binod
bynvy	bandy
byny	ayn
byny	ayn
byny	ayn
bynyyvn	bunyan
bynz	benz
bynz	benz
bynz	benz
bypyn	bipin
byra	byra
byr	bar
byr	bar
byr	bar
byr	bar
byr	bar
byrbk	barb
byrc	byra
byrd	byrd
byrd	byrd
byrdmr	border
byrdn	byrd
byrfys	brays
byrg	berg
byrgl	baral
byrk	bark
byrla	byra
byrmn	byron
byrnbvym	barnaby
byrn	barn
byrnh	byrne
byrns	berns
byrtay	barta
byrt	bart
byrtryk	barry
byrtyh	barth
byrtyh	barth
byrvt	bart
byryc	beryl
byryganty	briganti
byryng	bering
byrz	byra
bysayv	bakaya
bys	bas
bysh	bush
byskmp	basem
bysl	ayse
bysly	bally
bysmark	bismark
bysm	ayse
bysr	byer
bystandr	bystander
byst	best
byst	best
bysyn	ayson
bytankrt	bank
bytard	bard
byt	bat
byt	bat
bytmn	batman
bytn	abyan
bytrays	brays
bytryk	amtrak
bytz	bitz
byvan	bevan
byv	bev
byvcamp	basecamp
byvcmp	bacar
byvdvyn	bauduyn
byvfyz	buffy
byvgam	avram
byvkmp	back
byvkraft	kraft
byvly	bally
byvlyv	bally
byvmnt	advent
byvmvnt	belmont
byvngs	byrnes
byvr	byer
byvrly	beverly
byvrz	byer
byvsh	ayush
byvtl	advil
byvys	brays
byvzvyl	beryl
byyvcmp	basecamp
byyvnyk	bryony
byz	ayn
byzr	byer
byzvanat	azana
byzvas	akivas
byzvyl	beryl
byzyr	bizer
bzva	alva
cagn	cage
cakv	aka
calk	cal
cambrlayn	cambrian
camplyn	campey
cand	and
candran	chandran
candr	andr
candvnya	candy
cansy	candy
cany	candy
capla	cala
capl	cal
capmn	cadman
capra	capra
capyn	ayn
card	bard
carltn	carlin
carltvn	carlton
carlvt	arlet
carly	carly
carlyh	carly
carlyn	carlin
carlz	carl
carng	charng
cartvn	barton
caryk	cary
cas	cas
casmz	asma
castyn	aston
catany	castano
cav	av
cavda	chavda
cavhan	avian
cavn	cain
cavvyn	calsyn
cavvyv	calsyn
cavz	cave
cay	ca
caykn	ayn
cayld	auld
cayldz	aldo
cayz	ayn
ch	c
ckrd	aird
clatvn	clamen
clyvs	claus
clyyan	cayman
cmaly	amal
cmbrlyn	charlyn
cmbrz	cabre
cmbzy	abbey
cnadr	andr
cn	c
cnd	and
cndlr	ander
cnslvr	ansley
cnth	beth
cny	coy
cpdy	cody
cpz	apr
crag	craig
craskaynt	prashant
crbl	aral
crc	cr
crcyl	cecil
crpy	cray
crskynay	askanas
crvbyny	cerveny
crvyc	cray
cry	cary
cry	cary
cryl	aral
cryskynty	brackney
crystal	crystal
crysynth	bryant
csbrv	cabre
cs	cs
csny	candy
csny	candy
cstr	aster
ctal	cal
ct	at
ctvyn	kevyn
cva	ava
cva	ava
cv	av
cv	av
cv	av
cv	av
cv	av
cvdhary	adhara
cvkry	avery
cvksy	aksu
cvlka	cala
cvn	ain
cvnpyg	candy
cvrn	avon
cvsak	bosak
cvvanak	chovanak
cvy	coy
cvy	coy
cvylr	coyle
cya	ca
cya	ca
cyaky	cary
cyang	chang
cybansky	cybanski
cy	c
cy	c
cycstr	caesar
cyk	cyr
cyk	cyr
cyk	cyr
cykn	ayn
cykry	camry
cyky	cary
cykz	coke
cyldz	aldo
cylt	celt
cylth	celt
cyltj	celt
cyltjh	aaltje
cyly	lyly
cylyjh	blyth
cylyngvrs	ayling
cylyngvrt	ayling
cym	cm
cyn	ayn
cyn	ayn
cynn	conn
cynv	ayn
cyp	cyr
cyp	cyr
cyplvydn	calsyn
cypmn	lymn
cypn	ayn
cyrag	byra
cyrak	byra
cysm	ayse
cysmn	ayson
cysty	casey
cysvlm	anselm
cyta	alta
cytam	coram
cytan	ayman
cyt	cat
cyt	cat
cytrdy	cordy
cytvvd	active
cytvyn	calsyn
cytyk	astik
cyv	cyr
cyv	cyr
cyzvba	chavda
cyzv	cyr
cyzvrv	cyr
dabac	aabar
dabas	dadas
dabl	dahl
dabny	dabney
dabs	dais
dabsvn	dabin
dabvs	abes
dabvys	abbys
dabyl	daryl
dabynsky	dubinsky
dabynsn	dobyns
dabynsvn	dobinson
dabynz	dabin
dada	dada
dad	dada
dadgyvn	dady
dadh	dada
dadk	dada
dadly	dady
dads	dada
d'a	dea
dadv	dada
dadyr	dady
daf	dag
dagan	dagan
dagan	dagan
dag	dag
dag	dag
dag	dag
dagly	dagley
dagn	dag
dagr	dag
dagrty	dagley
dagrz	agra
dagvac	dagan
dagz	dag
dahak	dahar
dahaml	bahama
dahn	dahl
dahrty	darby
dahvd	dahar
dahvk	dahuk
daj	dag
daj	dag
dajyvn	abyan
dakas	dadas
dak	bak
dak	bak
dak	bak
dakhvrn	ahern
daklvz	akiva
dakmn	dakin
dakn	dakin
dakryng	akron
daks	dais
daks	dais
daktrz	dakar
dakv	aka
dakvrs	dakars
dakyng	dakin
dakynz	dakin
dakz	danz
dalajr	alar
dalan	alan
dalas	dadas
dalayr	alar
dalbk	alba
dalbrgr	alber
dalbyr	alber
dal	dal
dal	dal
dal	dal
dalfr	alar
dalmn	adalma
dalms	adalma
dalmyya	dalmia
dalnz	danz
dalrs	adars
dalrympl	dalrymple
daltvn	dalton
daly	daly
daly	daly
daly	daly
daly	daly
dalynar	dolinar
dalyngr	dalager
damar	dahar
dambl	amal
damlr	amir
dampltvn	dalton
damvn	damon
damvntt	damon
damyan	damian
damyanv	damian
damyla	bayla
damyngs	damons
damyny	damon
damynykas	amandas
damytrv	datri
damyvn	damian
dana	dana
danald	danald
dana	dana
danavan	canaan
dan	dan
dandas	dadas
dan	dan
dan	dan
dan	dan
dandy	andy
danfrd	danald
danfy	dancy
dang	bang
dang	bang
dangtay	dongtai
dangvy	dancy
dangyv	dancy
dangyvn	angevin
danham	denham
danh	dan
danjl	anil
dankan	balkan
dankv	danko
dankv	danko
danky	dancy
danlvp	dunlap
danly	daly
dannbargr	danenbarger
dannly	danny
danr	dan
dansmvr	dancer
danstr	dancer
dansy	daisy
dansyng	dancing
dantn	dante
danvan	banan
dany	dady
dany	dady
danydyn	andy
danyl	daryl
danyl	daryl
danyl	daryl
danylsvn	danielson
danylv	danald
danylz	danald
danys	danas
danyyls	danials
danz	danz
dapay	papay
dapnyk	danny
daprk	apr
daprry	barry
dapry	apr
darang	dagan
dara	ara
darby	darby
dar	adar
darham	durham
darl	carl
darly	carly
darlyngtn	darlington
darnal	darnall
darnl	daryl
darnl	daryl
dart	dart
darv	dare
darvn	daren
darygvs	daryls
daryl	daryl
das	das
das	das
dasn	dan
dasvn	basin
dasyng	ayn
dasyvk	ashok
dat	at
dath	darth
datjh	daatje
datry	datri
datsvn	dawson
datvn	dabin
datvyt	davy
daty	dady
daty	dady
davad	davao
davark	dahar
davbr	dahar
davd	daud
davd	daud
davd	daud
dav	av
dav	av
dav	av
davknyz	danny
davkynz	dakin
davn	dan
davnprt	davenport
davny	danny
davnyng	dawning
davnyng	dawning
davrs	daves
davryn	dacron
davsan	avian
davs	avs
davsn	avon
davsvn	davison
davt	dart
davvd	david
davvd	david
dayal	dalal
dayan	dagan
dayan	dagan
dayanysya	dannys
dayanysys	cabaniss
dayaz	ayah
daybala	ayala
daybl	dahl
daycync	dancing
day	day
day	day
daydryc	badry
day	day
dayk	day
dayksvn	ayson
dayky	bayly
daykynk	dakin
daykynz	dakin
daylaygan	malayan
daylvn	dallan
daymnd	dymond
dayn	ayn
dayn	ayn
dayr	dayr
dayrdryk	darryl
dayr	dayr
dayrktvr	arter
dayrt	dart
days	dais
dayt	dart
dayvd	daud
dayvrjh	darth
dayvrjh	darth
dayvrt	dart
dayvrth	darth
dayvrtj	dart
dayvrtj	dart
dayvrya	arya
dayvvn	darvon
dayvyn	darvon
dbatvnya	latonya
dblr	able
dbyt	bat
ddfyld	alfeld
ddjn	adan
ddryk	daryl
ddy	addy
dfrvy	darby
dgly	daly
dgraf	graf
dgrf	agra
dgrlvnd	borland
dgvtardy	degotardi
dha	dea
dhamar	dhamar
dhnr	cher
dhnrt	dart
dhvk	chik
djamyla	djamila
djly	daly
dkan	dan
dkk	dik
dklrk	dierk
dkr	dr
dkstr	dikstra
dkyah	ayah
dky	day
dk	bk
dlal	blal
dlany	alan
dl	al
dlh	al
dlman	dolman
dlny	clay
dlrd	aird
dlryv	daryl
dltn	alan
dltvvya	deltuvia
dlvra	alva
dlvryz	allyz
dlvys	alves
dly	daly
dlykatny	delikatny
dlys	alps
dlysyv	alyson
dma	ama
dma	ama
dmkak	amlak
dmkh	demke
dml	dal
dmlr	amir
dmn	dan
dmpstr	dempster
dmr	dr
dmrz	danz
dmsq	ams
dmyla	bayla
dmynysvs	dionysus
dmys	amys
dnald	danald
dnaqy	anay
dnavlt	denault
dn	d
dndlr	ander
dn	d
dndryj	andr
dng	dag
dnham	denham
dnjvr	anbar
dnkvaltr	dakar
dnkynd	anand
dnl	dal
dnmn	ann
dnnl	anil
dnryj	daryl
dnsr	andr
dntvn	anton
dnv	dov
dnvks	daves
dnyh	danih
dnyl	anil
dnylz	doyle
dnyng	deng
dnys	amys
dnysvn	dyson
drabk	drabek
dradr	drader
dragan	dragan
draganys	draganis
dragn	drag
dragr	drag
drakmn	dakin
dral	aral
dralt	aral
dramatys	dramatis
dram	bram
drap	drag
drapr	draper
drast	aras
dratmn	dratman
draty	araby
dravn	brain
dravr	brar
draynh	draine
drayr	dayr
drbs	debs
drby	darby
drcmn	drown
drdh	arch
drg	dag
drgvmyr	dragomir
drgvn	dagan
drgvns	dragons
drk	ark
drksl	dekel
drmvt	drout
drnal	aral
drnk	drnek
drntr	dante
drsnr	drano
drtcn	draco
drth	darth
drv	dov
drv	dov
drvdyng	druding
drvdys	drudis
drvmand	armand
drvmr	diver
drvny	danny
drvnys	dannys
drvr	dror
drvt	art
drvyk	davy
drvyt	davy
drvzn	darvon
drydjy	dryden
dryfvs	dreyfus
dryjr	dayr
dryk	ark
dryk	ark
drym	drum
drymr	dayr
drymz	drum
drynks	drinks
drynz	bryn
dryr	dayr
dryry	drury
drys	amys
dryskvl	crystal
dryskyl	crystal
dryv	arya
dryv	arya
dryvt	drout
dryxa	arya
ds	ds
dsl	dal
dsmvlynz	devlin
dsmvnd	desmond
dsmyt	desmet
dsnvyrz	denver
dsrazyrs	brays
dsrvzyrz	carver
dstly	astley
dsvtv	adsett
dtlfs	adolfs
dtmn	atman
dtryj	daryl
dts	ats
dtvylr	daryl
dva	ava
dvak	ava
dvalybay	alba
dvan	dan
dvanyr	dayr
dvar	dear
dvarth	darth
dvaykynk	dakin
dvbay	dubay
dvbratz	dobbratz
dvbrydj	bryde
dvbrykyn	dobrikin
dvbryz	avery
dvbsvn	dobson
dvbvys	debbys
dvbynsvn	dobinson
dvbynyn	bynon
dvbyr	dayr
dvcarm	arm
dvcaylard	duchaylard
dvct	daco
dvcync	dobyns
dvda	dada
dvdamany	dodamani
dvd	and
dvdgvn	dodgen
dvdj	dada
dvdl	advil
dvdly	dady
dv	av
dv	av
dvfvr	avior
dvgan	dagan
dvgan	dagan
dvg	dag
dvgyvn	dagan
dvha	doha
dvhh	dahl
dvhrty	doherty
dvhvr	dahar
dvhyrst	amherst
dvjn	avon
dvk	dik
dvk	dik
dvlan	dilan
dvl	dal
dvlkya	aliya
dvlman	dolman
dvlr	dal
dvly	daly
dvlyn	allyn
dvmba	domba
dvm	dem
dvm	dem
dvmn	avon
dvmnykv	domeyko
dvmykv	demke
dvmykz	demke
dvmyngv	deming
dvmynykas	dominicas
dvmynyk	dominy
dvmynyk	dominy
dvmynyks	armonks
dvmynykyvs	minskys
dvmynyn	dominy
dvmynyvs	damons
dvnacy	dancy
dvna	dana
dvnald	danald
dvnat	dana
dvnatv	donath
dvnaty	donath
dvnay	anay
dvn	dan
dvn	dan
dvng	deng
dvnham	denham
dvnkn	danko
dvnly	daly
dvnpk	drnek
dvnpyk	dancy
dvns	dons
dvntsk	donetsk
dvnvan	denman
dvnyny	danny
dvnys	danas
dvpalm	depalm
dvplr	advil
dvplt	adept
dvpry	avery
dvpyvys	averys
dvra	dora
dvrand	durand
dvrand	durand
dvran	doran
dvran	doran
dvrapt	durant
dvras	doras
dvrasy	doras
dvrath	barath
dvraty	airay
dvravks	baracks
dvraya	vaya
dvrazyv	dorazio
dvrcak	demcak
dvrcn	darcy
dvrdal	dordal
dvrfman	dorfman
dvrham	durham
dvrkn	daren
dvrkyn	dorken
dvrl	advil
dvrld	darla
dvrma	dorma
dvrnd	bernd
dvrnd	bernd
dvrn	dorn
dvrn	dorn
dvrrans	darrens
dvrst	borst
dvrsy	daisy
dvrsy	daisy
dvrtcn	barton
dvrt	dart
dvrth	darth
dvrtj	dart
dvrtjh	darth
dvrtvn	barton
dvrty	darby
dvrty	darby
dvrvc	dirac
dvrvty	bruty
dvrvyn	darvon
dvry	dory
dvrynda	dorinda
dvrys	averys
dvrys	averys
dvrysvmy	dorsey
dvs	avs
dvskv	dusko
dvsn	avon
dvstalyk	dostalik
dvsty	dusty
dvta	alta
dvvaykynk	dakin
dvvl	advil
dvy	davy
dvykynk	dykins
dvykynk	dykins
dvyn	avon
dvyndr	andr
dvyny	danny
dvynyng	dawning
dvyr	dayr
dvysr	dayr
dvyt	dart
dvytv	blyth
dvyvyr	davy
dvyykynk	duyckinck
dvzat	duzat
dvzyyr	dayr
dyab	diab
dya	dea
dya	dea
dyala	ayala
dyamantaras	diamantaras
dyamdy	dady
dyamvnd	diamond
dyana	dana
dyan	dan
dyaz	diaz
dybat	bat
dybath	debathe
dybatvnya	debathonia
dyb	dib
dybl	dahl
dybt	dart
dybtvnya	divya
dybv	debs
dybyt	abbot
dycyr	cyr
dyda	ayda
dy	d
dy	d
dy	d
dydrysz	dyers
dydryx	badry
dydyrycs	cedrics
dygan	dagan
dygazmn	dagan
dygh	ayah
dygnarv	dagnall
dygraf	degraff
dygrf	dyer
dygrv	dyer
dygv	dag
dygvyd	david
dykanynk	danny
dykavty	davy
dyk	dik
dyk	dik
dykl	akl
dykns	dykes
dyknz	danz
dyknz	danz
dyksay	daisy
dyks	dykes
dyksn	dakin
dykstra	dikstra
dyksvn	dyson
dyksvn	dyson
dykv	dik
dykv	dik
dyky	dady
dyky	dady
dykynz	dykins
'dyl	adel
dylan	dylan
dylayr	dayr
dyl	dal
dylma	dilma
dyln	dylan
dylny	daley
dylr	dyer
dylvrs	dyers
dyly	daly
dyly	daly
dylyngr	ayling
dylyngtn	alington
dylyp	daly
dylyp	daly
dylyv	daly
dymad	ahmad
dyma	dema
dyma	dema
dymars	demars
dymarst	demarest
dymaryp	dimaryp
dymas	dumas
dymask	dumas
dym	dem
dymn	lymn
dymrs	dyers
dymsak	demcak
dymvk	ayman
dymyng	deming
dymytar	dimitar
dymytry	dimitry
dymytrys	dimitris
dymytryv	dimitry
dymytryv	dimitry
dymytryvs	demetrius
dyna	dyna
dyna	dyna
dyna	dyna
dynamyt	dynamite
dynbym	dancy
dyn	ayn
dyn	ayn
dyn	ayn
dyng	deng
dynglv	angle
dyngsvr	dingsor
dyngy	dancy
dyngy	dancy
dynl	dyna
dynlr	dinler
dynn	dinn
dynpyk	dancy
dynr	dyer
dyns	dons
dyns	dons
dynsmvr	dinsmoor
dynt	dent
dynv	dyna
dyny	dyna
dynyngr	denyer
dypak	dipak
dypayvla	depaola
dypayvlv	depalm
dypbvy	darby
dypld	apple
dyprsyv	dyers
dyprtr	cyprus
dypytrv	datri
dyr	cyr
dyr	cyr
dyr	cyr
dyrdrk	byrd
dyrdryk	darryl
dyrk	dirk
dyrk	dirk
dyrks	dirks
dyrvkv	darvon
dyrvrtj	darrel
dysantv	desanto
dysav	desai
dysay	day
dys	das
dysgy	dusty
dysmvnd	desmond
dysnt	dent
dystl	distel
dytjy	sytje
dytmar	delmar
dytr	dyer
dytvrz	datri
dytvtala	ditutala
dyva	dyna
dyvakarvny	divakaruni
dyvanatan	devanathan
dyvan	dylan
dyvar	dahar
dyvayn	dylan
dyvayn	dylan
dyvayzr	dayr
dyvha	divya
dyvn	ayn
dyvnh	dyna
dyvnpk	drnek
dyvnyda	dionida
dyvrt	dart
dyvrt	dart
dyvrth	darth
dyvrtj	dart
dyvrtjh	darth
dyvrtjh	darth
dyvvsr	daves
dyvya	divya
dyvy	davy
dyvyd	david
dyvyd	david
dyvyd	david
dyvy	davy
dyvydsvn	davidson
dyvydyan	davidian
dyvyldh	danald
dyvys	daves
dyvysn	daves
dyvysvn	davison
dyvyt	davy
dyyala	diyala
dyzny	danny
dyzr	dyer
dyzvn	dizon
dz	d
dzgagnh	dagan
fablr	faber
fabrh	fabre
fabrv	fabre
fabrys	fabris
fabyanv	abyan
facs	acs
fad	fac
fadl	fadl
fadnbrg	fabbro
fadvr	adar
fadyla	fadila
fadyl	fadil
'faf	afaf
fagan	fagan
fagans	fagans
fajn	fan
fajyvar	hajar
faks	fays
falcvk	falchuk
falk	falk
falknr	falk
falkrsvn	fulkerson
falkv	falk
falkvnr	balkan
faln	falk
falsam	balsam
faltak	foltak
faltls	fales
faltvn	alton
falvn	alan
faly	daly
falyvt	salyut
falz	faiz
famyvs	amys
fandryc	fandrich
fang	bang
fangvs	angus
fants	kants
fara	ara
farag	farag
faragv	farag
farat	fafat
farkas	farkas
farl	carl
farly	carly
farmr	farer
farsbrg	forsberg
farst	farsi
fartk	ark
farvanya	carranza
farvanyah	farwaniyah
farvgya	arvola
farvk	ark
farvk	ark
farvq	farag
farvz	ariz
faryd	farid
fary	cary
faryha	fariha
faryvr	farer
fasbrg	fabbro
fas	as
fas	as
fasl	fadl
fatyma	fatima
fatys	fates
favaz	fawaz
favl	fadl
favns	anns
favns	anns
favst	fast
favst	fast
favst	fast
favst	fast
favzya	faiza
favzy	davy
favzyya	fawziyya
faxry	farry
fayf	fay
fayk	falk
fayls	fayes
fayn	ayn
faynk	fayne
faynly	bayly
faynrty	fanny
faynstvn	mayston
fayntvn	paynton
fayrbank	fairbank
fayrvz	fairuz
fayt	fast
fayyz	fayiz
fayza	faiza
fayz	faiz
fayz	faiz
fayzl	fadil
faza	faiza
faz	fac
fazl	fadl
fazya	alya
fazy	fay
fazy	fay
fbrv	bev
fcnr	cr
fdl	fadl
fdr	dr
fdr	dr
fdrl	adel
fdrmn	fermi
fdvr	adar
fdyla	adela
fdyl	adel
fhd	fahd
fht	ait
fk	bk
flaglly	bagley
flahrty	flaherty
flakygr	laky
flardynga	flardinga
flat	flat
flat	flat
flavka	alaska
flay	clay
flaygyr	fanger
flays	fays
fldman	feldman
fldmar	feldmar
fldmn	aldan
fldr	flor
fldspar	feldspar
flj	fla
flk	falk
flkynz	flynn
flmr	flor
flsty	dusty
flth	alta
fltj	alta
fltjh	fatah
fltyv	floyd
flvch	bloch
flvdyn	flodin
flvra	flora
flvr	flor
flvr	flor
flvrk	clark
flvrns	alvins
flvrs	alars
flvry	flory
flvryn	flory
flvrz	flor
flvt	flat
flvvrz	alvarez
flvyd	floyd
flyjh	blyth
flyks	fayes
flykyngr	fleming
flym	fly
flymyng	fleming
flyndrz	flanders
flynt	flint
flyny	flynn
flysz	elyse
flyvry	fleury
flyzardv	felizardo
fmmth	faith
fmt	fm
fmtj	fm
fmya	alya
fncarc	anbar
fndr	andr
fn	f
fn	f
fng	eng
fngr	andr
fnr	fr
fnsky	bosky
fntvn	anton
fntyman	fentiman
fnvyk	anay
fny	fay
fnys	fays
fra	afra
fragvrgya	frageorgia
fram	bram
framsan	framson
framsvn	framson
frandsn	frandsen
fran	fran
frangakys	frangakis
frankl	frank
frankl	frank
franklyn	franklin
frankv	frank
frankv	frank
frankvy	frank
frankvys	francoys
frankvyz	francoys
frans	frans
fransr	frans
franssydtj	franscyntje
fransvyz	francoys
fransyka	fransiska
fransyntay	francyntie
fransynth	francyntie
fransyntjh	franscyntje
fransynty	francyntie
fransyntyh	francyntie
fransyntz	francyntie
fransyska	fransiska
fransyska	fransiska
fransyskas	fransiska
fransyskvs	fransiska
fransysyvs	franciscas
frantysk	frannys
frantzn	frantzen
fraq	fran
frary	araby
frasr	fraser
frast	fast
frasty	grasty
frayda	ayda
fraydman	freedman
fraydmn	braden
fraydy	brady
fray	bray
fraygrsa	fritgersa
fraytgrsa	fritgersa
frazr	frazer
frazyr	frazer
frazyyr	frazer
frda	freda
frdaynnd	franny
frd	fed
frdkyn	fradkin
frdrkyng	frederking
frdryk	fredrik
frdryk	fredrik
frdryk	fredrik
frdryk	fredrik
frdrykv	fredrik
frdt	art
frdya	freya
frdy	frey
frdy	frey
frdyg	ferdig
frg	fr
frgt	argo
frgvsn	argos
frh	fr
frj	fr
frjn	fran
frlang	arling
frly	fly
frm	arm
frnands	armands
frnandv	fernando
frnandz	fernandez
frnasyskas	fransiska
frnasyskaz	fransiska
frnc	arne
frnk	fink
frnk	fink
frnkh	finch
frnkl	fink
frnkl	fink
frnklyn	franklin
frnksvn	frankson
frnkvys	fannys
frnkvyz	funky
frnsaynt	anant
frns	ferns
frnsnyt	ernst
frnsnyt	ernst
frnsvys	fannys
frnsynty	ernst
frnsyska	fransiska
frnsyska	fransiska
frnzl	franz
frq	fr
frr	fr
frsr	frs
frtyk	fertik
frvanyah	farwaniyah
frvanyh	branch
frvk	ark
frvk	ark
frvmyn	bremen
frvnyah	arunah
frvz	ariz
frybrg	drying
fryda	freda
frydbrgr	rydberg
fryd	fred
frydgyr	bridger
frydh	bryde
frydl	bryde
frydmar	feldmar
frydmn	dryden
frydmn	dryden
frydryk	fredrik
frydyn	dryden
fry	fry
fry	fry
fryha	arya
fryks	fryes
frylnd	freund
frylyng	arling
frylyngr	arling
frylz	fayiz
frymal	freemal
frymvt	bryant
fryngtvn	alington
frynk	frank
frynk	frank
fryr	fry
fryr	fry
fryrmat	fermat
frys	fays
frys	fays
frys	fays
frytag	freitag
frytas	fredas
fryt	fry
frytgrsa	fritgersa
frytn	aryan
fryts	frits
frytv	frith
frytvl	crystal
frytzyvs	fritzius
fryvald	freiwald
fryvvgl	crystal
fryz	fry
fryzr	frazer
fryzr	frazer
fsdal	fosdal
fst	fast
fsyg	fasig
ftc	fac
ftcn	eton
ftra	fera
ftr	fr
fvd	fed
fvjy	fay
fvjyta	fujita
fvjyvka	fujioka
fvkv	fike
fvldz	aldo
fvlgam	algae
fvlkanys	albanys
fvlk	falk
fvlks	fales
fvlmn	ajlun
fvln	avon
fvlr	fair
fvlr	fair
fvly	fly
fvmrtvn	fumerton
fvndal	fundal
fvndv	fonda
fvngn	feng
fvng	feng
fvnky	funky
fvntnvt	fontenot
fvn	fan
fvnyvk	fenyes
fvrbs	fares
fvrbz	ariz
fvrd	ford
fvrdham	fordham
fvrdsandn	furdesanden
fvrjy	farry
fvrk	fork
fvrlang	furlong
fvrmn	fermi
fvrmn	fermi
fvrnr	farer
fvrny	fanny
fvrny	fanny
fvrnyr	fafnir
fvrr	furr
fvrrv	farry
fvrsayt	fermat
fvrsayt	fermat
fvrsblam	forsblom
fvrsbrg	forsberg
fvrs	frs
fvrsyl	beryl
fvrt	art
fvrts	forts
fvry	fry
fvsng	fasig
fvt	ait
fvtrr	fetra
fvts	acts
fvtynvs	flynns
fvy	fay
fvys	fays
fvyy	fay
fvzard	figard
fvzy	fay
fvzyh	faith
fxrya	arya
fxry	fry
fxryya	freya
fxyr	cyr
fyaban	fabian
fyaksy	aksu
fyaskvnarv	fiasconaro
fybr	br
fydalgv	fidalgo
fydl	fadl
fydlr	fadl
fydvr	feder
'fyf	afaf
fygard	figard
fygvra	figura
fyhan	afghan
fyk	ack
fyks	bks
fylaks	dylans
fyl	zyl
fylk	falk
fylpat	flat
fyl	zyl
fyl	zyl
fylps	alps
fylr	aylor
fylvs	byles
fylvz	allyz
fylyas	filias
fyly	fly
fylyp	fly
fylyps	alps
fylyps	alps
fylz	elz
fymtjh	eyntje
fymyjh	myth
fynan	finan
fynan	finan
fync	sync
fyn	ayn
fyn	ayn
fynk	fink
fynkl	fink
fynly	fanny
fynly	fanny
fynly	fanny
fynstad	finstad
fyny	ayn
fynyn	bynon
fynys	fannys
fy	f
fyps	alps
fyrbnks	franks
fyrbryn	bryn
fyr	cyr
fyrhrst	fairhurst
fyrma	firma
fyrn	fern
fyrvdr	byrd
fyrvk	fork
fyrvz	ariz
fyrvz	ariz
fysbyn	ayson
fys	fays
fys	fays
fysk	fisk
fysr	ayse
fyta	alta
fytc	fac
fytzjrald	fitzgerald
fytzvl	faizel
fyvr	byer
fyvstl	faisal
fyza	ayda
fyz	fez
fyzh	ayah
fyzl	fadl
fzya	alya
gaba	gaba
gabara	gabara
gabbl	gabel
gablr	gable
gabrylh	cabral
gabrylh	cabral
gabryylsvn	gabrielsson
gabvr	gabor
gabyn	gabon
gacr	gaca
gadbry	gadbury
gadbt	adit
gadbvry	gadbury
gadbvys	gadbois
gadfrvyd	godfrey
gadfry	badry
gadgl	gadil
gadmn	adan
gadrv	adri
gadsn	adan
gadsvard	asgard
gadvyn	galvan
gady	dady
gadyjn	abyan
gadyl	gadil
gaf	ga
gaf	ga
gafny	danny
gafran	afra
gafyn	ayn
gagnh	gagne
gahrty	gaherty
gajnh	gagne
gajr	gair
gala	ala
galaghr	dalager
galagr	alar
galahad	galahad
galan	alan
galant	gallant
galatyn	balaton
galavy	galbavy
galbavay	galbavy
galc	gale
galdn	galen
gal	al
gal	al
gal	al
gal	al
galj	gale
galkv	galko
galn	gale
galp	gale
galpyn	galpin
galt	gale
galv	gale
galvla	galila
galvsn	galvan
galvvy	galbavy
galvy	alva
galybrt	galibert
galy	daly
galy	daly
galy	daly
galy	daly
galyla	galila
galylh	galila
galylh	galila
galyty	gallaty
galyvn	galen
galyzya	galizia
gamak	gamal
gamal	gamal
gambynv	gambino
gaml	gaal
gaml	gaal
gamrv	camry
gamrvs	camrys
gamvn	amin
gamyj	amy
gamysh	amish
ganapaty	ganapathy
ganar	aabar
ganatra	ganatra
ganavan	canaan
gandlc	gandhi
gandrsvn	andersen
gandrzyk	gandy
gandvrp	ander
gandy	gandy
gan	gan
gang	gang
gang	gang
gangvly	angel
ganl	gaal
ganrvs	gaeris
gans	gans
gansvn	anson
gantram	guntram
gantr	ganter
gantr	ganter
gantr	ganter
gantrp	gantry
gantrt	gantert
gantvrp	ganter
gantvrph	ganter
ganty	gandy
ganvn	ann
ganvyl	gandy
ganyr	andr
ganysan	ganesan
ganzak	ganzak
ganzalz	ganzak
gapta	gatta
gapysty	gaherty
garadvan	garagan
garafalv	garofalo
garans	sarans
garbh	garbe
garby	darby
gardnr	gardner
gardynr	gardner
garfyld	garfield
garfynkl	garfinkel
garlyk	carly
garmz	garms
garn	barn
garnr	garner
garnt	aint
garny	garry
garsky	gursky
garss	garms
garsvl	garshol
garsya	arya
gart	art
gartmn	gartin
gartryj	gantry
gartyn	gartin
garvd	bard
garvfalv	garofalo
garvla	arvola
garvtv	gareth
garyk	gary
garyk	gary
garys	garms
garytv	gareth
gasard	asaad
gas	gas
gaskat	baskar
gaskvn	gaskin
gaskvyn	gaskin
gaskvyyn	gaskin
gaskyn	gaskin
gaskynz	gaskin
gaslr	basir
gaslr	basir
gaslyk	allyn
gaslyng	gatling
gaspar	gaspar
gaspr	gaspar
gasta	gatta
gastavs	gustavs
gastavvs	gustavos
gastlav	gastli
gastlv	gastli
gastylv	gastli
gastyn	aston
gastynyv	gascony
gasvl	basel
gasy	gary
gasyk	ask
gasynk	ashok
gata	gaba
gat	gat
gat	gat
gathard	gerhard
gatkvmb	gatcombe
gatlyb	gatlin
gatly	atle
gatlyn	gatlin
gatmn	gatun
gatmn	gatun
gatryj	gantry
gatsf	ats
gats	ats
gats	ats
gatvyn	galvan
gatys	gates
gatyz	gatz
gatz	gatz
gatzvylr	gatrell
gavazny	galvan
gav	av
gavrd	aird
gavr	gair
gavtyr	ganter
gavyndan	govindan
gavynd	gavin
gavyn	gavin
gaya	gaya
gayat	gaya
gaybs	bayes
gayda	gayda
gaydry	badry
gaydval	gayda
gaydv	gayda
gaygl	gaal
gay	gay
gaylr	gayle
gaylvn	galen
gaymn	gayman
gaymvnd	gayman
gaynl	ayn
gaynvr	gaynor
gaynvr	gaynor
gayr	dayr
gayt	gat
gayvn	ayn
gayytz	gaetz
gazk	gaza
gazmn	gabon
gby	gay
gdard	adar
gdbry	dory
gdk	gd
gdralt	gerald
gdr	dr
gdyra	bdira
gdyrh	adar
gdyr	adar
gdys	gds
gf	cf
gfran	fran
glas	blas
glaskv	alaska
glasyr	glaser
glasyyr	glaser
glatz	glatz
glayr	alar
gldastyyn	gleason
gldbrg	goldberg
gldbrgr	goldberg
gldfsman	geldefsman
gldfsmn	geldefsman
gldfvt	clift
gld	gd
gldkmp	goldkamp
gldmn	aldan
gldr	alar
gldyng	glynn
gldzmn	aldan
gldzvrsy	gadbury
glf	alf
gl	al
glndvrf	glandorf
gln	gan
glryk	gary
gls	als
glsyrz	allyz
gltr	alar
glvb	alva
glvj	alva
glvrya	gloria
glvvy	levy
glyb	alya
glyc	alec
glycmn	glynn
glyk	alok
glyksmn	alyson
glyn	glen
glynz	glynn
glysvn	alyson
glyvs	glass
glyzr	gloyer
gmbl	amal
gmg	gog
gml	gil
gml	gil
gmyj	amy
gnagy	gnagy
gnks	genks
gnvsys	gipsys
gnysylda	gnishilda
gnzals	gizas
gnzals	gizas
gnzalz	gonzalez
gnzalz	gonzalez
gnz	agni
gph	goh
gpj	apr
grab	arab
grabnar	grabnar
grabn	graben
grabynr	graben
grad	grad
graf	graf
graft	graft
grag	drag
gragty	grasty
graham	graham
graham	graham
grah	grah
grahrna	grahorna
gralyn	galen
gramss	gramsas
granbrgr	grabnar
grandastrvm	grandmaster
grand	grand
gran	gran
grantam	grantham
grant	grant
granvyn	granvin
granyt	grant
granzyv	brandy
grardyn	gerardin
graskyn	gaskin
grasr	graser
gratr	grater
grav	gorav
grav	gorav
grav	gorav
grav	gorav
graym	gray
grayngr	gaynor
graysldyz	grady
graysyld	brassard
grayvas	gramsas
grayy	grady
grayyngr	gaynor
grayyv	grady
grbs	gris
grbyah	grah
grbyh	grah
grdan	gordan
grdn	gran
grdnr	gardner
grdy	grady
grfyt	gift
grg	garg
grg	garg
grg	garg
grgvr	greer
grgvr	greer
grhard	erhard
grhart	gerhart
grhart	gerhart
grjvaysn	grivas
grkv	grov
grl	gil
grly	gray
grlyk	gray
grmak	erma
grmban	gremban
grm	arm
grnandr	grand
grnd	grad
grndmstr	grandmaster
grndydyr	freddy
grn	gan
grngr	gang
grnjr	garner
grnjr	garner
grnly	gandy
grnsyng	grensing
grnt	grant
grnvyl	gandy
grnycr	gonyer
grny	gony
grqty	bruty
grsaph	grah
grsdvrf	gersdorf
grs	ars
grs	ars
grsldys	gradys
grsr	ars
grstl	gerstl
grsty	grasty
grstynn	gerstein
grta	greta
grtcn	gartin
grt	art
grt	art
grtrvd	astrid
grtrvyd	geertruyd
grvby	araby
grv	grov
grvgvry	gregory
grvhvl	grohol
grvlayt	gallant
grvlyt	arlet
grvm	arm
grvnr	gran
grvnvald	greenwald
grvnynk	groenink
grvs	gris
grvsjvhan	gresham
grvsk	grass
grvsr	graser
grvsy	garvey
grvt	grit
grvt	grit
grvthavs	goethals
grvvr	greer
grvvy	garvey
grvyncm	grinch
grvyn	bruyn
grvynlnd	greenland
grvynvld	groenveld
grybh	grah
grybl	grable
grybyh	araby
gryf	graf
gryf	graf
gryfr	graf
gryfr	graf
gryfr	graf
gryfy	grady
gryfys	gradys
gryfyts	arafats
gryfytz	graft
gryg	greg
gry	fry
grygr	greer
grygvr	gregor
grykv	grov
grylk	grilk
grylnbk	grilk
grynbrg	bryner
gryndly	grindley
gryng	bryn
gryngh	grinch
gryn	bryn
gryngr	bryner
grynham	grinham
grynj	bryn
grynjr	bryner
grynsvn	grinsven
grynvald	greenwald
grynv	bryn
grynvp	bryn
grynvvd	grand
grynyas	brendas
grynyj	bryn
grypnkrl	bryner
gryr	arya
grysayld	griswald
grys	gris
grysld	grusd
grysldys	gradys
grysmvr	grammer
grysr	graser
gryst	grist
grysvald	griswald
grysvld	griswald
grysvn	bryson
grysyld	griswald
grysyldh	grimaldo
gryt	grit
gryts	arts
grytz	gritz
grytzn	gritz
grytzvn	gretzky
gryvl	grail
gryvlyt	arlet
gryvnvd	grand
gryyn	aryan
gryynvald	greenwald
gryzly	grizzly
gryzvn	aryan
gsan	gan
gs	gs
gskvyn	galvan
gskvynh	galvan
gskyn	gaskin
gskyns	gaskins
gskynz	gaskin
gstavvs	gustavos
gst	gat
gstl	gaal
gtys	guys
gvada	ada
gvang	gang
gvan	evan
gvan	evan
gvanyav	guanyao
gvard	bard
gvbl	gaal
gvbyn	gabon
gvcan	avian
gvda	ada
gvda	ada
gvda	ada
gvdal	dal
gvdard	gerard
gvdata	gudata
gvdat	gudat
gvdaynaf	adana
gvd	gd
gvdgr	adar
gvdhv	dov
gvdl	fadl
gvdman	godman
gvdmn	godman
gvdnaf	bednar
gvdram	avram
gvdran	godman
gvdrv	adri
gvdrv	adri
gvdryc	avery
gvdsn	gds
gvdsvn	godson
gvdvyn	evelyn
gvdvyn	evelyn
gvdyng	deng
gvdyn	gwyn
gvdyr	adar
gvdyvayn	dylan
gvdyvyn	godewyn
gvgan	avian
gvgr	gage
gvgvan	galvan
gvhd	fahd
gvh	goh
gvhyn	gwyn
gvkyanv	guiyang
gvland	goland
gvlan	golan
gvldyng	golding
gvl	gil
gvlsby	gatsby
gvlt	celt
gvlvmb	golomb
gvly	daly
gvmz	gatz
gvmz	gatz
gvnar	bonar
gvnna	gonna
gvntvrp	ganter
gvnvt	genet
gvny	gony
gvnzals	gonzales
gvnzals	gonzales
gvnzalv	gonzalo
gvnzalz	gonzalez
gvpala	gopala
gvpalan	gopalan
gvpta	gupta
gvpth	garth
gvpvl	apel
gvpynat	gopinath
gvralavala	goralwalla
gvral	gural
gvralp	guralp
gvran	goran
gvrapartap	gurupartap
gvraspy	grasty
gvrav	gorav
gvrbrg	gorberg
gvrdf	gorde
gvrd	aird
gvrd	aird
gvrdn	garon
gvrdyn	gordan
gvrgan	garagan
gvrganz	franz
gvr	ger
gvr	ger
gvrky	gorky
gvrl	girl
gvrly	carly
gvrm	gorm
gvrmt	garms
gvrnal	bernal
gvrny	garry
gvrtvn	gartin
gvrv	garg
gvrvsamy	gurusamy
gvrvytz	gorwitz
gvry	gary
gvryk	gary
gvryncm	garance
gvryndr	bryner
gvryng	bering
gvrynmn	glynn
gvrys	averys
gvsf	avs
gvs	avs
gvstav	gustav
gvstavs	gustavs
gvstavvs	gustavos
gvstlv	gastli
gvsvl	aviva
gvsvyl	gospel
gvsy	avs
gvthard	gerhard
gvtjs	gates
gvtlyb	evelyn
gvty	gary
gvtyk	astik
gvvdgr	golder
gvvdyng	golding
gvvrd	goverd
gvvvsys	gipsys
gvvyndr	gaynor
gvyat	gat
gvydv	gayda
gvy	gay
gvykarys	ankaras
gvylam	gillam
gvyl	beyl
gvyl	beyl
gvyl	beyl
gvylrmv	garms
gvyn	gwyn
gvyn	gwyn
gvyvda	gayda
gvyydv	gayda
gvyyjr	gayler
gvyylym	bayly
gvyyn	glynn
gvzvytz	gaetz
gyanasy	ghanas
gyat	gat
gybsn	gabon
gybsvn	gibson
gybvny	albany
gybvnz	benz
gybvr	gabor
gydry	badry
gydv	ayda
gydvn	ryden
gydz	ayda
gyft	gift
gy	g
gygr	byer
gyjsbrtas	gijsbertus
gyjsbrtvs	gijsbertus
gylagly	gillogly
gylam	dylan
gylam	dylan
gylbay	galbavy
gylbrt	gilbert
gylfrd	alford
gylfvrd	alford
gyl	gil
gyl	gil
gyl	gil
gyl	gil
gylmn	dylan
gylmn	dylan
gylmr	aylor
gyln	ayn
gylnr	aylor
gylpyn	galpin
gylr	aylor
gylrm	gorm
gylrmv	garms
gylrvy	gilroy
gylry	garry
gylspay	gaspar
gylspy	gypsy
gylt	celt
gylvt	alva
gylyam	gillam
gyly	lyly
gyly	lyly
gylys	byles
gylys	byles
gylyta	geleta
gylyz	allyz
gylyz	allyz
gyml	gaal
gymnv	gymer
gymnz	gomez
gyn	ayn
gynkz	genks
gynsbrg	ginsberg
gyntn	bynon
gyntvn	ginton
gypjh	gepje
gypn	ayn
gyrard	gerard
gyr	cyr
gyr	cyr
gyrhart	gerhart
gyrtrvyd	geertruyd
gyrtsn	gartin
gyrvlayt	barclay
gyrvlyt	garvey
gysbrtvs	besbris
gys	gas
gysh	gish
gysylda	gayda
gytard	gerard
gyt	gat
gyt	gat
gytgy	getty
gytlmn	gatlin
gytlyn	gatlin
gytn	ayn
gytnyk	gdansk
gyts	acts
gytvmr	gitomer
gytvnd	dymond
gyvf	goff
gyvlyty	gallaty
gyvn	ayn
gyvvany	galvan
gyvvn	gavin
gyvyn	gavin
gyvz	gatz
gyyankvla	giancola
gyzav	gaza
haba	haba
habrdr	haber
habr	haba
habr	haba
habrkam	abram
habrlc	abel
habrmn	haberman
habrt	habert
habs	ahabs
habvra	habura
habvrg	aberg
habyn	abyan
habz	haba
hachaltr	bachelor
hacynsvn	hansen
hacynz	acuna
hacysvn	alyson
hadgz	cadiz
hadlnd	hadland
hadlstvn	alston
hadly	haddy
hadramat	hadramawt
hadramavt	hadramawt
hadsn	adan
hadsvn	hadavi
hadsvn	hadavi
hadvba	haba
hadya	hadaya
hady	dady
hadyl	hadil
hafbk	haba
hafmn	hafer
hafmn	hafer
hafmn	hafer
hafnylyng	ayling
hafr	hafer
hafsah	hafsah
hafs	hafs
haga	haga
hagan	hagan
hagard	hagar
hagard	hagar
hagdal	hadar
hag	ag
hagkynz	hacking
haglr	hagar
haglyn	allyn
hagmn	hagan
hagmn	hagan
hagn	haga
hagr	haga
hags	ags
hagsvn	hagan
hagtn	hagan
hagyn	hagan
hahtaha	huhtala
haj	haj
hajkynz	hacking
hajr	haj
hajrz	hafiz
hajs	haas
hajyr	hajar
hajz	haj
hakabay	aabar
hakdt	haddy
hak	hak
hak	hak
hakly	akl
haknys	dannys
haksa	hakka
haksav	hafsah
haks	haas
haksl	akil
haksv	aksu
hakvlynn	hakulinen
hakvyl	havel
haky	hak
hakyng	hacking
halam	halab
halan	alan
halat	halat
haldr	halar
halfldr	haller
halgr	halar
hal	hal
hal	hal
halkdys	haleys
halk	chalk
halknr	chalker
halm	halm
halmn	halm
halnd	hand
haln	hahn
halpyn	halpin
halr	hal
halr	hal
halrt	halat
halstd	halsted
halst	halat
haltgrn	hultgren
haltsyngr	holtsinger
haltvn	alton
haltz	hiltz
halvb	halab
halybrtvn	alkerton
halydy	haddy
halyfyld	alfeld
haly	daly
haly	daly
halymn	hallen
halyvl	hall
halzr	halar
hamacy	gamay
hamah	hamah
hamans	hamans
hamanz	haman
hamarkvyyst	hammarquist
hambyg	hamburg
hambyj	abby
hamd	ham
hamfry	amery
hamfryz	amery
hamfryz	amery
hamh	ham
haml	hail
haml	hail
hammanz	hammans
hamns	hamans
hampryvn	hamparian
hampsayr	hampshire
hampsyr	campey
hamptvn	hampton
hamr	ham
hamsayr	ramsay
hamvnd	amand
hamvndz	amand
hamy	amy
hamyl	hamel
hamyltn	hamilton
hamyltvn	hamilton
hanafvrd	hannaford
hana	ana
hanbvt	abbot
handl	hand
handrsvn	andersen
hang	bang
hangrfvrd	hannaford
han	han
hankh	hank
hanklr	anker
hankz	hank
hansakr	hansher
hansn	hanan
hansn	hanan
hansr	hans
hansvn	hansen
hansvn	hansen
hant	han
hantyngtvn	huntington
hanv	han
hanya	hanaa
hanyfa	hanifa
hany	han
hanyh	danih
hanymn	canyon
hapkarft	ackeret
hapkraft	hopcraft
hapkrft	habert
hapkynz	hacking
hapr	apr
hapsvn	hamson
harald	harald
haraldsn	haraldsen
harary	harare
haratz	haratz
harbd	harbud
harbr	harber
harbr	harber
harbr	harber
harbrn	harbin
harbryj	harry
harbvd	harbud
harbvr	harber
harbyg	darby
harbyj	darby
hardn	harden
hardymn	harden
hardyng	harding
hardyn	harden
hardysvn	hardison
hargravz	haratz
har	har
harkl	akl
harkr	harker
harkvm	hakim
harkyn	harkin
harkynz	harkin
harld	harald
harld	harald
harl	carl
harlnd	harland
harln	harlan
harlv	harv
harman	harman
harmanvs	harmanus
harmn	harman
harmnvs	harmanus
harmvtv	armato
harmz	harms
harnr	arne
harp	earp
harpr	harpe
harpvld	harpold
harr	barr
harryg	harrig
harsa	harsh
hars	ars
hars	ars
hartag	hartog
hartah	hurtah
hartfyld	hartfield
hart	hart
hart	hart
hartl	hart
hartlp	hartlep
hartly	hartley
hartmn	hartman
hartr	hart
hartvl	hartel
hartvyl	hartel
hartygan	hartigan
harvard	harvard
harv	harv
harvhysa	haruhisa
harvld	harald
harvl	harv
harvn	harv
harvn	harv
harvny	harvey
harvy	hardy
harycn	aryan
haryharan	hariharan
harykn	aryan
harynkar	hardikar
harys	hares
harysvn	alyson
haryv	harv
haryz	ariz
hasakah	hasakah
hasal	hasan
hasbrvk	hasbro
hasby	husby
has	as
has	as
haskal	haskel
hask	ask
haskl	haskel
haskl	haskel
haskynz	baskin
haslvm	haslum
hasmn	hasan
hast	east
hasttlr	aster
hastvn	aston
hastyngz	hastings
hasyk	ask
hatap	fatah
hatcsvn	hamson
hatcynsvn	atchison
hatcynz	hatcher
hatcysvn	allyson
hat	at
hatlndnsys	albanys
hatly	atle
hatm	halm
hatmykr	hatmaker
hatr	har
hatrl	atri
hatvn	eaton
hatvn	eaton
hatvry	hajery
havard	havard
havdvn	hamdan
havgtaylyng	houghtailing
hav	av
hav	av
hav	av
havk	hack
havk	hack
havkr	haber
havkyn	harkin
havkynz	hacking
havl	hail
havly	bally
havlz	chavez
havn	hahn
havn	hahn
havs	avs
havsr	avs
havtvn	hatton
havtylyng	aveling
havtyn	hatton
havvla	havola
havvnn	hann
havy	davy
havys	hays
haybrd	bayard
haybz	fayiz
hayc	hay
haydar	hadar
hayd	hand
haydmn	hayden
haydn	haydn
haygdan	hagan
hayky	bayly
haylnd	hadland
haylt	bayla
haylvrd	hayward
hayly	bayly
haym	halm
hayngh	haange
hayn	ayn
hayn	ayn
haynly	bayly
hayns	hans
hayns	hans
hayny	ayn
haynz	ayn
haynz	ayn
hayply	bayly
hayr	dayr
hayrvnymvs	hieronymus
hayslvp	hyslop
haysvn	ayson
haytr	hayter
hayts	hayes
haytz	bartz
hayvard	harvard
hayvkynsvn	hawkinson
hayvkz	chavez
hayvl	hadil
hayz	hay
hayz	hay
hazn	hahn
hbntvn	hinton
hbrn	horn
hbrvq	harv
hbvrn	barn
hbyba	aboba
hbybh	abby
hdad	head
hdak	hak
hdavy	davy
hdaya	hadaya
hdaya	hadaya
hdaydah	hudaydah
hd	cd
hdlnd	hadland
hdlnd	hadland
hdlvnd	hadland
hdly	holy
hdramavt	hadramawt
hdramvt	hadramawt
hdrmat	fermat
hdryk	horak
hdsa	ada
hds	cds
hdya	ada
hdyda	ayda
hdydh	haydn
hdyh	hay
hdyl	adel
hdyn	adan
hfrvn	efren
hfsa	hfs
hfsah	hafsah
hfs	hfs
hfsh	hfs
hgarty	hegarty
hglnd	hagland
hgtylyng	ayling
hgy	hay
hgy	hay
hgyr	cyr
hhmn	chan
hjr	har
hjry	ajay
hk	bk
hkr	har
hkr	har
hksav	hasan
hksv	aksu
hkt	ait
hktvr	akar
hkym	hakim
hkyng	hmong
hkzn	akin
hlab	halab
hlal	blal
hlan	alan
hlavyn	hlavin
hlb	ahab
hlblyng	helbling
hlbyg	helbig
hlbyng	helbing
hld	al
hldn	alan
hlfmn	helfman
hlga	haga
hl	al
hlkant	elkan
hlk	hak
hllr	alar
hlmn	alan
hlmn	alan
hlmnstayn	blanstan
hlmr	alar
hlmz	alm
hlmz	alm
hlna	ala
hlnd	hand
hlndr	andr
hln	han
hln	han
hlr	har
hlstrvm	ahlstrom
hlt	helt
hltlandnsys	holtlandensis
hltlndnsys	holtlandensis
hltvn	alton
hlv	al
hlvj	alva
hlvm	alim
hly	ely
hly	ely
hlyndn	flynn
hlyvl	algal
hlzgng	holzgang
hlzmn	hazen
hmah	hamah
hmam	ham
hmans	hamans
hmanz	amand
hmar	har
hmbayj	amway
hmbyj	huby
hmdan	hamdan
hmd	md
hmh	am
hml	hal
hmp	am
hmpsayr	mayr
hmpsr	alps
hmra	hamra
hmr	har
hmr	har
hmr	har
hmstd	haste
hmsyrh	emyr
hmyd	ahmad
hmyltn	amyot
hmyltvn	hamilton
hmza	hamza
hmz	hz
hmzh	hamah
hna	ana
hna	ana
hnan	han
hnclyf	hinely
hnd	and
hndl	and
hndrsn	andron
hndrsvn	andersen
hndrycvz	hedrick
hndrycy	hedrick
hndryka	andra
hndrykas	andras
hndryk	andr
hndrykh	hendriks
hndrykj	hendrikje
hndrykjh	hendrikje
hndryks	hendriks
hndryks	hendriks
hndryks	hendriks
hndryksh	hendriks
hndryksn	hendriks
hndryksvn	andreasen
hndrykvs	hendriks
hndryky	hendriks
hndy	andy
hndz	and
hn	h
hn	h
hnj	haj
hnjy	anay
hnkl	akl
hnks	hanks
hnl	hal
hnly	holy
hnnfnt	anant
hnryk	henrik
hnryt	hart
hnsly	ansley
hnsn	hosn
hnt	hunt
hnth	huth
hntj	entje
hntjh	entje
hntyg	hentig
hnya	alya
hnyfa	haifa
hnyfh	ayah
hnygan	hagan
hnyg	eng
hny	hay
hny	hay
hnyj	enyo
hnyk	enyo
hnyngsn	haynes
hny	hay
hnz	hinz
hpkraft	hopcraft
hplr	apr
hqyr	cyr
hraby	araby
hrak	hak
hran	bran
hranyky	hranicky
hrayzyng	ayling
hrbayj	bray
hrbrt	habert
hrbvrt	habert
hrbyj	huby
hrdasfyld	herdsfield
hrd	herd
hrd	herd
hrdsfyld	herdsfield
hrdzfyld	herdsfield
hr	ar
hrlayndyz	brandy
hrlndys	brandys
hrlvy	haley
hrlyndys	brandys
hrman	haman
hrman	haman
hrman	haman
hrman	haman
hrmans	hamans
hrmn	arm
hrmn	arm
hrmn	arm
hrmn	arm
hrmnvs	armands
hrmnyvs	amys
hrms	hams
hrmvsv	ermas
hrmz	ariz
hrnaky	anay
hrnandz	hernandez
hrndvn	herndon
hrn	han
hrn	han
hrn	han
hrnkr	hank
hrnsbay	hornsby
hrra	hera
hrsfal	horsfall
hrt	art
hrtlyng	hertling
hrtvk	ark
hrv	harv
hrvn	aron
hrvnymvs	hieronymus
hrvs	aras
hrvy	bray
hryk	ark
hrykn	aryan
hryng	bryn
hryngsav	haynes
hrys	hays
hrysvn	bryson
hryt	art
hryvl	aral
hsaka	osaka
hsakah	hasakah
hs	hs
hs	hs
hsh	hs
hskah	hamah
hskh	ask
hsmans	hamans
hsmns	hamans
hsna	hasna
hsn	han
hsn	han
hst	hs
hstr	aster
hstyngz	hastings
hsymanz	heymann
hsyn	ayn
hsyn	ayn
hsyn	ayn
hsyn	ayn
htcr	cr
htkvks	atkins
htryk	horak
htzlr	hetzler
hvadly	bradly
hva	ava
hvar	har
hvbr	br
hvbrmn	bran
hvbvrvg	aberg
hvbvrv	haber
hvbvrvq	haber
hvcynsvn	evenson
hvdaydah	hudaydah
hvdgy	haddy
hvd	and
hvdkyns	adkins
hvdkynz	adkins
hvdsn	hedin
hvdsvn	hodson
hvfgard	haggard
hvfrd	havard
hvfryn	avery
hvft	gift
hvgan	hagan
hvgard	hugard
hvgard	hugard
hvgarty	hegarty
hvg	hg
hvg	hg
hvg	hg
hvglnd	hagland
hvgnbvm	hvinden
hvgn	avon
hvgs	hgs
hvgtaylyng	ayling
hvgtylyng	hertling
hvgv	haga
hvgvyn	evelyn
hvhnsvn	evenson
hv	av
hv	av
hvk	hak
hvkn	avon
hvland	hyland
hvldn	halon
hvldzvrs	holders
hvl	hal
hvl	hal
hvlkamb	halab
hvlknr	hilker
hvlm	halm
hvlmn	halm
hvlmz	halm
hvlndnsys	hennessys
hvlrvyd	holroyd
hvls	hals
hvlstn	hilson
hvltlndnsys	holtlandensis
hvlymn	lymn
hvlzn	halon
hvlzvars	bolivars
hvmak	hak
hvm	ham
hvm	ham
hvmn	avon
hvng	hong
hvnygbrg	honigberg
hvp	av
hvp	av
hvpr	apr
hvqtylyng	hertling
hvqym	avram
hvrgan	horgan
hvrkan	horkan
hvrn	horn
hvrnr	herr
hvrsfvrd	horsford
hvrst	herst
hvrtmn	hartman
hvrtr	hart
hvrvat	horvat
hvrvt	hart
hvrvvytz	haratz
hvrvytz	haratz
hvrygmv	avram
hvryhan	aryan
hvry	avery
hvryng	bering
hvryv	harv
hvs	avs
hvsmn	hasan
hvstvn	heston
hvtn	avon
hvvart	hart
hvvn	avon
hvvr	har
hvya	alya
hvybrg	hamburg
hvyd	boyd
hvygn	haydn
hvyjn	haydn
hvyman	hoyman
hvyng	hmong
hvysr	hays
hvyt	hart
hvytynk	hoitink
hvyyskn	hyson
hvz	hz
hybax	haba
hybrg	hydra
hybrt	habert
hybvrn	barn
hycmn	hyman
hycns	eycks
hydajat	hidajat
hydland	hadland
hydn	haydn
hydn	haydn
hydnr	hadar
hydr	hyde
hydryc	hydra
hydrys	hydras
hyfa	afa
hyflr	hafer
hyftz	hafiz
hygarty	hegarty
hygl	haga
hygn	hyun
hygrmn	agren
hygvnt	agent
'hyh	shuh
hy	h
hyjdan	hamdan
hyjmn	hyman
hykarv	harv
hyk	hak
hykmn	hyman
hyksvn	hyson
hykv	hak
hyky	hak
hyky	hak
hylbry	hilary
hyldbrand	hildebrand
hyld	auld
hyl	hal
hyl	hal
hyl	hal
hyl	hal
hyl	hal
hylkr	aylor
hylmr	aylor
hylnbrnd	hyland
hylnd	hyland
hylnd	hyland
hylnth	aylott
hylry	haley
hyls	hals
hylsntygr	hilsenteger
hylsvn	hilson
hylt	helt
hylth	heath
hylt	helt
hyltj	helt
hyltjh	heyltje
hyltjh	heyltje
hyltj	helt
hyltn	dylan
hylyard	aylward
hyly	holy
hylyrstyn	holsten
hylys	byles
hylyth	blyth
hylz	elz
hym	ham
hymn	hyman
hymn	hyman
hymstd	dymond
hyncly	hinely
hyncy	dancy
hynd	hand
hyndryka	hendrica
hyngan	hagan
hyng	hong
hyn	ayn
hynj	ayn
hynly	handy
hynr	ayn
hyns	hans
hyns	hans
hyns	hans
hynsvn	hansen
hyntvn	hinton
hyntz	bentz
hynv	ayn
hynvnn	bynon
hynvz	hinz
hynz	hinz
hynz	hinz
hynz	hinz
hynz	hinz
hynz	hinz
hypgryv	hipgrave
hyp	ayn
hyps	alps
hyray	airay
hyrdgn	harden
hyrd	byrd
hyrly	carly
hyrn	horn
hyrnh	byrne
hyrn	horn
hyrt	hart
hyrvnymas	hieronymus
hyrvnymvs	hieronymus
hyrvta	hirota
hysan	hasan
hys	hays
hyskvks	hoskins
hyskvt	haskel
hyslap	hyslop
hysl	ayse
hyslvp	hyslop
hysmans	tysmans
hysmns	dysons
hysr	ayse
hytn	hyun
hytr	byer
hytr	byer
hyts	acts
hytsvn	hitson
hytvn	hyman
hytz	hitz
hytz	hitz
hyvard	havard
hyvgn	haven
hyv	av
hyvkynz	dykins
hyvm	halm
hyvngan	hagan
hyvnsv	hans
hyvvyt	horvat
hyvz	hinz
hyvzr	aylor
hyyn	hyun
hyz	hz
hyzman	hyman
hyzmans	guzmans
hyzmns	hymens
hyzmnz	hazen
hyzymnz	haydn
hzltvn	hilton
hzmnz	heinz
jabjh	babah
jab	jan
jab	jan
jad	jan
jad	jan
jad	jan
jagard	jagard
jag	ag
jagr	jager
jagv	jago
jahmanh	jahmane
jahns	jans
jakamynth	jacomyntie
jaksvn	jackson
jakvas	javas
jakvbh	jacob
jakvb	jacob
jakvbjh	jacobje
jakvbj	jacob
jakvbs	jacobs
jakvbsvn	jacobsen
jakvbsvn	jacobsen
jakvby	jacoby
jakvbz	jacob
jakvmyntay	jacomyntie
jakvmyntyh	jacomyntie
jakvmynty	jacomyntie
jakvmyt	hakluyt
jakvs	jakes
jakvyz	allyz
jakvz	jake
jakyvz	akiva
jala	jala
jalvnn	alvin
jamvna	jamuna
jana	jana
janardhan	janardhan
janatvn	anacin
jancs	janas
jang	jang
jang	jang
jang	jang
jangnykl	angel
jangr	jang
jangtayy	january
jan	jan
jan	jan
jan	jan
jan	jan
jank	bank
jank	bank
jankynsvn	jenkinson
jansh	jans
jans	jans
jansjh	jansje
jansj	jans
jansky	jansky
jansn	jann
jansn	jann
jansvn	jansen
jansvn	jansen
janth	baath
jant	iant
jant	iant
jantj	bantu
jantvj	antal
jantyh	anay
janvth	janet
janvt	janet
janvtjh	janotje
jany	jan
janyka	jana
janz	danz
janz	danz
jap	gap
japjh	caph
japj	apr
jaras	aras
jarbvt	jarbot
jardyn	arden
jars	ars
jart	art
jarvala	jarwala
jarvys	jarvis
jarytjn	marytje
jasck	jack
jas	as
jaspr	jasper
jasprz	jasper
jastam	assam
jastas	asias
jastjh	justje
jastj	casti
jast	east
jastjy	justje
jastyh	aster
jastyn	aston
jastyn	aston
jastyn	aston
jastyn	aston
jastys	caseys
jasva	java
jasvyndr	jasvinder
jatjy	cathy
jatyndr	jatinder
javf	java
javyd	javed
javyka	jataka
javyr	davy
jayan	jayan
jayant	jayant
jayaram	jayaram
jayn	ayn
jayn	ayn
jaynvr	gaynor
jayp	jay
jbhh	john
jbh	aba
jbyr	bar
jdy	jay
jf	cf
jf	cf
jfkk	jack
jfry	fry
jfryz	fry
jhamanh	hamah
jhang	jhang
jhan	chan
jhar	har
jhmanh	jahmane
jhra	jahra
jkbs	jobs
jk	bk
jkmn	akin
jkmn	akin
jksvn	jason
jkvbs	javas
jkvbsvn	jebsen
jkvbz	java
jkyn	akin
jla	ala
jlal	blal
jl	al
jlj	al
jlny	clay
jlth	alta
jlt	lt
jltjh	jeltje
jlvmark	jelvemark
jmal	amal
jmal	amal
jmar	imar
jml	jul
jml	jul
jmml	amal
jmvla	jala
jmyla	bayla
jmylah	jamilah
jmyla	bayla
jmyl	amal
jmylh	myth
jmylh	myth
jmyl	amal
jnah	jenah
jna	ana
jndryav	andra
jndryc	andr
jng	eng
jng	eng
jn	in
jnk	junk
jnk	junk
jnks	jenks
jnks	jenks
jnkynsvn	jenkinson
jnkz	inez
jnt	aint
jntjs	entje
jntry	gantry
jnyfr	anbar
jnykh	ayah
jnyk	enyo
jnyngz	enying
jnyrv	andr
jnysylda	gnishilda
jpsn	epson
jpy	jay
jrada	jerada
jrald	jerald
jrard	bard
jrard	bard
jrardy	brady
jrgnz	franz
jrhard	erhard
jrmyas	ermas
jrmy	amy
jrmyk	amy
jrmys	amys
jrs	jrs
jrstl	gerstl
jrtrvd	astrid
jrvnymvs	jaymes
jrvnyvs	jennys
jrvys	brays
jryng	bryn
jryngr	bryner
jrytsma	jorritsma
jryty	bruty
jrytzvn	aryan
jsf	js
jspr	apr
jstr	aster
jstvn	aston
jsyka	asoka
jsyk	ask
jtrv	atri
jtsam	jetsam
jvab	joab
jvana	jana
jvandr	andr
jvang	jang
jvan	evan
jvan	evan
jvanyta	juanita
jvav	av
jvay	jay
jvbal	jubal
jvbj	job
jvb	job
jvb	job
jvbyn	robyn
jvdas	judas
jvd	jed
jvdy	jody
jvdy	jody
jvf	alf
jvf	alf
jvfl	jeff
jvgla	avila
jvhana	ghana
jvhan	jehan
jvhansn	johann
jvhansn	johann
jvhansvn	johansen
jvhansvn	johansen
jvhansvn	johansen
jvhany	jehan
jvhanz	jehan
jvhanz	jehan
jvlay	clay
jvl	jul
jvl	jul
jvltz	hiltz
jvlyanth	jayant
jvlyantjh	jaantje
jvlyantj	jayant
jvlyant	jayant
jvlyany	albany
jvlyf	joly
jvly	joly
jvly	joly
jvly	joly
jvnas	janas
jvngan	jinan
jvnganz	dungane
jvn	jan
jvn	jan
jvn	jan
jvnv	jan
jvny	gony
jvnyn	jann
jvnyvr	denyer
jvprv	apr
jvrah	jurah
jvra	afra
jvran	amran
jvravlv	jerald
jvrgnz	franz
jvrj	burj
jvrjn	aaron
jvrjn	aaron
jvrjya	arya
jvrjyv	jerry
jvrk	ark
jvrvytz	bartz
jvry	jory
jvryng	bering
jvrysma	alyssa
jvrytsma	jorritsma
jvs	avs
jvslyn	evelyn
jvsth	josh
jvstj	jost
jvsty	dusty
jvsva	aviva
jvsvyg	josey
jvsyp	josip
jvtlyn	evelyn
jvvn	avon
jvydyp	jody
jvynr	jayne
jvynr	jayne
jvysf	joys
jvys	joys
jvyt	ivy
jvyt	ivy
jvza	juza
jvzf	jawf
jvzfvs	jeffs
jvzp	jeep
jvzy	ivy
jvzyh	ivy
jvzy	ivy
jvzy	ivy
jyaf	afaf
jya	jia
jyakvb	jacob
jyan	jan
jyany	jan
jyavrdany	jardine
jybsvn	jebsen
jybyns	dobyns
jygang	jigang
jy	j
jy	j
jyjsbrtvs	gijsbertus
jykmn	jokin
jylam	dylan
jylbrt	albert
jyl	jul
jylt	celt
jylyan	dylan
jylz	elz
jym	jim
jyml	jamal
jymsvn	ayman
jymy	amy
jymyny	ayman
jymz	jame
jymz	jame
jymz	jame
jynakyraman	janakiraman
jyng	jang
jyn	ayn
jyn	ayn
jyn	ayn
jyn	ayn
jyn	ayn
jyns	jans
jyntvn	anton
jynyk	junk
jynz	ayn
jyph	ayah
jyrardyn	gerardin
jyrmaska	germuska
jyrvsk	ayres
jysh	josh
jys	jos
jysr	ayse
jystr	eyster
jysvz	ayse
jyta	alta
jyvk	eyck
jyvrdanv	jordan
jyvvany	jovian
jyvvyl	advil
jyvyl	advil
jyzan	jizan
jyzn	ayn
jyzsbrtvs	besbris
jzyrh	ayah
kab	kai
kabrylv	cabral
kaclyng	jaclyn
kacv	ac
kacvn	bacon
kacy	katy
kacyh	bach
kadlask	kailas
kadmn	kaden
kadmvs	cadmus
kadn	kaden
kadrybysyk	kadribasic
kadrykys	karyns
kadv	kado
kadyn	kaden
kafry	afra
kafy	katy
kafyn	karyn
kagbvrn	agsorn
kagl	kagle
kagl	kagle
kaglyn	allyn
kagsal	faisal
kagsvl	ags
kahan	kahane
kahvn	hahn
kakalk	kabal
kakands	kacandes
ka	a
kakbryd	kakure
kakdkar	kakodkar
kakraft	kraft
kakryl	darryl
kakshd	aisha
kaktvs	kants
kaky	kaki
kakyvla	kayla
kakyvr	akar
kala	ala
kalafatas	kalafatas
kalafvt	kalafut
kalahan	calahan
kalanan	alana
kalatvr	kalathur
kalbavt	galbavy
kalb	kalb
kalb	kalb
kalbryj	kalb
kalbyda	kulbida
kal	al
kaldl	aldo
kaldvl	kaldis
kaldvl	kaldis
kaldys	kaldis
kalhyn	allyn
kalhynh	aaliyah
kal	al
kalkan	kalkan
kalklasvr	balkhash
kalman	kalman
kalmn	kalman
kalmn	kalman
kalmys	kalmyk
kalpak	kalpak
kalpana	kalpana
kalps	alps
kalpyn	allyn
kalr	kalb
kalrty	karty
kalry	badry
kalsgh	balogh
kalsvn	balson
kalsyn	calsyn
kalt	kalt
kaltvn	alton
kalv	kalb
kalvm	alim
kalvnlv	kalev
kalvrt	calvert
kalvyn	allyn
kalya	alya
kalyan	kalyan
kalyany	kalyan
kalyarv	kalyan
kaly	daly
kalygy	kalyan
kalyla	kalila
kalynsan	kalyan
kalynt	kalt
kalynz	kalyan
kalys	kalbs
kalys	kalbs
kalysyak	kalisiak
kalyyvs	alyces
kamacv	kama
kamala	kamala
kamal	kamal
kamama	camama
kamar	jamar
kamat	kama
kamb	kamb
kambs	kalbs
kambytz	babitz
kambyy	kamb
kambz	kamb
kamdar	kamdar
kamhvlz	kamholz
kam	kam
kam	kam
kaml	kam
kamln	kamen
kamlys	amys
kamn	kain
kamns	kamas
kampagna	campagna
kampar	kamdar
kampbl	kamal
kamp	kam
kampr	kampe
kamptvn	hampton
kampvs	campos
kampylv	kampala
kampyvtr	kamper
kamr	kam
kamrvd	kamerud
kamrvn	amran
kamrvs	camrys
kamskaya	kamskaya
kamstak	amlak
kamya	kama
kamyng	kamen
kamyn	kamen
kamyv	amy
kanakakvrn	kanakakorn
kana	kana
kanak	kanak
kanal	kanal
kanal	kanal
kanan	banan
kanava	kanaka
kanbvy	abbey
kan	kan
kandayv	kanda
kandly	andy
kandv	kanda
kandvyyt	advent
kandy	andy
kanfr	andr
kanfyld	alfeld
kang	kang
kang	kang
kang	kang
kan	kan
kanknt	anant
kanln	ann
kanly	anay
kanly	anay
kann	ann
kanr	kan
kanrly	carly
kanrvy	karty
kansl	kanal
kanstabarys	constabaris
kanstabv	kansan
kantara	cantara
kanth	kant
kant	kant
kant	kant
kantra	andra
kantr	kant
kantrl	antal
kanv	kan
kanvry	gantry
kanya	kana
kanyf	kan
kanyg	kang
kanyngham	anagram
kanys	kanes
kanysna	alyssa
kanytz	kant
kanyvn	canyon
kanzy	kanze
kapa	kama
kapanga	kapanga
kap	gap
kapk	kapp
kaplan	kaplan
kapln	kaplan
kaplynk	kaplenk
kapnr	kapner
kapral	kapral
kaps	gaps
kapsvn	kapson
kapvr	apr
kapyla	kapila
karabvlvt	karabulut
karagr	farag
karahr	caraher
kara	kara
karanjlv	karan
karan	karan
karara	karaca
karasa	karaca
karas	karas
karaskv	karak
karasv	karas
karayl	karayel
karbajal	carbajal
karbala	karbala
karbn	karan
karbvnly	karbala
karbvnya	karbala
kar	kar
kardal	kardal
kardl	kardal
kardl	kardal
kardlys	carlys
kardnas	karinas
kardynaly	cardinali
kargyl	argyle
karhart	carhart
karkarn	kalkan
karkas	farkas
karlayl	karayel
karl	karl
karl	karl
karlkvyst	karlquist
karls	karls
karlsvn	carlson
karltvn	carlton
karltvn	carlton
karlvs	karlas
karlvt	arlet
karlyn	karyn
karlyn	karyn
karman	barman
karmvdy	carmody
karmvna	carmona
karmycayl	carmichael
karn	karn
karn	karn
karnlyan	kalyan
karnr	karn
karnry	barney
karnya	arya
karny	karn
karny	karn
karnz	karn
karp	karp
karplas	karlas
karpntr	kapner
karpntyr	carpenter
karstnsn	carstens
karstnz	bartz
karsvn	carson
karsvn	carson
kart	art
kartnr	arter
kartrayt	ararat
kartr	karr
kartvyz	karty
karty	karty
kartyk	kartik
kartyr	karty
kartys	karty
karvlyn	carolyn
karvr	karr
karvsv	karas
karvsv	karas
karvyn	karyn
karyaga	cariaga
kary	cary
kary	cary
karyda	karida
karydyan	aryan
karyh	karyn
karyjr	karner
kary	cary
karylv	daryl
karyra	arya
karys	karas
kasak	kanak
kasama	kasama
kasam	kasai
kasanvva	casanova
kasara	kasama
kasat	kasat
kasgrvh	kastrup
kasl	karl
kaslmn	kalman
kasm	kam
kasmn	kasun
kasmycy	kalmyk
kasnr	basir
kasnyr	casner
kasprzak	kasprzak
kasrtynv	karty
kasryl	darryl
kasta	kast
kastanv	astana
kastlv	castle
kastlv	castle
kastnr	kastner
kastnr	kastner
kastrcm	kastrup
kastrgyn	karyn
kastr	kast
kastrv	castro
kastrykam	astrakhan
kastrykvm	castricum
kastryvm	kastrup
kastvl	kast
kastvry	kasturi
kasty	karty
kastylv	castle
kastyn	aston
kasvf	asif
kasvn	kasun
kasy	kasey
kasyng	kang
kasynly	ascoly
kasynsky	galensky
kasyv	kalev
kata	kama
katalanv	catalan
katan	karan
kataryn	kathryn
katb	kalb
katbrt	kateri
katcy	kathy
katkart	patkar
katl	karl
katl	karl
katlmn	gatlin
katlr	atle
katlyr	katelyn
katn	kain
katr	kar
katrntj	katryntje
katryj	karyn
katryjn	catrijn
katry	kathy
katryna	katrina
katryna	katrina
katryn	karyn
katryn	karyn
katryn	karyn
katryn	karyn
katryn	karyn
katrynth	katryntje
katryntjh	katryntje
katryntj	katryntje
katrynty	katryntje
katvala	katwala
katvpys	kathys
katy	katy
katyng	kang
katz	katz
kavasyn	cavasin
kavayy	kasaty
kav	av
kav	av
kavdlyng	aveling
kavdyl	kardal
kavh	kave
kavh	kave
kav	av
kavly	bally
kavly	bally
kavlyng	allyn
kavn	kain
kavrz	kar
kavs	avs
kavstn	kansan
kavyta	kavita
kaya	kaya
kayak	kayak
kay	kay
kayk	kauk
kaylas	kaylas
kayl	karl
kayn	ayn
kayn	ayn
kayny	ayn
kaypr	apr
kayras	karas
kayrd	aird
kayrvf	ayres
kaysr	kayser
kayt	kalt
kayt	kalt
kazdan	kazdan
kazgryf	karyn
kazmayr	kazmaier
kazvhyrv	kazuhiro
kazvnvzy	kanze
kazy	katy
kazyr	dayr
kazyrr	karr
kbakyan	kabakian
kbakybv	kabakibo
kbanys	albanys
kbrg	aberg
kbr	br
kbyr	akbar
kbyr	akbar
kcng	kang
kdavr	adar
kd	cd
kdl	ada
kdl	ada
kdr	dr
kdym	adam
kdyn	adan
kdyra	bdira
kdyr	adar
kdysya	alyssa
kdysyh	dyson
kfart	kmart
khv	av
kk	bk
klabvrn	claborn
klaf	klan
klag	klan
klag	klan
klagstvn	blanstan
klak	klan
klamn	klan
klamr	alamo
klanfyld	clanfield
klansy	klans
klantvn	clanton
klarjh	alar
klark	clark
klark	clark
klar	alar
klartay	karty
klarth	barth
klartjh	klaartje
klartj	karty
klartjy	karty
klart	klatt
klarty	karty
klaryj	karyn
klasa	klassa
klasj	blas
klasjh	klassa
klasmyr	klammer
klasn	klan
klasnr	glaser
klat	flat
klatz	blatz
klavdya	chavda
klavdy	lavey
klavsy	klans
klavytr	kavita
klayn	klan
klayn	klan
klayr	alar
klaysj	klans
klaysvn	clayson
klaysvn	clayson
klaytvn	clayton
klaz	blaz
klazvra	klazura
klazyng	kang
klbay	alba
klb	kalb
klbrn	karn
klbvrn	alber
klbvrn	alber
klby	kilby
kl	akl
kldny	kenny
kldvl	abdul
kldvy	kidby
klflt	kalt
klkar	kelkar
kl	akl
kl	akl
klmanz	elman
klmbv	kamb
klmn	klan
klmp	kemp
klnfyld	alfeld
kln	kan
kln	kan
klnr	alar
klrtay	karty
klrty	karty
klrvs	karas
klt	kalt
kltn	klan
kltnr	keltner
klvb	alva
klvbk	alba
klvkynas	kloukinas
klvly	kelly
klvmpnr	clumpner
klvnfrv	alvaro
klvsn	alvin
klvth	blyth
klvynn	flynn
klybr	klyber
klybrn	klyber
kly	ely
kly	ely
klyf	alf
klyfrd	alford
klyft	clift
klyftvn	clifton
klyk	alok
kly	ely
kly	ely
klyla	kayla
klymr	klemm
klymvf	klemm
klyngrvt	klingler
klynk	blank
klyn	klan
klyn	klan
klynsvrg	kayser
klynz	flynn
klyr	alar
klyr	alar
klyr	alar
klyr	alar
klyrtyh	blyth
klys	alps
klysh	blyth
klytvn	alston
klyvy	levy
kma	ama
kmal	amal
kmal	amal
kmbry	amery
kmbs	amos
kmbz	kamb
kmdr	amir
kmfvys	amways
kmfyld	alfeld
km	am
kmkr	amir
kmllv	kalev
kmpastr	kast
kmpbl	amal
kmp	kemp
kmp	kemp
kmpr	amir
kmpstr	kempster
kmpvs	kempis
kmpy	amy
kmr	kar
kmr	kar
kmr	kar
kmrvn	amran
kmsptr	ampte
kmstr	amster
kmylah	kamilah
kmyla	kayla
kmylh	kayla
kmyr	emyr
knamvry	amery
knavay	navas
kndal	kendal
kndl	knel
kndryk	andr
kndv	and
kndvlf	kandolf
kndy	andy
kndyg	andy
kndy	andy
kng	eng
kng	eng
kn	in
kn	in
kn	in
knnyng	kenning
knpvl	knel
knrad	konrad
knrad	konrad
knrad	konrad
knradvs	konrads
knrat	brat
knrdyng	harding
knr	kar
knsyngtv	kensingto
knta	kenta
kntarv	kentaro
knvb	knob
knvfynkh	knufinke
knvl	knel
kny	kay
kny	kay
knykrbkr	khyber
knyngtvn	alington
knyn	ann
knysky	kousky
knyvn	kayvon
knyvn	kayvon
knz	kenz
kpjh	kaj
kpl	pl
kply	daly
kpr	apr
kprt	kert
kptan	ketan
kpystran	capistran
krab	krab
kra	ara
kracly	bradly
kracly	bradly
kracn	brain
kracr	brar
krakart	akar
krakfrd	bradford
krakfvrd	bradford
krak	karak
krak	karak
krakt	kraft
kramary	kramer
kramhvrn	crumhorn
kramr	kram
krandlmyr	bradley
kransvyk	brandy
kransvyyk	cranswick
kranzvyk	brandy
krap	krab
krapr	apr
kraqtvn	crafton
kraras	karas
krasby	araby
kras	aras
krasn	krasen
krasyk	kraack
kratr	brar
kratrz	katz
kratygr	kratzer
kratzr	kratzer
kravfvrd	bradford
kravl	aral
kravly	bradly
kravn	brain
kravn	brain
kravsvn	krasen
kray	bray
kraydr	kramer
krayg	kraig
krayg	kraig
krayj	bray
krayj	bray
kray	bray
kraysvl	brays
krazn	brain
krazyr	frazer
krbla	kubla
krbl	aral
krbsr	arber
krbtry	abery
krbvnyl	albany
krbyt	kirby
krc	kr
krdal	kardal
krdla	bodla
krdl	aral
krdry	badry
krft	kraft
krftvn	breton
krg	kr
krg	kr
krgr	argo
krgr	argo
krhang	chang
krh	kr
kr	kr
krk	ark
krkraft	kraft
krkraft	kraft
krly	krey
krlyvs	orlys
krmr	arm
krmyk	kalmyk
krmyt	kermit
krnay	anay
krnfrd	kinard
krn	kan
krn	kan
krn	kan
krnl	aral
krnlys	kennys
krnlyvs	kennys
krns	kans
krnsvyk	kinsey
krnvl	kanal
krnyz	keny
krnz	kenz
krps	kips
krray	airay
krs	krs
krs	krs
krs	krs
krskyntyh	erskine
krslyk	grilk
krsn	krs
krsnr	kiser
krsnr	kiser
krsnv	krenn
krspv	krs
krst	kast
krstn	kast
krsts	arts
krt	art
krtlnd	arend
krtr	art
krtyn	bruyn
krtzr	arter
krvash	kresh
krvasz	akivas
krvb	krab
krvcfvrd	bradford
krv	kr
krvd	blvd
krvg	krug
krvkfvrd	bradford
krvk	krok
krvkn	irvin
krvl	aral
krvm	kram
krvm	kram
krvmh	kaveh
krvm	kram
krvm	kram
krvmn	irvin
krvmr	kovar
krvmy	kram
krvmyts	kermits
krvnhym	arnhem
krvny	kenny
krvnz	krenz
krvpyk	kropik
krvsby	crosby
krvscn	krasen
krvs	kris
krvsh	kresh
krvsn	irvin
krvsn	irvin
krvtyv	bruty
krvvd	arend
krvyl	kevyn
krvyn	kevyn
krvyr	kevyn
krvz	ariz
krvzyr	frazer
kry	fry
krycfyld	krystal
kry	fry
kryda	arya
krydr	bryde
krygan	aryan
kryg	krug
kryg	krug
krygr	kregg
krygr	kregg
kry	fry
kryk	krok
kry	fry
kry	fry
kryla	kayla
krylas	kaylas
kryl	aral
krylyz	allyz
krym	kram
krymn	aryan
kryn	bryn
kryn	bryn
kryn	bryn
krynz	krenz
krypyv	krey
kryqr	pryor
kryr	arya
krysan	aryan
krysayntay	krystal
krys	korys
krysc	korys
krys	korys
krys	korys
krysh	kresh
krysjh	kresh
krys	korys
krys	korys
krysp	crisp
kryspn	bryson
kryspyjn	crispijn
kryspyn	bryson
kryssayntyh	bryant
krysta	krista
krysta	krista
krystal	krystal
krystal	krystal
krystal	krystal
kryst	brest
krystlr	krister
krystmn	kresten
krystmn	kresten
krystn	bryson
krystr	kayser
krystv	krista
krystvf	krystal
krystvfr	krister
krystvfrsvn	kesterson
krystvn	kresten
krystvn	kresten
krystyana	kristian
krystyan	kristian
krystyan	kristian
krystyansn	krystals
krysty	kristy
krysty	kristy
krystyjnth	kristijntje
krystyjntjh	kristijntje
krystyjntj	kristijntje
krystyna	kristina
krystyn	kresten
krystynh	kresten
krystyn	kresten
krystyn	kresten
krystyn	kresten
krystynty	kresten
krysvayjn	krishan
krysvjyn	bryson
krysvyjn	krisoijn
krysvyn	bryson
krysvzn	bryson
krysy	korys
krysy	korys
krysy	korys
krysz	grosz
krytr	kyte
kryvas	grivas
kryvasz	grivas
kryvn	aryan
kryvsn	kayvon
kryvvnvz	kayvon
kryyk	kayak
krzna	erna
ksavan	kesavan
ksav	av
ksay	kay
ks	ks
ksk	ask
kskyn	karyn
ksl	ks
ksl	ks
ksln	kain
kslr	esler
kst	kast
kstlak	kostelak
kstl	karl
kstlvt	astley
kstnr	aster
kstrap	kastrup
kstr	aster
kstrcm	strum
kstrsvn	katrin
ksvan	asian
ksvn	kain
ksydy	addy
ksym	asim
ksym	asim
ktan	kan
ktara	kara
ktb	tb
ktcam	atram
kt	at
kt	at
ktlar	alar
ktl	tl
ktl	tl
ktlt	kalt
ktly	atle
ktnzrv	kanze
ktsymatyds	almatys
ktvla	atila
ktvyn	kevyn
kty	katy
kty	katy
ktyl	atul
ktz	katz
kvaayntn	kalyan
kvaknbas	kansas
kvaknbvs	evans
kva	ava
kval	val
kvalsyk	kalmyk
kvanbay	anay
kvang	kang
kvang	kang
kvang	kang
kvan	evan
kvanlan	kannan
kvanrad	konrad
kvanrad	konrad
kvanradt	kannada
kvanradvs	kannadas
kvanrdt	brandt
kvanryd	karyn
kvantvn	anton
kvarsky	kovarski
kvartzyth	karty
kvasman	kalman
kvast	kast
kvasym	asim
kvatryn	karyn
kvavryng	karyn
kvaylysy	kaylas
kvayman	ayman
kvayntana	santana
kvayntvn	paynton
kvayt	kalt
kvba	aba
kvb	av
kvb	av
kvbla	kubla
kvbn	avon
kvbsa	kobsa
kvbv	kibo
kvbv	kibo
kvbyb	kobb
kvbylah	kamilah
kvbyla	kayla
kvcar	bacar
kvc	ac
kvcran	karan
kvcy	ivy
kvcyh	koch
kvdamah	qudamah
kvdama	kama
kvdvgnv	advent
kvdy	addy
kvganda	kanda
kvglan	kaplan
kvglyn	evelyn
kvgvma	kogoma
kvhan	khan
kvhn	kuhn
kvjh	kaj
kvjyas	kenyas
kvkal	kokal
kvkalyk	kacalek
kv	av
kvkbrn	kakure
kvk	kok
kvkfyld	alfeld
kvk	kok
kvknbas	kansas
kvknj	avins
kv	av
kvk	kok
kvkryl	avery
kvksvn	kansan
kvktavay	koktavy
kvkvnn	kayvon
kvkvrk	kakure
kvkya	kaya
kvlasa	kolasa
kvl	akil
kvl	akil
kvlka	kafka
kvlmn	kalman
kvln	avon
kvln	avon
kvln	avon
kvlnv	kalev
kvlr	ivar
kvlsar	kelkar
kvls	als
kvlsvn	balson
kvlt	kalt
kvlty	kelty
kvlvl	all
kvlycala	kalevala
kvly	daly
kvly	daly
kvlyha	koliha
kvlyn	allyn
kvlyng	allyn
kvlyngvvd	klingler
kvlyns	karyns
kvlynz	allyn
kvlyr	kevlar
kvlys	julys
kvmar	kumar
kvmarv	kmart
kvmbr	kamb
kvmptvn	compton
kvmr	ivar
kvmr	ivar
kvmvrv	khmer
kvmvryta	komorita
kvn	kan
kvng	kang
kvng	kang
kvnka	benka
kvn	kan
kvn	kan
kvnrad	konrad
kvnrad	konrad
kvnradvs	konrads
kvnrat	konrad
kvnrat	konrad
kvnrayt	konrad
kvnryat	kenya
kvnt	kant
kvnv	kan
kvnvpka	konopka
kvnvr	abner
kvnvvr	denver
kvnyng	koning
kvpjanz	kaplan
kvpj	kaj
kvp	kip
kvpln	kaplan
kvplnd	copland
kvpls	karls
kvpnz	kenz
kvpr	apr
kvpr	apr
kvps	kips
kvradyny	bradely
kvram	avram
kvran	karan
kvran	karan
kvrapaty	koorapaty
kvrbt	kert
kvrbyn	karyn
kvr	kar
kvrdas	kordas
kvrds	fords
kvrdyk	cordy
kvrdz	kurd
kvrkam	avram
kvrkvl	kardal
kvrl	karl
kvrly	carly
kvrn	karn
kvrnlh	karish
kvrnlvs	karlas
kvrnlys	barneys
kvrnlyvs	barneys
kvrnlyvsn	aurkleven
kvrnlyz	allyz
kvrnval	bernal
kvrnyvl	karayel
kvrnz	karn
kvrp	karp
kvrsl	karl
kvrslv	karl
kvrsn	karan
kvrstn	kerstin
kvrt	kert
kvrth	barth
kvrtl	karl
kvrtlnd	cortland
kvrtlnt	arlet
kvrtrayt	abstract
kvrtz	bartz
kvrvnla	arvola
kvrvyn	karyn
kvrya	arya
kvry	kory
kvry	kory
kvrydvr	ryder
kvrygan	aryan
kvry	kory
kvry	kory
kvryla	karla
kvryl	beryl
kvrzayn	karan
kvsada	kasama
kvsak	bosak
kvsay	kasai
kvsh	kish
kvsjh	kish
kvsj	avs
kvsky	bosky
kvskymaky	koskimaki
kvslv	kislev
kvsmans	klemans
kvsmanz	isman
kvsmas	cosmas
kvsmns	avins
kvsnkv	evenki
kvsta	kosta
kvsta	kosta
kvstanza	costanza
kvst	kast
kvstn	kast
kvstrmn	kastein
kvstylv	kettyle
kvstys	dustys
kvsvgh	kaveh
kvsyn	karyn
kvsyra	assyria
kvsz	avs
kvta	akita
kvtcay	avichay
kvt	ket
kvtcy	kathy
kvtjanz	kattan
kvtla	kotla
kvtmayr	katmai
kvtny	kathy
kvtrvnyv	katrin
kvty	katy
kvtz	katz
kvvar	kovar
kvv	av
kvvs	avas
kvyalsky	kowalski
kvyalyk	kacalek
kvy	ivy
kvycy	alyce
kvyk	ivy
kvyknbas	guyanas
kvyknbvs	keynes
kvyl	beyl
kvyl	beyl
kvyl	beyl
kvylyn	evelyn
kvymn	kevyn
kvyn	kevyn
kvyn	kevyn
kvyn	kevyn
kvyn	kevyn
kvyn	kevyn
kvyn	kevyn
kvyn	kevyn
kvynrad	konrad
kvynrad	konrad
kvynrad	konrad
kvynrat	konrad
kvynrayt	koenraad
kvynrdvs	kannadas
kvynrydvs	konrads
kvynryt	avery
kvyntana	montana
kvyntn	bynon
kvynt	kant
kvyntvn	kenton
kvypr	kuyper
kvyryn	karyn
kvysman	kinsman
kvyst	kast
kvyt	ivy
kvyt	ivy
kvyykl	kayak
kvyylyn	evelyn
kvyyman	ayman
kvyymn	kalyan
kvyynln	avignon
kvyyntanar	quintanar
kvyyntvn	kenton
kvyy	ivy
kvyyst	kast
kvyyt	amyot
kvyytz	katz
kvyzmn	kayvon
kvzn	avon
kvzv	kazi
kvzy	ivy
kvzy	ivy
kvzyn	karyn
kyalasa	ayalas
kyasvn	kasun
kyat	keat
kyb	yb
kybh	ayah
kybl	kabal
kybl	kabal
kyblr	kabir
kyblr	kabir
kybv	kibo
kycn	ayn
kycrv	lycra
kycyn	karyn
kyd	kid
kyd	kid
kydl	ayda
kydra	hydra
kyf	alf
kyf	alf
kyfr	byer
kyfr	byer
kygan	ayman
kygynz	karyn
kyhl	kohl
kyhv	kiev
kyjv	kaj
kykbrd	byrd
kykbryd	ackroyd
ky	k
ky	k
ky	k
ky	k
kyk	kok
kykvma	kikuma
kylan	dylan
kylbay	kilby
kylbrv	aylor
kylby	kilby
kylbyn	kilby
kylg	kilg
kylgvr	alger
kylh	kyle
kylhvrn	kelvin
kyl	kyle
kyl	kyle
kyl	kyle
kylpk	kalpak
kylr	kyle
kylr	kyle
kylr	kyle
kylrmt	klimt
kylt	kalt
kyly	kyle
kylyvn	kalyan
kylz	kyle
kymbal	kabal
kymbrly	kimberly
kymbry	amery
kym	kam
kym	kam
kympa	kama
kymv	kam
kymvn	ayman
kymvra	aymara
kymz	kam
kyna	dyna
kynan	ayman
kynann	kinane
kynard	kinard
kyn	ayn
kyncn	bynon
kyngastvn	kingston
kyngfay	kingfai
kyngry	kingery
kyngsfvrd	kingsford
kyngstvn	kingston
kyngztn	kingdon
kynh	ayah
kyn	ayn
kyn	ayn
kyn	ayn
kyn	ayn
kyn	ayn
kyn	ayn
kyn	ayn
kyn	ayn
kynknn	bynon
kynkyd	kinky
kynmn	bynon
kynmn	bynon
kynrsly	kingsley
kynsla	ayala
kynsl	kanal
kynsmn	kansan
kynsvn	kansan
kynt	kant
kynt	kant
kyntl	kanal
kyny	keny
kyny	keny
kynyny	kenny
kynyvn	kenyan
kynz	kenz
kynzman	kinman
kynzy	kanze
kyp	kip
kyp	kip
kyp	kip
kyplyng	kipling
kypyng	ayling
kyra	byra
kyran	karan
kyras	karas
kyrbay	kirby
kyrby	kirby
kyr	cyr
kyrk	kirk
kyrta	barta
kyrty	karty
kyrvn	byron
kyryl	beryl
kyrysy	korys
kysa	ayda
kys	krs
kys	krs
kys	krs
kys	krs
kyslv	kislev
kysnrvs	kislevs
kysr	ayse
kysr	ayse
kystvfr	eyster
kysvn	ayson
kysy	ayse
kysydy	kasaty
kysy	ayse
kysynjr	kastner
kysyn	ayson
kytagvcy	kitaguchi
kytamvra	kitamura
kytc	kyte
kytcn	katen
kyt	ket
kyt	ket
kyt	ket
kyt	ket
kyt	ket
kytl	kyte
kytly	kathy
kyts	kits
kyty	katy
kytyng	tyng
kyv	av
kyvcy	crecy
kyv	av
kyvk	eyck
kyvkyvlys	beverlys
kyvmr	kovar
kyvng	byung
kyvng	byung
kyvng	byung
kyvs	avs
kyvsmatv	kamath
kyvyvaly	kalevala
kyvzvn	kayvon
kyzr	byer
kzmnz	kenz
'laaldyn	alaaldin
labat	laban
labdn	laban
labdvn	labdon
labkyn	laban
labla	layla
labl	lal
lab	la
labrad	labroad
labryvla	labriola
labsr	aabar
labyn	laban
lacln	bacon
lacns	lacys
lacyny	lacey
ladasky	ladasky
ladr	badr
ladrvt	adept
ladvn	adan
ladvvyka	divya
ladvvykvs	addicks
ladvyg	ladwig
ladyk	ladak
'ladyn	gladys
ladyvyl	advil
lafam	adam
lafavntyn	lafayette
lafgryn	lofgren
lafvrkad	labroad
lafy	lacy
lagrlyng	lagerling
lagrstrvm	lagerstrom
lagvmvrvf	lagomorph
lagvn	dagan
lahlma	lahelma
lahyj	lahij
laj	haj
lajrbrg	barbra
lakay	laky
lakh	laky
laklh	akl
lak	bak
lak	bak
lak	bak
lak	bak
lakr	laky
laks	lais
laksv	aksu
laksyn	calsyn
'lakvabah	alaqabah
lakvtvrh	laith
lakvvd	akiva
laky	laky
laky	laky
lakysa	lacys
lalkyn	allyn
lal	lal
lals	als
laly	laly
lalyt	lalit
lamark	lamark
lamastvs	lamastus
lambard	lombard
lambardv	lombard
lambda	lambda
lambly	gamble
lambrn	lamborn
lambrt	lambert
lambrvs	lambros
lambvly	lamboley
lambvrn	lamborn
lambvrn	lamborn
lam	lam
lam	lam
lamplayt	lampani
lampn	lamp
lampy	lamp
lampyt	lamont
lamrs	lamars
lamvrs	lamars
lamykyn	lamykin
lana	lana
landagr	landahl
landastrvm	lundstrom
landayr	landahl
landbrg	lander
landgrn	landen
landgryn	landry
landkvyyst	landrys
land	land
landl	land
land	land
landmn	landen
landn	land
landr	andr
landrs	landers
landrvm	landrum
landry	landry
landrz	landry
landyn	landen
landyn	landen
landys	andys
langdvn	langdon
lang	lang
lang	lang
lang	lang
langly	langley
langnz	lang
langsa	langs
langsav	landsat
langstvn	langston
langsv	langs
langv	lang
langyr	bangor
lanj	lan
lanka	lanka
lankart	lonkart
lankstaf	blanstan
lanktvn	lankton
lan	lan
lan	lan
lan	lan
lan	lan
lanr	lan
lanr	lan
lansdyl	andy
lansfrd	lunsford
lans	alans
lanstz	lantz
lansyng	lansing
lanta	lana
lant	iant
lantlvsamad	lantlosamade
lantrman	lanterman
lantz	lantz
lantz	lantz
lanvm	lam
lanvsy	lanas
lany	lacy
lany	lacy
lanz	lanz
lapasv	lapaso
lap	lap
laplayn	kaplan
lap	lap
lapvrd	laird
lapvrs	aprs
lapvrt	laporta
lapvta	laputa
lapvvrs	anvers
lapydary	lapidary
lapyskv	lacys
lara	lara
laraly	araby
lardynga	flardinga
larja	lara
larj	lara
larn	barn
larns	laras
larns	laras
larsn	lars
larsn	lars
larsvn	larsen
lartr	larter
larvc	alaric
larvkvyh	barakah
larv	harv
larvrl	larry
laryf	arya
larysa	arya
laryvyr	carver
larz	lanz
laskala	lascala
laska	laska
laskary	baskar
lask	ask
laskvs	laskos
las	las
las	las
las	las
lasnyk	lasnik
last	last
lastra	lastra
lastr	laser
lastry	lastra
lastyng	astana
lasvn	basin
lasyngr	casner
latala	latala
lata	lana
latam	latham
latbry	landry
latbvry	lathbury
latkynz	atkins
lat	at
latz	blatz
lavandh	lawanda
lavayn	laan
lavd	land
lav	av
lav	av
lavls	als
lavmn	avon
lavnka	lanka
lavnyvs	lannys
lavray	airay
lavrns	laverns
lavstad	lovstad
lavtn	avon
lavtvn	latin
lavygnh	lavigne
lavyn	avon
lavyt	davy
lavzak	ganzak
layan	jayan
laybs	bayes
laybz	fayiz
laydvyna	ladonna
laydya	ayda
'laydyn	aladdin
layhv	laiho
laykz	fayiz
lay	clay
layl	lal
lay	clay
laymak	ayman
laymb	lamb
laynd	land
layng	laing
layn	ayn
layn	ayn
layrd	laird
laytbrn	bayern
laytmn	clayton
laytnyng	ayling
layv	av
layv	av
layv	av
layvly	bayly
layvrytsn	landrys
layvsay	ladasky
layvvy	lavey
layvy	bayly
'layyn	alain
lazara	lazara
lazard	lazard
lazarv	lazar
lbanrd	baird
lbanvrd	baird
lbdan	abyan
lbdvn	ebdon
lbn	lan
lbrynydys	brandys
lbvn	ben
lbvr	alber
lbvrt	albert
lclh	cl
lcmn	lymn
lcmr	cm
lcnr	cr
ldfvrd	ledford
ldj	ada
ldk	lok
ldvaydj	edvard
ldvyk	levy
lf	alf
lflr	fla
lftvs	letas
lg	ag
lhan	chan
lhlh	lal
lhman	lehman
lhman	lehman
lhmn	lymn
lhmn	lymn
lhnrr	herr
lhrntz	lantz
lhryan	aryan
lhyj	haj
lhy	ley
lj	j
lkambr	kamb
lkrn	akin
lkrvs	kris
lks	bks
lksn	akin
lkvst	kast
lky	laky
lmbrn	laban
lmbrn	laban
lmbrt	kmart
lmbvrnh	lamborn
lmbvrn	lamborn
lmbvrn	lamborn
lmbvvrn	lamborn
lm	alm
lmp	lamp
lmpyng	lamping
lmrz	emre
lmvn	amin
lmyr	emyr
lndahl	landahl
lndavr	adar
lnd	and
lndry	landry
lndrz	andr
lndvay	lendvai
lndy	andy
lndyn	andy
lndynv	andy
lndz	lodz
lngly	angle
lnglyng	england
lngmyd	ingmar
lngmyd	ingmar
lngss	angus
lngstn	langston
lngstvn	langston
lnky	laky
lnlvsamad	lantlosamade
lnlvzamyd	bellamy
lnndn	land
lnrt	art
lns	ins
lnsvn	anson
lntlvsamad	lantlosamade
lntlvsamyd	lantlosamade
lntyn	anton
lpard	lepard
lpart	alpert
lpla	lela
lp	l
lpvrs	aprs
lpvrta	laporta
lpvvrs	anvers
lrap	lap
lrbz	ariz
lrd	lord
lrmn	lymn
lsard	allard
lsly	laly
lsr	lr
lsr	lr
lst	last
lsyak	kayak
ltbry	larry
ltjy	lacy
ltryj	lory
ltv	lt
lvalay	laly
lvats	loats
lvayngh	laing
lvaynj	ayn
lvayn	ayn
lvbv	lvov
lvbvtyn	bruyn
lvbyn	laban
lvc	loc
lvdmn	lodman
lvdvrf	ludorf
lvdvvyka	divya
lvdvvykas	dhakas
lvdvyjk	ladak
lvdvyka	aviva
lvdvykas	dhakas
lvdvyk	ladak
lvdvyks	levys
lvdvykvs	dykes
lvdvysvs	levys
lvfarv	lofaro
lvfasv	lofaso
lvfbarv	lofaro
lvfr	fr
lvfstrvm	lofstrom
lvgh	bligh
lvgndra	logendra
lvgz	lanz
lvjyk	aveek
lvka	aka
lvkard	lazard
lvkas	avas
lvk	lok
lvk	lok
lvk	lok
lvk	lok
lvk	lok
lvk	lok
lvkn	alvin
lvks	alves
lvkstvn	liston
lvkv	lvov
lv	av
lv	av
lv	av
lvmas	limas
lvmbardv	lombard
lvml	lal
lvm	lam
lvmn	lymn
lvnan	avian
lvnav	lana
lvndan	landen
lvnd	land
lvndvn	landen
lvnj	lan
lvn	lan
lvn	lan
lvnly	laly
lvnmv	lvov
lvnyg	lang
lvny	gony
lvny	gony
lvny	gony
lvnyngdal	lonningdal
lvnz	lanz
lvnz	lanz
lvpatkyn	lupatkin
lvp	lap
lvpr	apr
lvprsty	lopresti
lvpyn	lyn
lvpz	lanz
lvra	lara
lvra	lara
lvrc	lara
lvrd	lord
lvrjyv	larry
lvrna	lorna
lvrn	alvin
lvrns	alvins
lvrnt	bernt
lvrntzn	lantz
lvrnz	lanz
lvrnzn	lann
lvrnzv	ivanov
lvrnzy	barney
lvrtvn	lorton
lvrty	karty
lvry	lory
lvry	lory
lvry	lory
lvry	lory
lvry	lory
lvsantvs	losantos
lvs	avs
lvs	avs
lvsmvr	lamar
lvsrv	lvov
lvsskv	laska
lvst	last
lvstr	laser
lvsty	lusty
lvsyh	lash
lvsy	avs
lvsy	avs
lvsy	avs
lvsytv	last
lvtbg	attig
lvtmpyv	lamp
lvtr	ivar
lvtynz	lanz
lvtz	lutz
lvvra	elvira
lvvrjat	lauverjat
lvvt	last
'lvy	alva
'lvy	alva
lvyd	loyd
lvy	ivy
lvy	ivy
lvyndn	lynda
lvyng	laing
lvyn	lyn
lvyn	lyn
lvynsvn	evenson
lvys	levys
lvysyly	lyly
lvysyvr	eyster
lvyyngh	loyang
lvyyng	loyang
lvyysaly	laly
lvyyzv	lvov
lvyz	allyz
lvzanv	lozano
lvzyr	lazar
'lya	alya
'ly	ely
'lya	alya
'lya	alya
'lya	alya
lya	alya
'ly	ely
'ly	ely
lyam	lam
lyang	lang
lyanz	lanz
lyav	alya
lybannrd	libannord
lybanvrd	libannord
lybcn	laban
lybl	lal
lyblyt	liblit
lybmn	lymn
lybrcak	labroad
lybrg	libra
lybrn	laban
lybrty	liberty
lybryk	librik
lybskamb	kamb
lybsn	laban
lybvrn	barn
lybvytz	babitz
lybyd	lebed
lyby	lyly
lycarsvn	carson
lycfyld	alfeld
lyc	loc
lycmr	lycra
lyctn	lycra
lycvrvyys	lycurgus
lydal	lidal
lyda	ayda
lyd	loyd
lydman	lodman
lydn	lymn
lydn	lymn
lydrak	badrak
lydrdrap	hydra
lydrdrp	byrd
lydrdrvp	burrup
lydrdvrp	leiderdorp
lydr	andr
lydvr	lidor
lydvyna	dvina
lydya	lydea
lydya	lydea
lyfayv	fay
lygyv	lyly
lyhy	lyly
lyk	lok
lykyvry	kerry
lyla	layla
lyla	layla
lyla	layla
ly	ely
lylbk	lylah
ly	ely
ly	ely
ly	ely
ly	ely
ly	ely
lyly	lyly
lyly	lyly
lylynd	hyland
lylyntal	antal
'lyma	alima
'lym	alim
'lyma	alima
lymbax	lomax
lymbvrg	limburg
lym	lam
lymn	lymn
lymr	lyme
lymyng	liming
'lyn	lyn
lynan	lyman
lynars	iyars
lyndal	lindal
lyndan	lynda
lyndbk	lynda
lyndbrg	lindberg
lyndgard	lindgard
lyndgrn	lindgren
lyndhlm	lindholm
lynd	land
lynd	land
lyndl	lendl
lyndl	lendl
lyndmn	lyndon
lyndmn	lyndon
lyndn	lynda
lyndnmvt	landman
lyndr	lynda
lyndrmn	lyndon
lyndrvts	landrys
lyndsy	lynds
lyndvn	lyndon
lyndz	lynda
lyndzy	landry
lyngas	lyndas
lyngly	langley
lynhan	lehan
lynh	lyn
lynkh	lynch
lynk	link
lynkln	lyndon
lynkvln	lankton
lynkvys	landrys
lyn	lyn
lyn	lyn
lyn	lyn
lyn	lyn
lyn	lyn
lyn	lyn
lyn	lyn
lynstrat	lastra
lynval	laval
lynvnn	lyndon
lynvra	lenora
lypard	lepard
lypkyn	lipkin
lypskamb	lipscomb
lypskmb	lipscomb
lypskm	epsom
lypskvmb	lipscomb
lypskvmp	lipscomb
lypst	gypsy
lypyj	lyly
lyr	cyr
lyr	cyr
lyrn	lymn
lyrykal	lyrical
lyryk	lory
lysbth	blyth
lysbtjh	lysbethje
lysbtj	last
lysbtjy	lusty
lyskanv	alaskan
lyskmb	lamb
lyskn	alyson
lysky	bosky
lys	las
lysn	lymn
lysn	lymn
lystr	eyster
lystvn	liston
lysvn	alyson
lysvn	alyson
lysy	lyly
lysyn	alyson
lyt	lot
lytl	lytle
lytltvn	litton
lytly	lyly
lytmn	lymn
lytn	lymn
lytrl	litel
lytv	blyth
lytvn	latin
lytvn	latin
lytvyn	litvin
lyva	lyra
lyvandn	hyland
lyvandvn	landen
lyvayn	lyman
lyvbvny	lyubovny
lyvh	ayah
lyv	lye
lyv	lye
lyv	lye
lyv	lye
lyv	lye
lyvnard	lenard
lyvnardv	lenard
lyvndvn	lyndon
lyvngvd	byung
lyvn	lymn
lyvnl	laval
lyvnsbry	lounsbery
lyvnvra	lenora
lyvnz	lanz
lyvvh	lylah
lyvv	levi
lyvy	levy
lyvyngstvn	livingston
lyvyn	kevyn
lyvyn	kevyn
lyvys	levys
lyvyv	levy
lyvyvs	levys
lyvyvy	levavy
'lyyah	aliyyah
lyyl	beyl
lyyvvh	lylah
lyza	liza
lyza	liza
lyzard	lazard
lyzardz	lazard
lyzbty	buzby
lyz	liz
lyzn	lymn
lyzr	byer
lyzvt	bizet
mabanag	mabanag
mabay	malay
maby	macy
mac	mac
mactld	machteld
madaba	madaba
madaks	adams
madj	hadj
madlyn	madelyn
madlyn	madelyn
madlyn	madelyn
madn	madon
madrvn	madden
madsn	madon
madvn	madon
madvray	madras
madygan	madigan
mady	mady
madys	macys
madysvn	madison
madyv	mady
mafry	mary
mafyn	ayn
magagna	magagna
magard	jagard
magdalynth	magdalena
magd	magda
maglyrv	hagler
magr	mager
magrvdr	magruder
mags	ags
magvayr	magyar
magvyr	mager
magyl	daryl
mahadvan	mahadevan
mahajan	mahajan
mahalt	mahala
mahaly	mahaly
maha	maha
mahavlt	mahault
mahtv	mahto
mahvlt	mahala
mahvt	mah
majv	maj
majy	macy
majyv	macy
makarayg	macaraeg
makayvly	mahaly
makk	mack
maklaqlyn	allyn
mak	mak
mak	mak
mak	mak
makryj	mary
maksvl	makil
maksy	aksu
maksym	akeem
maksymylyan	ashmolean
makv	mak
makvmbr	macomber
makvnvcy	dancy
makvsy	macvoy
maky	laky
makynvn	bakunin
makyras	mayras
makysak	maysan
makzym	akeem
malamvd	malamud
malan	malan
malbrg	malberg
mald	bald
maldn	malan
malkvk	alok
malkvm	albom
maln	main
malnr	malnar
malrvny	albany
maltyn	maltin
malvn	malan
malvny	macvoy
malygan	kalyan
malyk	alok
mama	mama
mamfvrd	mumford
mamn	main
mamrt	mamet
mamy	amy
manama	manama
mana	mana
mana	mana
manbr	manber
manc	mac
mandal	mandal
manda	manda
mandar	mandar
mandavyl	mandal
mandl	mandl
mandr	andr
mandy	mandy
mangan	mangan
manglany	manglani
mangr	andr
mangyn	mangan
manjyt	manjit
manjyt	manjit
manka	lanka
mank	bank
mankrt	manet
manks	banks
mankvs	banks
manky	macky
manly	mandy
manma	mama
man	man
manrv	marv
mansn	manin
manstr	mansur
mansyl	hansel
mansyngr	lansing
manta	malta
mantl	mandl
mantnz	lantz
mantras	andras
mantvr	mantor
mantyks	mandys
manty	mandy
manvly	macvoy
manvly	macvoy
manv	man
manv	man
manv	man
manv	man
manvry	gantry
manx	manx
manyja	manija
manyks	banks
many	many
many	many
manyng	manin
manyskas	maniskas
manys	macys
manyt	manet
manyv	many
manz	danz
mapartyda	malpartida
maplz	maple
maraly	mahaly
marany	marani
marat	marat
marazas	marazas
marbac	marbach
marbl	marble
marc	marc
marcyndv	maranda
mardr	marder
mardvc	marc
marfy	marcy
margalta	margarita
margalyty	margaret
marganth	amarnath
margant	largent
margarta	margarita
margaryta	margarita
margarytay	margarita
margarytjh	margaret
margarytj	margaret
margarytj	margaret
margarytjy	margaret
margaryt	margaret
margaryt	margaret
margaryt	margaret
margaryty	margaret
marglyn	marilyn
margrta	margarita
margryjh	margery
margryta	margarita
margryth	margret
margryth	margret
margrytj	margret
margrytjy	margret
margryt	margret
margrytyh	margret
margvlyn	margolin
margvlys	margerys
margvlyvks	margerys
marjnt	manjit
markham	markham
markly	markey
mark	mark
mark	mark
marks	marks
marksn	marks
markstynr	marksteiner
markv	mark
markv	mark
markvm	marcum
markvpvly	marcopoli
markvs	marks
markvs	marks
markvs	marks
markvyt	markey
markvyza	maritza
markvz	mark
markyl	darryl
marky	macky
markyngtvn	tarkington
markyyvs	marcys
marla	marla
marlat	marat
marl	carl
marly	carly
marlyn	marilyn
mar	mar
marn	barn
marpl	marple
marrl	marrs
marsal	marsala
marsla	marla
marsl	mars
marslv	marble
marslynv	marilyn
mars	mars
mars	mars
marstvn	marston
marsy	marcy
martl	marta
martlnd	martland
martn	marin
martntjy	martyntje
martyjn	martijn
martyjn	martijn
martyjntjh	martijntje
martyjntjy	martijntje
marty	marty
marty	marty
martynh	martyn
martynj	martyn
martynj	martyn
martyn	martyn
martyn	martyn
martynsn	martens
martynth	martyn
martynth	martyn
martyntjh	martyntje
martyntj	martyntje
martynt	martyn
martynt	martyn
martynv	martyn
martynvs	martens
martynz	martyn
martynz	martyn
martynz	martyn
martyzn	martyn
martyzntj	martyntje
martz	martz
marvaha	marwaha
marvcy	marcy
marv	marv
marvn	marin
marvn	marin
marvny	garvey
marvyn	martyn
marvyn	martyn
marvyt	marvit
marxam	mara
marya	arya
maryana	mariana
maryan	aryan
maryganth	marregante
marygant	maryann
maryh	march
maryjh	march
maryjh	march
maryjkn	marijken
maryj	mary
maryjnt	maryann
marykandv	maryland
marykn	aryan
marylyn	marilyn
mary	mary
mary	mary
maryn	karyn
marynv	karyn
marysh	marsh
marys	marys
marysvn	maryann
maryth	barath
maryth	barath
marytj	marytje
marytj	marytje
marytjy	marytje
marytjy	marytje
maryt	marat
maryt	marat
maryv	marv
maryvs	marys
maryyany	maryann
maryz	martz
marzk	marek
marz	marz
masahyrv	masahiro
masara	masada
masataka	masataka
masatv	masato
masayv	malay
masbrg	hasbro
maskary	baskar
maskl	akl
mask	ask
maskyas	masadas
masld	masud
maslly	bally
masna	masna
masna	masna
masrmn	marin
mastn	masin
mastyr	aster
masvn	masin
masyk	masek
masy	macy
masymv	asama
masyn	masin
matakv	matako
mata	mata
matana	matana
matar	matar
matay	malay
matjka	matejka
matlv	atle
mat	mat
matsvda	matsuda
matsvmvtv	matsumoto
matsvn	matson
matvla	matula
matv	marv
matvr	matar
matvs	mats
matynv	martyn
matys	katys
matys	katys
matyv	katy
matyvs	matyas
mavbay	mackay
mavby	mawby
mav	av
mav	av
mav	av
mavn	main
mavpyn	martyn
mavr	mair
mavrs	marrs
mavsr	avs
max	max
mayfyld	mayfield
mayklys	ayalas
mayklzn	jacklyn
mayk	mack
maykn	mayan
maykvhn	kayvon
maykvk	mayank
mayln	mayan
may	may
may	may
maymvn	ayman
mayndrt	maynard
mayn	ayn
mayn	ayn
maynr	mayer
mayr	mayr
mayr	mayr
mayr	mayr
mayr	mayr
mayr	mayr
mayrn	mayan
mayrs	marrs
mayryk	marek
mayrz	marz
maysal	maysan
maysa	mansa
maysl	mays
maystyk	mayston
maytag	maytag
maytham	latham
mayt	mast
mayt	mast
mayty	marty
mayvhay	abhay
mayv	marv
mayz	marz
mazra	macra
mbark	bark
mcld	auld
mctld	mutlu
mdaba	madaba
mdavr	adar
mdba	aba
mdh	mah
mdlyn	allyn
mdnyk	many
mdnyt	manet
mdrk	mark
mdrr	adar
mds	mds
mdsn	mds
mdsvn	madsen
mdvna	adana
mdyna	dyna
mdynh	dyna
mdynh	dyna
mdyn	adan
mdynny	danny
mdynt	dent
mdysvn	dyson
mdysvn	dyson
mfrg	afra
mfrk	mark
mfrvk	marek
mgdalnt	grant
mgdalyntj	madelyn
mgdalyyntjh	magdaleentje
mgda	magda
mgdayntj	dante
mglaglyn	allyn
mglat	aoglat
mgnan	magnan
mgnasn	ignasi
mgnh	agni
mgny	many
mgr	mar
mgy	may
mgy	may
mgy	may
mgynl	mayne
mgys	mays
mgysy	gypsy
mgyv	marv
mhadvan	mahadevan
mhama	mama
mharak	horak
mhl	mehl
mh	h
mhma	mama
mhrah	mahrah
mhra	mara
mhrg	berg
mhrh	mach
mhrk	mark
mhrm	arm
mhvyt	chet
mjdl	fadl
mj	j
mjya	maya
mjyd	boyd
mjykal	alukal
mjyk	mack
mkah	mah
mkalyr	malur
mka	aka
mkardl	kardal
mkdaln	medan
mkdrmvt	kermit
mkdvlnd	midland
mkdvnald	mcdonald
mkdvnald	mcdonald
mkdvyl	advil
mkfarlnd	mcfarland
mkfarlyn	charlyn
mkfrlyn	charlyn
mkgavyn	mcgavin
mkgrat	marat
mkgvvan	kevran
mkgvyrk	mcguirk
mkgvyr	ingvar
mkgyry	gary
mkh	mah
mkh	mah
mkhnry	mchenry
mkkah	mekkah
mkkan	akkad
mkkarty	karty
mkkarty	karty
mkkavn	akkad
mkkna	kana
mkkny	keny
mkknzy	kanze
mkkrkn	akron
mklaglyn	allyn
mklaqlyn	allyn
mklarn	karn
mklavlyn	allyn
mklavlyn	allyn
mklavvgyng	lavigne
mklyn	allyn
mklyn	allyn
mk	bk
mk	bk
mkmahan	mcmahan
mkmahvn	mcmahan
mkmahvn	mcmahan
mk	bk
mkmanys	mcmanis
mkmvln	akman
mkmylan	akman
mknat	keat
mknyl	knel
mknyl	knel
mkra	mara
mkrayh	mirach
mkray	moray
mkrdy	cordy
mkrvn	akron
mkrys	marys
mksfyld	alfeld
mksn	akin
mksymv	syme
mktavys	italys
mkvc	mac
mkvtv	akita
mkvy	davy
mkvy	davy
mkyl	mkel
mky	may
'ml	akl
mla	ala
mlandr	andr
mlany	many
mlayyr	layer
mlbay	alba
mlcr	alar
mlcyr	cyr
mlka	melka
mlkvlm	kelm
mlkvm	albom
mlmn	alan
mln	ln
mlr	lr
mlth	myth
mlv	al
mlvn	alan
mlvr	alar
mlybv	alba
mlydy	clyde
mly	ely
mlyngr	bryner
mlyn	lyn
mlyny	flynn
m'ma	mama
mmh	mah
mmta	mamta
mnama	mama
mnamh	mach
mnard	menard
mndl	mandl
mndl	mandl
mndl	mandl
mndr	andr
mndvza	mendoza
mndybl	andy
mndyk	andy
mndy	andy
mndz	and
mnfvl	angel
mngan	mangan
mngh	anghe
mng	eng
mngs	megs
mnhart	enyart
mnh	mah
mnjyvn	mayan
mnk	mak
mnkvsv	mikes
mnkyvs	andys
mnma	mama
mnnyng	manning
mnrv	marv
mnsa	mansa
mnsn	mns
mnstryna	menestrina
mnsvr	mansur
mnsvr	mansur
mnsvr	mansur
mnsvry	mistry
mntl	anil
mnt	mat
mntqh	menth
mntsr	mantor
mntsynn	mantsinen
mnty	monty
mntzr	mantor
mnyjr	mayer
mnyks	macks
mny	many
mny	many
mnyng	enying
mnyn	amnon
mnzr	andr
mnzs	mns
mnzyz	allyz
mpl	mel
mpl	mel
mqbrh	babah
mqrby	darby
mqsvd	masud
mranda	manda
mrdys	andys
mrdyt	mady
mrhavs	mohacs
mrjynyv	arjuna
mrkl	akl
mrkly	markey
mrknt	brant
mrkr	ark
mrnda	manda
mrny	many
m'rq	mar
mrsr	mrs
mrsrya	misra
mrsryv	drury
mrtn	amran
mrtnz	franz
'mr	mr
mrvah	grah
mrvan	amran
mrygan	aryan
mryj	arya
mryk	ark
mryks	eriks
mryman	aryan
mry	fry
mry	fry
mrymn	aryan
mrynly	bayly
mrys	marys
mryt	art
mrz	marz
msalxy	malay
msa	isa
msandr	andr
msbarn	barn
msks	omsks
mskyn	miskin
mslyn	allyn
msman	isman
msr	mar
mss	mass
mstan	mastan
mst	mast
mst	mast
mstrz	marz
ms'vd	asaad
msyf	asif
msyna	dyna
msyngr	synge
msyn	ayn
msyvs	mayas
mtana	mana
mtlyn	allyn
mt	mt
mt	mt
mtna	etna
mtna	etna
mtrnc	marc
mtrnyc	manny
mtrv	marv
mtrync	bryn
mtsgr	ats
mtsvmvtv	matsumoto
mtsvn	masin
mtvr	mair
mtyn	ayn
mtyn	ayn
mtyv	marv
mtyv	marv
mtyv	marv
mtyvs	matyas
mtyvs	matyas
mtyvsvn	maysan
mtyvz	fayiz
mtzgr	metzger
mtzyng	metzing
mvalr	ivar
mvanzr	andr
mvbay	dubay
mvbly	mable
mvdgyl	gudgel
mvd	md
mvdy	mady
mvdy	mady
mvfad	mead
mvganty	moganti
mvhama	bahama
mvhan	mohan
mvhr	bohr
mvkasa	mukasa
mvk	mak
mvkryj	avery
mvlandr	melander
mvldn	malan
mvlk	falk
mvl	mel
mvln	avon
mvlr	ivar
mvlr	ivar
mvlvy	malay
mvlygan	kalyan
mvly	daly
mvlynary	malnar
mvmfvrd	mumford
mv	av
mvnagan	monagan
mvnak	kanak
mvnakv	kanak
mvnaz	mana
mvndfrans	mondfrans
mvndvr	mandar
mvnkar	menkar
mvnk	monk
mvnks	monks
mvnkz	menke
mvn	man
mvn	man
mvnrv	marv
mvns	mans
mvntag	montag
mvntagv	montag
mvntalbanv	montalbano
mvnta	monta
mvntanarv	montanaro
mvntanv	montana
mvntgmry	montgomery
mvntgvmry	montgomery
mvnt	mont
mvntral	mineral
mvntrv	gantry
mvntvya	montoya
mvntyjv	montijo
mvnvlyt	cuneyt
mvnyz	many
mvnzlr	manber
mvrabytv	morabito
mvrad	murad
mvral	amaral
mvrals	arals
mvralt	muralt
mvra	mara
mvrandv	maranda
mvran	moran
mvranv	marani
mvras	maras
mvravan	moravan
mvray	moray
mvrayns	morans
mvrc	marc
mvrdac	myrdal
mvrdak	marduk
mvrfy	marcy
mvrhavs	durhams
mvrhavs	durhams
mvrkl	mark
mvrkn	marin
mvrlan	morlan
mvrl	burl
mvrl	burl
mvrl	burl
mvrlyj	carly
mvrly	carly
mvrman	amerman
mvr	mar
mvrnyng	morning
mvrs	mars
mvrs	mars
mvrs	mars
mvrstad	maurstad
mvrtan	marian
mvrtn	marin
mvrtvn	marten
mvrtymr	marty
mvrtymr	marty
mvrty	marty
mvrtymvr	mortimer
mvrv	marv
mvrvny	cerveny
mvrvyl	beryl
mvryl	beryl
mvry	mary
mvry	mary
mvryn	bryn
mvrysn	marys
mvrysvn	bryson
mvrysvn	bryson
mvryta	marta
mvsal	masai
mvsana	mana
mvsfys	missys
mvsla	avila
mvsmn	masin
mvs	avs
mvsvn	masin
mvsvy	missy
mvsyg	avs
mvsy	avs
mvsyr	mayr
mvsyvn	masin
mvsz	avs
mvta	mata
mvtana	matana
mvt	mat
mvtvr	matar
mvtvrz	marz
mvtysv	katys
mvvr	ivar
mvyl	beyl
mvy	ivy
mvynyhan	moynihan
mvynz	mayne
mvyr	mayr
mvysan	maysan
mvys	mays
mvyss	marss
mvysvn	maysan
mvyz	ivy
mvyzvn	mayan
mvzyna	mozina
mvzz	marz
myav	av
myayndrt	maynard
mycalys	ayalas
myca	myra
mycan	ayman
mycaylys	carlys
mycl	cl
mycltjn	maclean
mycltn	dylan
mycltyn	jaclyn
myclys	macys
mycn	ayn
mydlbrv	mylar
mydltn	medlin
mydltvn	maltin
myd	md
mydr	myer
mydy	mady
mygn	ayn
mygnran	magnan
mygnry	cagney
mygr	myer
mygr	myer
mygvyl	magill
myhalyk	mahaly
myhan	mohan
myjr	myer
myjry	mary
mykak	mak
mykalk	ayala
myka	mika
mykas	myras
mykayl	mikael
mykayyl	mikael
mykayylyz	allyz
mykayylz	kayla
mykk	eyck
myklacln	dylan
mykljn	dylan
myklm	akl
myklsn	dykes
myklsvn	abelson
myk	mak
mykna	myrna
mykr	myer
myks	amys
myks	amys
myks	amys
mykt	myst
mykvk	dekok
mykvlyk	kalmyk
mykv	mak
mykyng	mekong
mykynz	dykins
mykz	mak
mylad	milad
mylam	milam
mylam	milam
mylan	dylan
mylara	melara
mylard	mylar
mylar	mylar
mylasys	malays
mylbrt	milbert
myldrd	mildred
mylgram	milgram
mylks	milks
mylkv	melka
mylky	milky
mylman	melman
mylman	melman
mylmv	mylar
myln	ayn
mylnr	mylar
mylnvr	malnar
mylnyvm	lyly
mylr	myer
mylstvn	alston
mylt	milt
mylt	milt
myltn	dylan
mylvard	aylward
mylv	kyle
mylvs	myles
mylvt	melva
mylyanz	balfanz
mylygan	dylan
mylykn	allyn
myly	lyly
myly	lyly
myly	lyly
mylynd	hyland
my	amy
mymas	mimas
my	amy
my	amy
mymy	amy
myna	dyna
myna	dyna
mynamv	manama
mynard	maynard
mynard	maynard
mynaryk	masaryk
myndrt	mindt
myngv	meng
mynky	funky
myn	ayn
myn	ayn
myn	ayn
myn	ayn
myn	ayn
mynral	mandal
mynr	myer
mynrva	marva
mynrz	marz
mynsr	mans
mynstrl	minstrel
mynsy	gypsy
myntakah	mintaka
myntakva	mintaka
myntka	mintaka
mynt	mont
myntr	manti
myntvn	minton
myntz	mintz
mynvaryng	mainwaring
mynyard	minyard
myny	many
mynz	ayn
mynz	ayn
mypl	maple
myra	myra
myra	myra
myrankr	miranker
myrfld	myrtle
myr	cyr
myrmak	mirmak
myr	cyr
myr	cyr
myr	cyr
myrs	mars
myrsy	gypsy
myrty	marty
myrva	marva
myrvl	cyril
myrvt	marat
myrydyt	myrdal
myrz	marz
myrz	marz
myrz	marz
mysa	mesa
mysa	mesa
mysan	maysan
mysat	myst
myslav	mylar
mysl	myst
mysl	myst
mysm	myst
mysn	myst
mysra	misra
mystry	mistry
mystyk	misty
mysvnr	ayson
mysyk	masek
mytal	antal
mytava	amitava
mytcl	mitch
mytcm	mitch
mytnyk	manny
mytrvvyk	mitrovic
mytsl	mats
mytv	myth
mytv	myth
mytvn	matin
mytvnn	litvin
myv	amy
myvs	amys
myvsn	myron
myvvz	martz
myvz	marz
myvzr	myer
myyh	myth
myyr	mayr
myyrs	myers
myz	amy
myz	amy
myzvn	myron
myzyra	mayra
mzdh	mach
mzyk	mack
mzyvn	mayan
nab	na
nabl	nabil
nabyl	nabil
nadan	adan
nadansvn	adans
nadvlny	nadolny
nadyg	nadig
naf	na
naf	na
naf	na
nafza	afa
nagasaky	nagasaki
nagasyva	nagasiva
nagnt	agent
nagy	nagy
naham	nahum
najr	nair
najyah	najiyah
najya	najya
nakagaky	nakagaki
nakamvra	nakamura
nakasvra	nakasora
nakasyma	nakashima
nak	bak
naksvn	nansen
nakvyyn	naveen
nal	al
nalyk	alok
nam	nam
nandvany	nandwani
nanly	nancy
nan	nan
nans	nans
nansy	nancy
nantvn	anton
nap	gap
nap	gap
naptvn	napton
napvlytanv	napolitano
narad	narad
nardn	nardi
nardv	nardi
nardy	hardy
narla	narla
narsavag	narsavage
narv	harv
nasav	hasan
nas	nas
nas	nas
natan	nathan
nat	nat
natsn	nats
navar	navas
navarv	havard
navas	navas
nav	av
nav	av
navya	najya
navylv	avila
naya	gaya
naydv	ayda
nayfh	nayfeh
nayflr	nayar
naykrbykr	ackroyd
nayks	banks
nayks	banks
naykvlas	ayalas
naylr	nayar
naylz	bayla
naymah	naimah
nayrmn	aaron
nayt	nat
nayt	nat
nazaha	nazahah
nazarytyan	nazaretian
nazaryv	nazario
nbatay	abhay
nbatyh	baath
nbaty	bat
nbl	nb
'nbr	anbar
nbrs	brs
nda	ada
ndkarny	nadkarni
ndn	nan
ndvd	blvd
ndyn	adan
nfan	fan
nfdv	nd
nfjan	fan
nfl	afa
nfysa	noya
nfyza	noya
nfza	afa
ngtyv	agoyo
ngy	nagy
nhavs	ahabs
nhnh	nahnah
njaf	najaf
njf	alf
njva	neva
njyah	ayah
njya	najya
njyh	najya
nklas	niklas
nkls	nils
nknz	benz
nkv	nev
nkv	nev
nl	al
nlkyn	allyn
nls	als
nlsn	alan
nlt	lt
nmazy	macy
npan	nan
np	np
npl	np
npr	apr
nptvn	napton
npvra	napora
nrad	brad
nrdnflt	nordenfelt
nrs	ars
nrtrvp	northrop
nrvp	drop
nry	fry
nry	fry
nsly	sly
nsnal	kanal
nsva	neva
nsvm	asim
nsyda	ayda
nsyha	nasiha
nsyh	nash
nsyra	byra
ntakr	nair
ntrtvn	norton
ntyfa	atifa
ntyha	norha
nvala	ala
nvar	invar
nvayl	neal
nvaz	ava
nvbl	nabil
nvbl	nabil
nvda	nida
nvdyng	nuding
nvf	alf
nvgnt	night
nvjans	evans
nvjanz	avian
nvjnans	conans
nvjns	avins
nvjnt	advent
nvks	avas
nvkv	lvov
nvlan	nolan
nvld	auld
nvlf	nolf
nvl	akl
nvl	akl
nvnys	nans
nvp	np
nvra	nora
nvrbay	norby
nvrda	nardi
nvrdbay	nordby
nvrdbvrg	nordborg
nvrddrap	narendra
nvrdnstvrm	nordenstrom
nvrdrap	aludra
nvrdrvph	adolph
nvrdt	nordt
nvrdvrp	border
nvrdvrp	border
nvrha	norha
nvrkat	avram
nvrn	avon
nvrsrap	ararat
nvrsvrp	nasir
nvrtkat	barakat
nvrtvrph	north
nvrtvrp	northrop
nvrvvd	narad
nvry	nery
nvsak	bosak
nvsl	avs
nvt	nat
nvtzn	nitin
nvtz	notz
nvvala	nevada
nvvrddrp	noorddorp
nvvsl	nevel
nvvyk	novik
nvya	noya
nvyfl	beyl
nvyjanz	nevejans
nvyk	ivy
nvyl	beyl
nvyl	beyl
nvyls	neals
nvyngtvn	alington
nvys	amys
nvz	av
nyby	abby
nycvlas	niclas
nycvls	cls
nydal	nidal
nyda	ayda
nydh	ayah
nydlz	ayala
nyd	nd
nyfjan	neefjan
nyfyn	nyman
nygly	lyly
nyg	nye
nygra	nigra
nygt	myst
nyhalany	nihalani
nykalas	ayalas
nyklas	niklas
nyklas	niklas
nyklas	niklas
nyklas	niklas
nykl	akl
nykl	akl
nykl	akl
nykl	akl
nykls	dykes
nykls	dykes
nykls	dykes
nykls	dykes
nyklsn	dykes
nyklsn	dykes
nyklsvn	neilson
nyklv	akl
nyklz	akl
nyklz	akl
nyk	nik
nyk	nik
nyk	nik
nykrbakr	akbar
nykrbkr	akbar
nykrbykr	norby
nykrsvn	akron
nyks	bks
nyksvn	ayson
nykvla	nukala
nykvlas	niklas
nykvlas	niklas
nykvlas	niklas
nykvlas	niklas
nykvl	akil
nykvlsan	arkansan
nykvls	dykes
nykvls	dykes
nykvls	dykes
nykvlsvn	neilson
nykvlyk	kalmyk
nykvly	lyly
nykvly	lyly
nykvlz	niknaz
nykvlz	niknaz
nykv	nev
nyky	laky
nyky	laky
nyky	laky
nyky	laky
nylbry	allbery
nyljh	lylah
nylmg	alm
nylnd	hyland
nyl	nye
nyl	nye
nyls	nils
nyls	nils
nyls	nils
nyls	nils
nylth	lylah
nyltjh	aaltje
nyltj	aaltje
nyltjy	aaltje
nylz	elz
nymah	nyman
nyma	nyman
n'ymh	ayah
nymh	ayah
nymrad	narad
nymtz	nimtz
nymy	amy
nyndk	lynda
nynja	ninja
nyn	ayn
nyn	ayn
nyns	nans
nynstar	ninstar
nynv	ayn
nynvys	ninoys
nypan	nyman
nypnbrg	nyberg
nyptvn	napton
nyr	cyr
nyr	cyr
nys	nas
nys	nas
nysn	ayn
nyspl	lysol
nysylda	nashida
nytyn	nitin
nyvan	nyman
nyvark	newark
nyvayngtn	yangon
nyvayngtvn	naunton
nyvbay	bombay
nyvbry	avery
nyvbry	avery
nyvkvlas	nickolas
nyvkvyst	nevskys
nyvlnd	dymond
nyvman	nyman
nyvman	nyman
nyvmn	lymn
nyvmyr	emyr
nyvsam	nyasa
nyvtn	nyman
nyvvyngtvn	newington
nyvysvn	nevison
nyvyyngtvn	newington
nyyvkamb	kamb
nyyvtn	kayvon
'nyzh	ayah
nzahah	nazahah
nzaha	azana
nzahh	nash
nzyrah	nazirah
nzyra	byra
nzyrh	ayah
pablt	pablo
pablv	pablo
pacvlkh	pacholke
pacyanv	abyan
padva	padua
padvla	padula
padyal	padial
padyla	padula
paglays	malays
paglya	paglia
paglys	carlys
paglyyarv	pagliaro
pagt	page
pajt	pant
pakala	pakala
pakard	packard
paknas	pakenas
paks	paks
paks	paks
pakt	pak
pakvat	aka
palagy	palagyi
palak	palau
palfvrd	alford
palmrt	palmert
pal	pal
pal	pal
palrmv	palermo
palsky	polsky
palsn	alan
palsyfr	calsyn
paltjh	aaltje
paltj	aaltje
paltjy	aaltje
palvmbv	palumbo
palydv	aldo
paly	daly
paly	daly
paly	daly
palys	alps
pamfry	amery
pam	pam
panags	panagos
panas	panas
panc	pan
panda	panda
pandr	andr
pandvlfynv	pandolfino
pandyan	pandian
pandyt	pandit
pandz	panda
panfyl	panfil
pangbvrn	pangborn
panjaby	punjab
pankras	pancras
pankrs	banks
pann	ann
pan	pan
pant	pant
panvalkr	panvalkar
panvn	panon
panykv	bank
panysy	pansy
papalardv	pappalardo
papay	papay
paplaskas	paplaskas
papltvn	alton
paply	papay
papn	pan
pap	gap
pap	gap
papvyk	papay
paq	pa
para	ara
parat	marat
parayl	parayil
pardn	pardi
pardyngtn	pardington
pardyngtvn	pardington
pardy	hardy
pardz	pardi
parham	parham
park	park
parkyn	parkyn
parkz	park
parmar	parmar
parns	pans
parsanz	parson
parsl	parsi
parsn	parsi
parsvns	parsons
parsvnz	parson
partvn	parton
partvs	partos
party	karty
paryngtvn	pardington
pary	cary
parys	marys
paskal	pascal
paskv	pasko
paskv	pasko
pas	pas
pastrnak	pasternak
pastvr	aster
pasyfyk	masaryk
pasyr	basir
patn	pan
patr	paar
patrsvn	parson
patrsvn	parson
patrvklvs	patroclus
patryk	patrik
patryk	patrik
patryk	patrik
patrys	patsys
patrysya	patrica
patryzyv	patrizio
pats	ats
patta	gatta
patvcy	pataky
patvksnt	patuxent
patyl	patel
pavl	pal
pavlsn	paulin
pavls	pauls
pavlth	pavlik
pavlt	kalt
pavlyk	pavlik
pav	av
pavv	av
payj	ayn
payk	pack
paynh	payne
payn	ayn
payntvn	paynton
payny	payne
pay	day
paypr	apr
payramyd	pyramid
payth	ayah
paytj	pant
paytr	bayer
paytr	bayer
paytvn	payton
payvlsvn	paulsen
payvltj	paultje
payvth	ayah
pd	pd
pdram	pedram
pdrsn	parsi
pdrsvn	parson
pdy	pd
pg	ag
pgram	pegram
pgt	pat
pk	bk
pkr	kr
pkyngz	kang
plak	pak
plamn	plamen
plamr	alamo
plank	blank
plan	alan
plant	pant
plastynv	plastino
platfvrm	platform
plat	plat
plat	plat
platyv	plat
playr	alar
plc	pl
plham	pelham
plkcya	alcoa
plky	clay
plnknr	alnoor
plnth	plath
pltayr	altair
pltcr	peter
pltfrm	platform
pltkvs	platkus
pltnn	alton
plt	lt
plt	lt
pltyv	aliya
pltyyr	altair
plvhn	alvin
plvmr	alamo
plygryny	almgren
plynskyn	plinskin
plyskyn	pliskin
plyt	plat
plyv	alya
pnbakr	anbar
pndltn	andean
pndltvn	pendleton
pndya	pandya
pngadv	pengadu
png	eng
pnkras	andras
pnl	pal
pn	in
pns	ins
pntvn	anton
pnyman	nyman
pnynsvla	peninsula
pnynzvla	panza
pny	amy
pph	poh
pplr	apple
ppyn	ayn
prabst	pabst
pract	pratt
pradv	prada
pragv	bragg
prahl	prahl
praktykvm	praktikum
pral	aral
pralt	prall
pram	pram
pramvd	pramod
pranav	pranav
prangs	prongs
prank	frank
prapys	brays
prasad	prasad
prasana	prasana
prasant	prasana
prasn	prasen
pras	aras
pratp	pratap
prat	brat
prats	prates
pratvl	pratul
pratyk	piatek
pratyks	prates
pratykv	pataky
pravl	prael
pravyn	craven
prayb	arab
prayl	prael
praym	pram
prayvn	prasen
prayvyt	prakrit
prbn	aron
prc	ac
prdykarv	crockart
prdykys	dykes
prdys	andys
prkas	aras
prks	paks
prkyns	parkyn
prkynz	parkyn
prlman	perlman
prlmn	orlon
prl	pal
prlr	brar
prly	orly
prmal	premal
prnt	pant
prntys	montys
prpk	perpk
prsattam	pratap
prskat	arafat
prsl	april
prslt	pelt
prstn	parson
prstrvd	prestrud
prstrv	castro
prstvn	pistun
prsvn	parson
prsynv	bruyn
prsyval	orval
prvamr	pram
prvan	provan
prvgtv	pavlov
prvjt	pratt
prvmvntvry	promontory
prvn	aron
prvps	preis
prvs	pres
prvtrv	pavlov
prvtvs	prates
prvv	grov
prvvst	prevost
prvyn	bruyn
prvy	pruy
prvys	brays
prya	arya
pryavlt	bryant
prybl	prael
prycard	picard
prydy	brady
prykly	prickly
prykn	aryan
prykt	pratt
prylv	prall
prymrv	pryor
prymv	pram
prymyvs	pigmys
pryng	prong
pryn	bryn
pryns	arons
prynss	paynes
prynt	brant
pryny	bryn
pry	fry
pryskat	crystal
pryslr	pryor
prystly	priestly
prystly	priestly
pryst	brest
prystvn	preston
prysyla	poosala
prysyng	bryson
prytcard	pritchard
pryty	bruty
pryty	bruty
prytz	pritz
pryvr	pryor
pryvs	fryes
pryvst	prevost
pryyvty	pretty
prz	apr
pskyn	parkyn
psnkv	pinky
ps	ps
pstma	postma
pst	pat
ptcr	cr
ptkr	atka
ptla	ala
ptrn	atri
ptr	pt
ptrsn	parsi
ptrsn	parsi
ptrsvn	parson
ptrsvn	parson
ptrvf	prof
ptrvnla	arvola
ptrv	atri
ptrvv	petrov
ptrvyc	parkyn
ptryc	patric
ptryk	park
ptry	pery
ptrz	atri
ptsy	patsy
ptv	pt
ptybn	abyan
ptybvn	paysan
ptyl	atul
ptyns	gwyns
pty	pt
pty	pt
pty	pt
ptytjyn	payton
ptzvld	petzold
pvalma	adalma
pva	ava
pvga	puga
pvglys	peggys
pvg	peg
pvgvsyan	pogosyan
pvhan	puhan
pvhar	pohar
pvhl	pohl
pvh	poh
pvkvrny	pokorny
pvlakvs	olavs
pvlgar	pulgar
pvlk	polk
pvlmytys	almatys
pvlnd	poland
pvln	avon
pvln	avon
pvlnt	pant
pvl	pal
pvl	pal
pvlsn	polen
pvls	als
pvls	als
pvltr	pelt
pvlv	lvov
pvlvvyn	allyn
pvlyng	poling
pvlypaly	paypal
pvly	daly
pvlys	julys
pvlyt	pelt
pvlyyam	khayyam
pvlz	elz
pvma	puma
pvmfry	pumfrey
pvna	pena
pvnt	pant
pvnvz	aviva
pvpat	popat
pv	av
pvp	av
pvp	av
pvrahv	prahl
pvranyk	puranik
pvrjz	perez
pvrkv	park
pvr	air
pvrtnvy	portnoy
pvrtrfyld	porterfield
pvrvs	paris
pvryntvn	paynton
pvryr	parr
pvsala	pakala
pvsary	peary
pvsn	avon
pvs	avs
pvstyl	distel
pvsv	avs
pvsy	avs
pvtkvnn	putkonen
pvt	pat
pvtry	petry
pvtyt	patt
pvtyt	patt
pvtz	putz
pvvlz	volz
pvv	av
pvynt	pant
pvyntyng	poynting
pvyryr	avery
pvysl	poisl
pvyv	ivy
pvzyvs	pavlovs
pyak	pak
pyatjy	patsy
pyatk	pack
pybady	abad
pydh	ayah
pyd	pd
pyd	pd
pyjh	ayah
pyjt	myst
pykap	pickap
pykard	packard
pykasv	dykes
pykl	akl
pyk	pak
pyk	pak
pyk	pak
pyk	pak
pykrl	pearl
pyks	paks
pykvlbny	kilby
pykz	pak
pylar	mylar
pylarz	mylar
pylatv	pilate
pylazv	blaz
pyl	pal
pyl	pal
pylvsky	polsky
pylvyv	lvov
pyly	lyly
pylysnry	pillsbury
pynakl	akl
pyna	dyna
pyncaz	duncan
pyncra	lycra
pyndar	pindar
pyndv	lynda
pyngnvt	pingenot
pyng	pang
pynkvvytz	pinkowitz
pynky	pinky
pyn	ayn
pyn	ayn
pyn	ayn
pynsn	bynon
pynsvn	pinson
pynth	lynch
pyntn	bynon
pyntr	pyotr
pyntr	pyotr
pyntr	pyotr
pyntvn	panton
pyntvn	panton
pynv	ayn
pynv	ayn
pynxam	annam
pynyan	pinyan
pyny	ayn
pynz	ayn
pypgras	pipgras
pyp	pym
pyp	pym
pypr	pype
pypvny	gypsy
pyramyd	pyramid
pyran	piran
pyrany	cyrano
pyrard	pirard
pyravat	pirawat
pyrkv	park
pyrlman	perlman
pyrl	perl
pyrmn	byron
pyr	cyr
pyrsn	byron
pyrsn	byron
pyrsn	byron
pyrs	pyers
pyrs	pyers
pyrsvn	parson
pyrt	port
pyrv	byra
pyrvz	perez
pyry	pery
pyryr	parr
pyryz	perez
pyrz	byra
pysah	ayah
pysan	paysan
pysh	posh
pysly	lyly
pysns	dysons
pys	pas
pys	pas
pys	pas
pystvn	pistun
pytan	ayman
pyta	alta
pyth	myth
pytj	kyte
pytkv	atka
pytmn	lymn
pyt	pat
pyt	pat
pyt	pat
pyt	pat
pytr	pyotr
pytr	pyotr
pytr	pyotr
pytrsvn	parson
pytrv	petra
pytrz	petra
pyts	pts
pytybvn	python
pyvmly	pygmy
pyvn	ayn
pyvnyk	pavlik
pyv	pym
pyvryntn	hyvonen
pyvtr	pyotr
pyyk	eyck
pyyry	parry
pyyv	pyle
pyza	ayda
pyzly	lyly
pyzs	eyes
pyzvlytv	pavlov
pyzyaly	piziali
pyzyny	payne
pyzy	lyly
pyzyr	pyotr
pzarays	zaras
qadsyh	addy
qalya	alya
qasan	hasan
qasm	qasim
qayd	and
qays	fays
qbylh	abel
qdamh	adam
qdyla	adela
qdyl	adel
qdym	adam
qdyra	bdira
qdyr	adar
qdysh	adas
qdysyha	aiesha
qlya	alya
qlyba	alba
qlyb	alya
qlyla	alya
qml	akl
qmr	mr
qntvn	anton
qrbya	arya
qrybyh	araby
qsan	san
qsn	qun
qsym	asim
qsym	asim
qtran	tran
qvasym	qasim
qvbylh	quayle
'qyla	aqila
'qyla	aqila
'qyl	aqil
'qyl	aqil
qyt	ait
qyvn	ayn
rabkyn	rabkin
rabld	rabold
rabl	raba
rabnav	grabnar
rabn	raba
rabn	raba
rab	arab
rabrt	rabat
rabrtsn	rabats
rabrtsvn	rabats
rab	arab
rabtm	raba
rabvyl	rabel
rabydyaks	abidjans
raby'h	rabiah
rabyjn	abyan
rabyn	raben
rabyn	raben
rabynsn	rabins
rabynsvn	rabins
raby	raby
raby	raby
rabyv	raby
racl	raul
rac	ac
radak	ladak
radbrg	rader
radbvd	radboud
radbvn	raben
radha	radha
radhyka	radhika
radklyf	adolf
radk	rad
radmn	adan
radnbrc	radenburch
radnbrgarbrvk	radenburgerabroek
radnbrgrabrk	radenburgerabroek
radnbrgrabrvk	radenburgerabroek
radnbrgrbrvk	radenburgerabroek
radnyk	radek
rad	rad
radramvny	rudramuni
radrfrd	barford
radr	badr
radr	badr
radt	rad
radva	radha
radvf	rad
radvlfs	adolfs
radvlfvs	adolfos
radv	rad
radvyg	radig
radyah	radeyah
radyh	brady
radyng	radig
rady	brady
rafalkv	rafalko
rafal	rafal
rafalsky	rafalski
rafa	rafa
rafayl	rafael
rafayly	rafael
rafnr	fafnir
raf	graf
rafrty	karty
rafykyv	rayya
rafyl	rafal
rafyn	ayn
rafy	raby
ragatz	ragatz
raglnd	ragland
ragl	ragle
ragnar	ragnar
ragnarsvn	ragnarsson
ragnrd	jagard
ragnvald	ragnvald
ragrv	agra
ragsdyl	ragsdale
raharjv	rahardjo
rahbk	dahuk
rahrr	bahro
rahryg	arya
rahvl	rahul
rahy	raby
rajcr	hajar
rajndr	andr
rajn	rain
raj	raj
rajr	raj
rajrz	marz
rajs	raes
rajv	raj
rajyv	najya
rakah	aka
rakl	akl
rakl	akl
rak	bak
rakvn	akin
rakv	aka
rakykvt	akiva
ralf	ralf
ralf	ralf
ralf	ralf
rama	rama
rambl	rambo
rambv	rambo
ramplz	ramez
ram	ram
ram	ram
ramr	ram
rams	ams
ramsy	ramsay
ramsyr	ramer
ramtan	amman
ramvlvs	camels
ramvs	ramas
ramy	amy
ramyrv	ramer
ramz	ram
rana	rana
randl	mandl
randr	andr
rangl	range
rankyn	rankin
rann	ann
ran	bran
ran	bran
ran	bran
ranr	rana
rantgn	anton
rany	many
rany	many
rany	many
ranyv	many
rapbryk	masaryk
rap	gap
rapr	apr
rark	ark
rasa	raba
rascn	basin
rasdal	randal
rasd	rad
rasfvrd	alford
raskh	ask
rask	ask
raskyn	raskin
rasl	ras
rasl	ras
rasmn	asma
rasndal	randal
rasndyl	randal
rasnman	eastman
raspyny	aspen
ras	ras
ras	ras
ras	ras
ras	ras
rastn	rastin
rastram	atram
rast	east
rastyn	rastin
rasty	grasty
rasvm	asim
rasv	ras
rasv	ras
rasv	ras
rasyd	masud
ratcsvn	macsen
ratgrt	rutgert
ratjrt	rajat
ratks	rutks
ratmn	atman
ratra	batra
rat	rat
ratrfvrd	barford
rat	rat
ratstrvm	rattray
ravbatm	rabat
ravdah	raidah
ravda	pravda
ravda	pravda
ravlnd	ragland
ravlt	kalt
ravnr	rader
rav	av
rav	av
rav	av
ravrdy	raverdy
rav	av
ravrt	art
ravs	avs
ravt	rat
ravyah	ayah
ravyh	davy
ravyndran	ravindran
ravyraj	raviraj
ravy	davy
ravy	davy
rayblt	rabat
raydah	raidah
raydj	ayda
raydl	ayda
raydn	haydn
rayfl	rabel
raylh	rayle
rayly	bayly
raymvnd	raymond
raynr	rayer
rayp	ray
ray	ray
raysl	ayse
rays	brays
raystlyn	raistlin
rayt	rat
raytz	bartz
rayvard	bayard
rayvlyngz	ayling
rayv	ray
rayvtyala	rautiala
rayzl	rabel
razdan	razdan
razn	rain
razvrbk	razorback
rbhvlz	rebholz
rbrtsvn	bryson
rbvk	bak
rbvsv	rbs
rbyah	abyan
rbyh	raby
'rbyl	arbil
rbys	rbs
rdah	ada
rda	ada
rdbvn	raben
rdfyld	alfeld
rdlfvs	adolfos
rdlvs	redlus
rdmn	adan
rdmyl	remy
rdryk	rory
rdva	reva
rdvlf	adolf
rdvndv	rand
rdydh	riyadh
rdyh	rath
rdy	ray
rfa	afa
rfsns	refsnes
rfsvn	refson
rf't	rafat
rgd	gd
rgv	rev
rhlyng	rehling
rhny	rony
rhymah	hamah
rhymh	ayah
rhym	ham
rjas	rajas
rjat	rajat
rj	j
rkah	aka
rkdal	akdag
rkkah	akkad
rkstn	rastin
rkvg	ravi
rlf	alf
rlyvs	luvs
rlyvz	allyz
rmd	md
rmfr	amir
rmlyngr	rayner
rmncyk	dancy
rmn	mn
rmns	mns
rmplyng	rampling
rmvny	many
rmy	amy
rnaldz	renalds
rnalt	anant
r'na	rana
rna	ana
rnavd	anand
rnbart	anbar
rndhl	radha
rndr	andr
rndy	andy
rnj	raj
rnvys	andys
rn	rn
rny	ray
rnzlnd	renzland
rnz	rn
rplagl	bilal
rprt	apr
rptvn	repton
rqah	ayah
rqa	ra
rqd	rad
'rryfa	arrifa
rsa	isa
rsl	rs
rsl	rs
rsnyk	rony
rst	rat
rsvl	rasul
rsvlvyrt	calvert
rsvnat	israt
rsvndl	lendl
rsyda	ayda
rsydh	riyadh
rsyd	boyd
rsynh	reyna
rsynjh	lynch
rsynth	blyth
rsyntj	resyntje
rsyvyn	kayvon
rtklyf	eklof
rt	art
rvan	evan
rvatr	ivar
rvay	ray
rvayz	ray
rvaznr	evan
rvbrj	avery
rvbr	br
rvbrta	roberta
rvbrt	evert
rvbrtsvn	robertson
rvbrtv	evert
rvbvz	roboz
rvbyn	robyn
rvbynsvn	robinson
rvbynz	robyn
rvby	raby
rvby	raby
rvc	ac
rvc	ac
rvda	reda
rvdh	rad
rvdlv	radev
rvdnbrg	rodberg
rvd	rad
rvd	rad
rvdrygv	rodrigo
rvdrygz	rodrigo
rvdvlfas	rodolfos
rvdvlf	rudolf
rvdvlfvs	rodolfos
rvgalsky	rogalsky
rvgvza	rogoza
rvhan	rehan
rvhl	brohl
rvhm	rohm
rvhn	rohn
rvhrr	rohrer
rvhr	ruhr
rvjas	rajas
rvkan	rukan
rvka	aka
rvkn	avon
rvkry	avery
rvksan	roxsan
rvksan	roxsan
rvkv	lvov
rvkyky	ricky
rvkz	ritz
rvland	roland
rvldan	roldan
rvlfh	ralf
rvlf	ralf
rvlf	ralf
rvlnd	rand
rvls	als
rvlv	lvov
rvly	daly
rvmfvrt	roumfort
rvmrv	avery
rvmyg	remy
rvmyv	remy
rvnald	ronald
rvnda	ronda
rvndh	rand
rvndl	lendl
rvndyn	randy
rvngv	range
rvntry	gantry
rvny	rony
rvny	rony
rvnyt	ronit
rvpkh	caph
rvprt	evert
rvp	rep
rvrkh	arch
rv	av
rv	av
rvr	air
rv	av
rvry	rory
rvrys	rorys
rvsalyn	rosalyn
rvsam	assam
rvsam	assam
rvsana	rosana
rvsa	rosa
rvskv	rusk
rvsl	avs
rvslyn	roslyn
rvslyn	roslyn
rvsnal	bernal
rvsnblat	rosenblatt
rvsndal	randal
rvsndl	fresnel
rvsnfld	rainald
rvsn	avon
rvsnr	avins
rvs	avs
rvs	avs
rvs	avs
rvsr	avs
rvstad	rostad
rvstnd	rostad
rvsvlt	iselt
rvsvn	rosen
rvsv	avs
rvsv	avs
rvsyala	ayala
rvsytr	rayer
rvtabaga	rutabaga
rvtgr	arter
rvtgrt	rutgert
rvtj	raj
rvtjy	aetje
rvtrfrd	astrid
rvt	rat
rvt	rat
rvt	rat
rvt	rat
rvt	rat
rvt	rat
rvt	rat
rvts	acts
rvtz	ritz
rvvlvry	avery
rvvth	raith
rvvt	rat
rvvt	rat
rvyah	ayah
rvyal	royal
rvyapa	royappa
rvybl	royal
rvydn	haydn
rvyh	ivy
rvyl	beyl
rvyly	bayly
rvymata	roimata
rvyn	avon
rvyn	avon
rvypk	aveek
rvy	ivy
rvys	roys
rvys	roys
rvys	roys
rvytnbrg	roytenberg
rvyyz	rayya
rvyz	ivy
rvzmary	limary
rvzmary	limary
rvzndal	randal
rvznfldr	rainald
rvznjk	vonk
rvzn	avon
rvz	ariz
rvz	ariz
rvz	ariz
rvzvlt	raoult
rvzy	ivy
rvzyr	avior
rvzyr	avior
rvzyta	avesta
ryad	rad
rybak	babak
rybar	ribar
rybk	bk
ryb	rb
rybrn	raben
rycard	picard
rycardsn	cardin
rycardsvn	richardson
rycar	bacar
rycav	rya
rycmn	lymn
rycmyr	cyr
ryc	rya
rycr	bryce
rycy	bryce
rycy	bryce
ryda	ayda
ryda	ayda
ryda	ayda
rydh	ayah
rydh	ayah
rydj	ayda
rydkvyst	rydquist
rydl	ayda
rydnbrc	rydberg
rydnbrgyrbrak	radenburgerabroek
rydn	ryan
ryd	rad
rydr	ryder
rydyg	radig
rydy	rudy
ryfkaynd	rifkind
rygan	ragan
rygard	regard
ryglr	ragle
ryg	reg
rygv	reg
rygynz	ragan
ryhana	rihana
ryhanh	rehan
ryhl	brohl
ryjkard	rickard
ryj	raj
ryjsvyjk	rijswijk
ryjsvyk	rysavy
ryjynz	reyna
rykard	regard
rykard	regard
rykr	byer
rykrt	art
ryksvn	ayson
ryktz	reetz
rykvlsvn	revlon
ryky	laky
rylnd	hyland
ryl	rya
rylsbk	rusk
ryly	lyly
rymant	ayman
rymnd	dymond
rymnz	lymn
rym	pym
rymrs	ayers
rymvnd	dymond
rymvnd	dymond
rymvnd	dymond
rymvn	rymon
rymyl	remy
rymy	remy
rynah	arunah
rynalda	reenalda
rynald	ronald
rynalds	renalds
rynaldz	renalds
ryndnr	rander
ryndrt	rynders
ryndrz	rynders
ryng	ring
ryngst	bengt
ryngvvd	bongard
rynh	ayah
rynkr	bryner
rynlda	lynda
ryn	ayn
ryn	ayn
rynr	ayn
rynr	ayn
rynrt	ronit
ryntvl	antal
rynvd	rand
rynvlda	lynda
rynvld	ronald
rynvld	ronald
rynvlds	renalds
rynvldsvn	reynoldson
rynvldz	renalds
rynvvd	rand
rypl	pl
ry	fry
ryrdan	gordan
ryrdan	gordan
ryrdn	byrd
ry	fry
ryrsvn	ayson
ryrz	byra
rysah	ayah
rysalvyrt	rysavy
rysar	cesar
rysavy	rysavy
rysjy	rusty
ryskar	baskar
ryslvrt	rysavy
ryslyng	rysling
rysly	lyly
rysnr	ryan
rysnr	ryan
rysnyk	bryony
rysrc	ayers
rys	ras
rys	ras
rys	ras
rys	ras
rys	ras
rysr	ayse
rysr	ayse
rystv	myst
rystyntjy	resyntje
rysty	rusty
rysvlvrt	resolveert
rysvlvvrt	resolveert
rysvr	ryder
rysvyk	rysavy
rysy	ayse
rytakv	jataka
ryta	rita
rytcy	rotch
ryt	rat
rytsgrt	ritsgert
rytvgr	rather
rytysgrt	ritsgert
rytzgrt	retzer
rytz	ritz
rytzr	retzer
ryvard	rivard
ryvbr	river
ryvdt	ruudt
ryvmlr	gymer
ryvnsvn	ryans
ryvnvld	ragnvald
ryvpka	riopka
ryvr	byer
ryv	rev
ryvrz	ayers
ryvv	ravi
ryvyrh	revere
ryvys	levys
ryyad	riyad
ryyd	boyd
ryynks	reynas
ryyr	byer
ryz	rya
ryzr	byer
ryzvlvrt	rybolt
ryzv	rev
ryzvy	reavy
rzbry	raby
rznbavm	anbar
rznfld	ronald
rznkrans	akrons
rznlf	ralf
rznmn	rinn
rzntjy	entje
rzvlvrt	calvert
rzynt	reyna
saartj	saartje
sabglasyal	subglacial
sabhany	abhay
sablt	sabot
sabramanyam	subramaniam
sabramanyan	subramanian
sab	saab
sabtns	gabons
sabt	sabot
sabvryn	abery
sabvs	abes
sabyn	sabin
sabyny	sabin
sacat	sadat
sack	ack
sacr	saar
sadgrv	sadgrove
sadha	radha
sadlr	sadler
sadrblam	saddam
sadyah	sadah
sadyh	sadah
sadyk	adik
sadykv	adik
sadykvyh	sadah
sadykyv	addy
sadyvp	dady
safr	saar
saf	sal
saft	sat
saftvr	salter
saftyn	martyn
sagars	sagans
saga	haga
sagayy	sagady
sagn	sagan
sagrv	agra
sagrv	agra
sahasy	sahasi
sah	mah
sahvlm	sahel
sajn	san
sajrv	harv
sakamvtv	sakamoto
sakary	sakari
sakayv	bakaya
saklad	saklad
sakla	sakha
saksna	hasna
saksnm	saks
saks	saks
saks	saks
saksvn	isakson
saksym	saks
saktn	akin
sakt	saki
sakya	sakha
saky	laky
salga	salma
salgvrv	alger
salkras	saharas
salk	salk
salmvnd	salmond
salmy	saley
saltzmn	saltzman
saltz	alta
salvmn	alvin
salvm	salem
salvmvn	salsman
salyan	kalyan
salygram	shaligram
salyn	alan
saly	daly
salyt	salyut
salyvan	galvan
salzbrg	salzberg
salznbrg	salzberg
samadar	samaddar
samah	samah
samakr	samar
saman	haman
samanta	samantha
samanta	samantha
samar	samar
samas	asamas
sambat	shambat
sambvlyk	sambolec
samgyn	sagan
samh	sam
samk	salk
saml	sal
samn	sam
samral	amal
samr	saar
samr	saar
samrz	camry
sam	sam
sams	sams
samtyng	samsung
samvls	camels
samvn	amin
samvsky	samosky
samvyl	samel
samyr	samar
samyt	amit
samyt	amit
samz	sam
sanahan	shanahan
sanandv	anand
sana	sana
sanbrn	sabin
sancty	dancy
sandar	mandar
sandhv	sandhu
sandlyn	sandlin
sandman	sandman
sandram	sandra
sandrm	sandra
sandrnz	sandra
sandrs	sadrs
sandrsvn	sanderson
sandrz	sandra
sandrz	sandra
sand	sand
sandyp	sandy
sandy	sandy
sangld	angle
sang	sang
sang	sang
sangv	sang
sanjay	sanjay
sanjh	danih
sanjstr	sangster
sankar	sanka
sankn	sanka
sankr	sakr
sankr	sakr
sank	bank
sank	bank
sanla	sana
sanly	sally
sannar	sanner
sanrang	sansing
sanrayz	sanjay
sanrjh	santje
sanrth	barth
sanrtjy	saartje
sanrt	art
sansayn	kansan
sansbrn	sansburn
san	san
san	san
sanss	sanas
sanst	east
sansvn	anson
santana	santana
santa	santa
santh	santa
santj	santa
santjy	santje
santrtj	antti
sant	iant
santsbrn	sansburn
santv	sanov
santvs	santos
santvsy	santos
santyk	sandy
santy	sandy
sanvndv	anand
sanvn	ann
sanv	san
sanyl	anil
sany	many
sany	many
sanyt	iant
sanzbvrn	sansburn
sanz	sanz
saprv	apr
sap	gap
sarann	saran
sara	sara
saraty	sarathy
sardgna	sardegna
sardlv	sardar
sardv	sardo
sarjh	sarah
sarknas	sharknas
sarlvt	arlet
sarly	carly
sarma	sarma
sarna	sarna
sar	ar
sar	ar
sartaksv	martas
sarth	barth
sartj	sarto
sartjy	karty
sart	art
sart	art
sartzr	arter
sarvath	barath
sarvk	ark
sary	cary
saryvl	daryl
sasaky	kasaty
sasan	hasan
saska	laska
saslav	saslav
sasmn	asma
sasnhym	arnhem
sasn	san
sastk	ask
sastyk	astik
saszh	sasze
sasz	sanz
saszy	sasze
satfn	satan
satfyn	satan
satj	sat
satkas	sankas
satn	san
satr	saar
satr	saar
sat	sat
sat	sat
satvn	satan
satvn	satan
satvr	satur
satv	sat
savan	sagan
savaram	savaram
savars	samars
savcvk	ack
savdy	sandy
savfrd	havard
savl	sal
savl	sal
savl	sal
savlz	sal
savndrz	sandra
savsan	sawsan
sav	av
savtr	saar
savtr	saar
savtz	savetz
savvy	savoy
savyn	savin
savyr	davy
saybrmyj	aubrey
saybrt	sabot
sayda	ayda
sayks	sacks
saykv	sacks
saylr	sayer
saymkv	ayman
saym	sam
saymvn	ayman
saymvns	caymans
sayp	ayn
sayry	sayre
saytj	saito
sayt	sat
saytv	saito
saytz	bartz
sayvrynglnt	sargent
sayvyrdynglant	siuuirdingelant
sayvyr	sayer
sazh	bach
sbastyn	aston
sbastyn	aston
sbayn	ayn
sbhan	shan
sbra	sabra
sbrt	art
sbryany	bryan
sbry	abby
sbs	sbs
sbyrah	byra
sbyra	byra
sbyrh	byra
sbystn	abyan
sbyt	bat
sdah	sadah
sdah	sadah
sda	ada
sday	day
sdgrv	segre
sdha	soha
sdh	seh
sdlr	adar
sdrhlm	dahl
sdrvv	adri
sd	cd
sds	cds
sdval	advil
sdvr	adar
sdv	ada
sdya	ada
sdyh	sadah
sdyk	adik
sdyra	bdira
sfard	asgard
sfrd	afra
sf	cf
sfyld	sold
sgal	sal
sgvra	agra
sha	sea
shrab	sarab
shr	sahr
sh	h
shyb	shub
skanl	kan
skarp	karp
skar	akar
sklany	klan
skman	akman
skrntn	akron
sksnm	skene
skspyr	caspar
skstn	skean
skstvn	alston
skt	sat
skvyra	skaya
skyvryty	karty
slamky	laky
slamn	slan
slar	alar
slaryr	slater
slat	flat
slay	clay
slayz	allyz
slbrg	sabra
slbrg	sabra
sldn	slan
sldvn	aldan
slf	alf
slfy	sly
slj	sly
slj	sly
slk	salk
slma	alma
slma	alma
slmydy	almaty
slmy	sly
slny	sly
slr	lr
sl	al
sl	al
slt	lt
slth	seth
sltjh	seth
sltvn	alton
slva	alva
slvd	blvd
slvdvf	blvd
slvn	slan
slvn	slan
slvvd	blvd
slyj	sly
slymanyh	lyman
slyma	sloma
slymh	blyth
slym	slim
slym	slim
slyna	alana
slypry	ellery
sly	sly
slytr	blyth
slyv	slav
smah	mah
smal	amal
smalyah	aaliyah
smalyh	small
'sman	isman
smar	imar
smar	imar
sma	ama
sma	ama
smat	mat
smbhv	amber
smblnks	banks
smh	seh
smkvvn	savin
smly	sly
smma	emma
smmr	amir
smpl	amal
smpt	sept
smrn	amin
smr	mr
smr	mr
sm	sm
smsc	sms
smsl	sms
smvtyvk	amitava
smyah	ayah
smyh	amy
smylh	myth
smym	amy
smyrah	myra
smyra	myra
smyra	myra
smyrh	emyr
smyr	emyr
smyr	emyr
smyr	emyr
smys	amys
smytly	smitley
smyz	amy
snan	inan
sna	ana
sna	ana
sna	ana
sndbrg	sandberg
sndfvrd	sandford
sndhyl	sendhil
sndlyn	sandlin
sndmn	sandman
sndrs	sadrs
sndrz	andr
snd	and
snds	nds
sndvyk	sandvik
sndy	andy
sndz	and
snfng	sang
snftlybn	senftleben
sngal	sangal
snglvglv	snell
sng	eng
sng	eng
sng	eng
sngvpta	sengupta
sngvta	angara
snhal	snehal
snjh	inch
snkyat	enyart
snnrtj	north
snny	sonny
snqan	inan
snr	sir
snsbrn	sansburn
sn	sn
sntj	entje
snt	sat
sntyagv	santiago
snvry	envoy
snvtv	anita
snyrjh	north
spard	asgard
sparndam	spaarndam
spastyn	spartan
sphr	sahr
sprd	aird
spryngr	springer
sp	np
spynval	sangal
spy	sky
srab	arab
srafyn	serafin
srasvl	rasul
sratvza	bratina
sraynh	ayah
srcak	sercan
srdar	sardar
srhyr	sahr
srjh	arch
srkamb	kamb
srkan	aryan
srk	ark
srks	saks
srkyah	arunah
srkyh	sikh
srld	sold
srl	sal
srlyng	arling
srly	orly
srman	seman
srmn	arm
srpnt	brant
srqyh	arch
srr	orr
srr	orr
sr	sr
sr	sr
sr	sr
srsta	brita
'srt	art
srtryd	astrid
srvady	brady
srvary	bovary
srvmbc	rambo
srvvd	arend
srvyc	arya
srvydyv	brady
srvys	brays
srvy	bray
srya	arya
sryf	arya
sryf	arya
sryngtvn	alington
sry	fry
sry	fry
sry	fry
sryt	art
sryvr	pryor
ssadry	badry
ssany	swany
ssdry	badry
ssyl	beyl
starlvzn	stalin
stfanvs	stans
sthvrajan	sethurajan
stlayn	slan
stlnd	sand
stlr	star
stl	sal
stmf	sam
stnt	aint
stratvn	straton
strytr	strath
st	st
stvfl	savel
stvraman	seaman
stv	st
styvnsvn	stevenson
svafvrd	safavid
svagatv	swagato
svamy	swamy
svamy	swamy
svank	shank
svan	evan
svan	evan
svanyk	shank
svany	swany
svarmn	saran
svart	smart
svaryngyn	saarinen
svas	avas
sva	ava
svayda	ayda
svbhandv	sobhan
svbvtka	sobotka
svcan	avian
svdan	sudan
svdan	sudan
svdarmv	sudarmo
svdarsan	sudarshan
svdr	sadr
svdyp	sudip
svdyptv	sudipto
svdyr	sadr
svdz	lodz
svfn	sven
svfr	fr
svfyh	ivy
svfyld	alfeld
svfy	ivy
svgn	sven
svgrlf	graf
svg	ag
svha	soha
svhas	suhas
svha	soha
svhm	sohm
svkk	saki
svkla	avila
svkvl	sokol
svkvmar	sukumar
svlar	solar
svlaymnyah	sulaymaniyah
svldr	sadr
svld	sold
svlfvr	dulfer
svlk	salk
svl	sal
svl	sal
svltan	sultan
svlt	celt
svltz	hiltz
svlvmvn	salsman
svlv	lvov
svlvvy	silvey
svlvyr	silver
svlvy	saley
svly	sly
svlys	julys
svlytas	avestas
svma	soma
svmasykar	somashekar
svmjy	sammy
svmn	sven
svmr	ivar
svmrvyl	sheryl
svmvy	sammy
svmykr	emyr
svnar	bonar
svna	sana
svndaram	sundaram
svndrz	sandra
svngkrn	songkran
svngr	sang
svngrvala	songerwala
svng	sang
svnja	sonja
svn	san
svn	san
svn	san
svnsn	sinan
svn	san
svny	sony
svny	sony
svpn	sven
svpratyk	supratic
svpryv	avery
svp	sup
svrab	sarab
svrab	sarab
svraj	suraj
svrana	surana
svrk	ark
svrl	burl
svrnsn	svens
svrn	sven
svr	sir
svr	sir
svrs	srs
svrsvn	burson
svrtl	sarto
svrtn	saran
svrvaly	sorvali
svryndr	bryner
svryn	bryn
svsal	sal
svsa	sosa
sv	av
svsh	avs
sv	av
svsn	sven
sv	av
sv	av
sv	av
svsya	sasha
svsyl	sibyl
svtan	satan
svtfn	satan
svtn	sven
svtr	ivar
svtr	ivar
svts	sats
svtv	lvov
svyak	kayak
svyda	ayda
svydh	ayah
svyft	soft
svylr	sayer
svylr	sayer
svynglr	sanger
svynrtvn	paynton
svyn	sven
svyn	sven
svyr	cyr
svytnky	slinky
svytv	blyth
svyynk	mayank
svzalys	italys
svzana	azana
svzanh	avian
svza	ava
svz	av
svzv	lvov
svzy	suzy
syandra	sandra
syang	sang
syang	sang
syanv	ryan
sybacr	aabar
sybl	sybil
sybl	sybil
syblt	rybolt
sybly	lyly
sybrt	sabot
syda	ayda
s'ydh	ayah
sydlr	ryder
sydlr	ryder
sydmn	lymn
sydny	sydney
sydr	sadr
s'yd	boyd
syd	sed
syd	sed
sydvr	ryder
s'ydy	sandy
syfard	seward
sygl	sage
sygl	sage
sygltvn	salton
sygmn	lymn
sygmn	lymn
sygmn	lymn
sygmvnd	sigmund
syg	ag
sygs	ags
syhan	shan
syhn	ayn
syhsvbhvn	sihsobhon
syhy	lyly
syjh	ayah
syjkv	eyck
syjmn	lymn
sykagv	sage
sykar	sekar
sykarv	sakari
sykr	sakr
syk	ack
sykvlv	sokol
sykvra	sekora
syky	sky
syla	sela
sylbrman	silberman
sylbrmn	salerma
syldn	dylan
syldz	sold
sylk	salk
syl	sal
sylvan	sylvan
sylva	silva
sylvd	blvd
sylvnn	sylvan
sylvrbrg	silverberg
sylvrmn	sylvan
sylvr	aylor
sylvrtvrn	salvatore
sylvrvd	sylvan
sylv	kyle
sylvvd	sylvan
sylvya	sylvia
sylvya	sylvia
sylvy	lyly
sylvyv	sylvan
sylyg	lyly
sylyman	lyman
sylymn	lymn
syly	lyly
syly	lyly
sylyt	lyly
sylzmn	sylvan
sylz	elz
sylz	elz
symal	amal
symard	simard
symayh	samah
symbab	siembab
symlr	gymer
symnds	lynds
symn	lymn
symn	lymn
symn	lymn
symn	lymn
symn	lymn
symnz	lymn
symplysyty	simplicity
symr	syme
symr	syme
syms	sams
syms	sams
symsyk	gypsy
symvdynz	simodynes
symvna	simona
symvnds	simonds
symvnh	ayman
symvnh	ayman
symvn	ayman
symvn	ayman
symvnsn	hymens
symvns	hymens
symvnz	ayman
symvnz	ayman
symyng	siming
symyngtvn	symington
symyn	ayman
symyn	ayman
symz	syme
symz	syme
syna	dyna
synan	sinan
syna	dyna
synayn	sinan
syndlmn	sandlin
syndrh	sandra
syngltvn	singleton
syng	sang
synk	sunk
synklary	sankara
synklayr	sinclair
synklr	sunker
synk	sunk
synr	sync
syn	ayn
syn	ayn
syn	ayn
syn	ayn
syn	ayn
syn	ayn
syn	ayn
syntya	santa
synv	sync
synvy	sandy
synybaldy	sinibaldi
synyg	sang
syny	sony
sypl	pl
syplvaydn	sylvan
syplvydn	sylvan
syplz	apple
sypmn	lymn
sypn	ayn
sypryanv	cyprian
syp	sup
syrafyn	serafin
syran	saran
syrant	brant
syra	byra
syray	stray
syrcnt	sprint
syr	cyr
syrkvys	gorkys
syrl	burl
syrly	carly
syrr	barr
syr	cyr
syr	cyr
syr	cyr
syrs	srs
syrs	srs
syrvka	sylvia
syrvn	byron
syrvs	ayres
syrvyz	seavy
syryf	surya
syryl	beryl
syrylv	beryl
syryng	shryne
sysaba	csaba
sy	s
sy	s
sy	s
sy	s
sysk	sisk
syslvnz	rysling
syslv	saslav
sys	sbs
systmz	systems
sysz	ayse
sytaram	sitaram
syta	sita
sytay	satan
syth	myth
syth	myth
sytj	sytje
sytjy	sytje
sytlayv	saslav
sytlr	lytle
sytrah	sitrah
sytra	batra
sytrh	myth
syt	sat
syt	sat
syts	sats
sytv	kyte
sytya	sita
sytyh	myth
syty	katy
sytyzn	python
sytz	bitz
sytz	bitz
syvald	ayala
syvalv	ayala
syva	siva
syvayrdynglnt	sardegna
syvla	ayala
syvl	sal
syvmn	lymn
syvng	byung
syvnka	sanka
syvn	ayn
syvnys	sonnys
syvrdynglnt	sardegna
syvr	byer
syv	av
syv	av
syvsmnz	ayson
syvvd	blvd
syvyrdynglant	siuuirdingelant
syvy	davy
syvy	davy
syyvayrdynglnt	sardegna
syyvnyl	bryony
syznhym	sydney
szarv	harv
tabvk	tabuk
tabyt	cabot
tac	ac
tadr	badr
tad	tad
taft	taft
taftz	taft
tafvn	taffe
taglv	tagle
tahara	tahara
tahryha	arya
tahvn	hahn
tajh	bach
taka	taka
takmn	akin
takr	sakr
taksbry	gatsby
takv	tak
taky	laky
talan	alan
talbrg	malberg
talbvyz	talboys
talkvt	talbot
talmayr	talman
talmn	talman
talmy	talmy
taln	aali
talnv	kalev
tals	als
talvann	galvan
talybah	talibah
talys	italys
tamana	tamara
tamara	tamara
tamas	tamas
tamatyvs	almatys
tamay	gamay
tambrvs	lambros
tamb	kamb
tampas	tampas
tampkynz	tompkins
tamsn	amin
tamsvn	hamson
tam	tam
tam	tam
tam	tam
tamynz	tammuz
tamy	amy
tamz	tam
tanak	tanak
tana	ana
tang	tang
tang	tang
tanjs	tanis
tankn	ann
tann	ann
tantvn	tanton
tanys	tanis
tapa	taka
taplyn	taplin
tapr	apr
tapsyn	calsyn
taptany	taitano
tapyk	capek
tapyn	ayn
tapyv	tanya
tara	tara
tardl	aral
tarkl	akl
tark	ark
tarml	aral
tarn	barn
tarq	tara
tars	ars
tarsvn	carson
tar	ar
tarvb	tarub
taryk	ark
tasdylr	tasdeler
taskr	tasker
tatam	tatar
tatary	tartary
tatbay	tatby
tath	gath
tatj	tat
tatl	tat
tatl	tat
tatrvy	tatby
tatsvrv	tatsuro
tat	tat
tat	tat
tat	tat
tatyh	fatah
tatyh	fatah
tatyl	atul
tatz	datz
tavars	tatars
tavrnyny	tavernini
tavr	tarr
tav	av
taybvt	talbot
tayjmn	taejon
taylbry	taylor
taylmans	caymans
taylmnz	ayling
taylr	taylor
taylv	bayla
taymn	ayman
taynvr	gaynor
tayray	airay
tayr	dayr
tayrvn	aaron
tayry	badry
taysn	ayn
taysvn	ayson
tay	tay
tayt	taft
tay	tay
tayty	bayly
tayv	tay
tbt	tat
tbvk	bak
tbyb	bib
tbyt	bat
tdl	tl
tfylah	lylah
tfyla	bayla
t'fylh	tafilah
tglbrg	garg
tgl	tl
thsyn	sheyn
th	th
thyrah	tahirah
thyra	thara
thyrh	thanh
tjajh	thanh
tjatj	taatje
tks	bks
tk	bk
tk	bk
tk	bk
tkyah	ayah
tkyh	sky
tlandr	andr
tlbrt	albert
tlbvys	levys
tlbvyz	allyz
tlfr	alar
tlkvm	albom
tllv	all
tlnt	tent
tlr	lr
tl	tl
tlybah	lylah
tlyba	alba
tlybh	blyth
tlyb	alya
tmbry	amery
tmplmn	taplin
tmplr	templar
tmpltvn	maltin
tmpst	mast
tm	tm
tmyr	emyr
tnant	anant
tnaya	tenaya
tnbrvk	librik
tnbv	anbu
tndyry	ander
tnkn	ann
tnpv	nev
tnts	tants
tnt	tat
tnvr	andr
tnvryv	envoy
tnykn	abyan
tnysan	maysan
tny	tay
tpv	apr
tqyh	tay
trada	prada
traftvn	trafton
trafvrd	trafford
trah	grah
trajktnsys	adkinss
trakv	brake
tran	tran
tranytsa	brants
trap	tra
trapyn	tracy
trash	trash
trastr	traster
tra	tra
travajlya	travaglia
travn	tran
travzy	ravey
trayktnsys	adkinss
traynth	traynor
trayntz	traynor
traynvr	traynor
traystnsys	brandys
traystnys	crystals
traysy	brays
traz	taraz
trbry	drury
trd	rd
trfvrd	orford
trld	auld
trldy	trudy
trl	tl
trlv	grov
trmvyl	orval
trmynal	terminal
trnr	arne
trnsh	trash
trns	rns
trn	rn
trntn	ornen
trnt	tent
trnyk	drnek
trsa	tra
trs	ars
trstvn	tristan
trtjy	tatby
trtjy	tatby
trtnh	trinh
trtvan	provan
trtvn	titan
trvb	arab
trvby	araby
trvdl	orval
trvdsvn	arvesen
trvf	graf
trvgtvn	trafton
trvhykv	gromyko
trvks	eriks
trvl	aral
trvl	aral
trvlyngr	traynor
trvmbv	trumbo
trvmytr	trometer
trvn	tran
trvp	drop
trvrays	ararats
trvr	brar
trvryk	drury
trvrys	rorys
trv	tra
trvtr	trevor
trv	tra
trvt	art
trvylygr	taylor
trvyryk	avery
trvysdyl	crystal
trvyth	truth
trvytj	tevet
trvyt	tevet
trvyyjh	aliyyah
trybl	trull
trybl	trull
trydvy	trudy
trygs	fryes
tryjv	arya
tryk	ark
tryktnsys	arkansas
trykt	trent
trymstar	crystal
trym	trim
tryndad	trindade
trynd	arend
trynham	grinham
trynjh	trench
trynkl	trinkle
trynth	trench
tryntj	tryntje
trynt	trent
trynvr	bryner
tryps	fryes
tryq	arya
trys	torys
trystnsys	britneys
trystrm	tristram
trysy	topsy
trysy	topsy
try	fry
try	fry
try	fry
try	fry
trytl	tritle
trytl	tritle
trytvry	tartary
tryvlv	travis
tryvrays	ararats
tryvr	pryor
tryvytz	bryant
trzh	arch
tskr	ask
tsla	tesla
tslr	esler
tsnr	sir
tsta	testa
ts	ts
tstr	aster
tsyma	asama
tsynk	sunk
ttjy	stoy
ttrad	tetrad
ttr	tor
ttrv	atri
ttrvyn	bruyn
tvama	tuama
tvary	avery
tvaycl	taco
tvb	tb
tvbvtys	tibets
tvbyas	libyas
tvbyn	robyn
tvdar	adar
tvd	tad
tvfry	avery
tvfth	taft
tvhla	avila
tvkr	ivar
tvk	tak
tvkyv	tokyo
tvlany	tolani
tvla	tula
tvlay	clay
tvldv	aldo
tvlmn	talman
tvl	tl
tvlyn	allyn
tvly	daly
tvly	daly
tvly	daly
tvlyvr	helyar
tvlyv	allyn
tvmany	tomany
tvmas	tamas
tvmas	tamas
tvmatyvs	almatys
tvmbly	twombly
tvms	tims
tvm	tam
tvmy	amy
tvmy	amy
tvmy	amy
tvmytyvs	almatys
tvmz	tam
tvnar	tonar
tvnga	tonga
tvng	tang
tvng	tang
tvng	tang
tvnjs	tanis
tvnr	ivar
tvns	anns
tvn	tin
tvnys	sonys
tvnys	sonys
tvnys	sonys
tvny	tiny
tvrad	avram
tvrambr	turambar
tvraya	tarawa
tvrbr	tarr
tvrda	torda
tvrkat	avram
tvrkv	turk
tvrldh	torah
tvrmala	tormala
tvrmn	tern
tvrnbrg	tornberg
tvrnly	barney
tvrnr	tarr
tvrn	tern
tvrn	tern
tvrntvn	tanton
tvrp	earp
tvrtl	turtle
tvrtn	tern
tvrtvn	turton
tvrvf	aviva
tvrvp	aviva
tvrya	arya
tvryn	bryn
tvrysn	torys
tvry	tory
tvrz	marz
tvsar	cesar
tvskanv	tasman
tvs	avs
tvsv	avs
tvsyng	tusing
tvsynk	tesink
tv	av
tv	av
tvty	ivy
tvvys	levys
tvyda	ayda
tvydy	teddy
tvyh	ivy
tvyn	avon
tvyt	ivy
tvyt	ivy
tvyydyl	lyndel
tvyyg	tyng
tvyyn	abyan
tybat	bat
tybl	sybil
tybvt	tibet
tycavr	bacar
tyd	tad
tyf	ty
tyfvrd	alford
tygv	togo
tyhan	tehan
'tyh	ptah
tyjath	ayah
tyjmn	lymn
tylbry	tilbury
tyldn	dylan
tylgnr	tilgner
tylmans	tysmans
tylmns	dylans
tylmnz	ayling
tyln	ayn
tylr	tyler
tylr	tyler
tylv	kyle
tylvtsan	sylvan
tylyng	ayling
tymbvl	timbol
tymkv	timko
tymn	lymn
tymn	lymn
tym	pym
tymvnyn	timonin
tymvr	gymer
tymyan	ayman
tymynz	tymen
tymz	lyme
tynant	anant
tyna	dyna
tyndal	tyndale
tyndal	tyndale
tyngly	tingley
tyng	tyng
tyng	tyng
tynsl	tinsel
tynsly	tinsley
tyn	ayn
tyn	ayn
tyn	ayn
tyny	tiny
typal	nepal
typv	pype
tyrny	byrne
tyrvks	turks
tyryh	torah
tyry	tory
tyrza	tirza
tysmnz	tysmans
tys	tys
tysynjr	tessner
tysza	tisza
ty	ty
tytay	tatar
tyth	myth
tytmas	tamas
tyts	tets
tyt	tat
tyt	tat
tyty	katy
tyvga	tioga
tyvmynn	tymen
tyvna	dyna
tyvnys	bennys
tyvnys	bennys
tyv	ty
tyyvln	kayvon
tyz	ty
vadaparty	vadaparty
vadh	ada
vadry	badry
vadzn	adan
vafa	afa
vafyah	ayah
vafya	vaya
vagl	vail
vagnr	vagner
vagnr	vagner
vagn	van
vah	mah
vajdyk	vajdic
vakfyld	alfeld
vakrdayn	vardan
vakvrn	ahern
valans	alans
valas	salas
valdmanyvna	ramayana
valdmnna	alcmena
valdmnnyvyna	waldmanneuenna
valdmnyvna	alcmena
valdram	waldram
valdv	aldo
valdz	valdez
valh	val
valka	walka
valknar	malnar
valmn	alan
valntyjn	valentijn
valntyn	valentin
valn	val
valryn	allyn
valtmn	altman
valtn	alan
valtr	valur
valtrz	valdez
valtvn	alton
valt	kalt
val	val
val	val
valvm	alim
valvrt	calvert
valvr	valur
valv	val
valvyn	allyn
val	val
valyhvr	valihora
valyngtn	alington
valyngtvn	alington
valyn	alan
valys	vals
valys	vals
valy	daly
valy	daly
valy	daly
valy	daly
valyy	alya
valz	val
vambvl	abel
vanantvrp	vanantwerp
vananvrp	vanantwerp
vanatvrp	ganatra
vanbrn	vanburen
vanbvrn	vanburen
vandnbrq	vandry
vandn	vanden
vandrvyr	vandry
vandrvyyr	vanderveer
vandvsn	vanden
vandvzn	vanden
vandyk	vandyck
vandzn	vanden
vandzvn	vanden
vang	vang
vank	bank
vankvrn	anckorn
vankvrn	anckorn
vanscvnhvn	anshan
vansk	ask
vanskvnhvn	anshan
vansy	pansy
van	van
vanvlk	vanick
vanvrankn	vanvranken
vanvrnkn	vanvranken
van	van
vanzant	vanzandt
vanzndt	vanzandt
varbrg	barbra
varbrtvn	warburton
varbrvg	barbra
varbrvq	barbra
varbvrvg	aberg
varbvrv	arber
vardy	hardy
vargas	vargas
vargv	vargo
varma	varma
varnr	arne
varnr	arne
varns	varnes
varn	barn
varn	barn
varny	varney
vartvn	barton
varty	varty
varvl	varvel
varyans	aryans
varyants	variants
varyantz	variants
varyvr	arber
vasalv	casals
vasky	ask
vaslv	basle
vasm	aim
vasngtn	mangan
vasngtvn	alington
vast	east
vast	east
vasvn	basin
vas	as
vas	as
vasyk	ask
vasym	asim
vasyngtvn	alington
vasyt	basit
vatanab	matana
vatanyb	latonya
vatkynz	atkins
vatrhavs	atrias
vatrmn	katrin
vatrsvn	carson
vatrz	atri
vats	ats
vatv	vato
vat	at
vavdray	vandry
vavdry	vandry
vaya	vaya
vayb	vaya
vayby	abby
vaydmn	hayden
vayd	vaya
vaygl	vail
vayldr	aylor
vayl	vail
vaymn	ayman
vayngrv	gaynor
vaynth	zaynah
vayn	ayn
vaypkj	kayak
vaysmn	ayson
vays	fays
vaythavs	cathays
vaythrn	anthon
vaythvrn	ahern
vaythvs	antevs
vaytvrs	ayers
vaytykr	hayter
vaytykr	hayter
vayzak	ganzak
vayz	vaya
vbr	br
vbstr	obst
vb	b
vcnr	cr
vdad	vlad
vdbrg	edberg
vdlmvdy	addy
vdlyn	allyn
vdmyr	dayr
vd	cd
vfa	afa
vfyah	ayah
vfyh	vaya
vfyyh	ayah
vgl	val
vgl	val
vgnr	agni
vgnr	agni
vhra	vera
vjdan	adan
vjyha	vaya
vjyhh	ayah
vjyh	vaya
vkkya	kaya
vkrfas	vargas
vkrv	harv
vk	bk
vladak	ladak
vladan	vladan
vladv	vlad
vlam	elam
vlan	alan
vla	ala
vla	ala
vldmn	aldan
vldmnvna	alcmena
vldmn	aldan
vldn	alan
vld	ved
vlfsvn	alison
vlkman	volkman
vlk	vik
vlk	vik
vlmjh	allah
vlmn	alan
vlmth	blyth
vlmtj	alm
vlmt	alm
vlnta	alta
vlntyjn	valentijn
vlntyn	allyn
vlr	lr
vlsky	bosky
vls	als
vlsy	als
vltmr	vitor
vltr	alar
vltryng	strong
vltry	flory
vlty	alta
vlvdyn	vladan
vlvsv	lvov
vlydh	blyth
vlyngtvn	alington
vlynk	blank
vlys	alps
vlys	alps
vlzl	all
vlz	elz
vlz	elz
vnabls	anabels
vnantvrp	vanantwerp
vnascvnvn	anacin
vnbrn	vern
vnbvrn	anbar
vncvnhvvn	inchon
vnc	inc
vndazn	adan
vndlnd	anand
vndl	and
vndl	and
vndmn	vanden
vndrfvrd	vanderford
vndrvr	ander
vndrvyr	vandry
vndry	vandry
vndvsn	andean
vndvvsn	andaman
vndvzn	andean
vndvzn	andean
vnd	and
vndyk	andy
vndzl	vandal
vng	eng
vnhf	enif
vnkata	venkata
vnkat	venkat
vnkrn	vern
vnkrn	vern
vnkvrn	anckorn
vnkvrn	anckorn
vnkv	nev
vnkyvrn	anckorn
vnkyvrn	anckorn
vnlk	volk
vnntvrp	anntar
vnrnkn	vernon
vnr	air
vnrypr	nayar
vnskvnhvvn	anshan
vnsl	anil
vns	ins
vnsvnhavn	anshan
vnsvnhvvn	anshan
vntrly	anatoly
vntz	bentz
vn	in
vnvlk	vivek
vn	in
vnvrankn	vanvranken
vn	in
vn	in
vn	in
vnyk	enyo
vnylk	volk
vnyngr	bryner
vnyrnkn	vernon
vnzandt	vanzandt
vnzant	anant
vnznd	anand
vnznt	anant
vrbk	ark
vrbvrvf	arber
vrcyk	ack
vrdan	vardan
vrhvst	brest
vrkmn	aiken
vrlv	grov
vrlynd	allyn
vrlyng	arling
vrmasrn	ermas
vrmas	ermas
vrma	erma
vrmvln	craven
vrmvnt	vermont
vrmylyyvn	malayan
vrmyvln	argyle
vrmz	ariz
vrngryn	vandry
vrnn	venn
vrnr	arne
vrsvvn	craven
vrvbl	orval
vrvjh	arch
vrvth	frith
vrvvd	arend
vrvvtj	arlet
vrvyj	arya
vrylav	arya
vrylv	aral
vryty	bruty
vry	fry
vsal	sal
vslyan	kalyan
vsly	sly
vslz	volz
vsm	sm
vstal	vestal
vstfal	vestal
vstly	astley
vstly	astley
vstmvrlnd	strand
vstn	aston
vstrhlm	stream
vstrn	aston
vstrvldt	astrid
vstrvlt	strait
vstr	aster
vst	st
vstvn	aston
vstvr	aster
vst	st
vst	st
vs	vs
vsym	asim
vsyt	sat
vsy	vs
vsy	vs
vtmvr	otmar
vtr	air
vtr	air
vts	ats
vt	at
vvdard	adar
vvdbrn	dorn
vvdd	budd
vvdgyt	addy
vvdhavs	vedas
vvdn	avon
vvdrv	adri
vvdvard	edvard
vvd	ved
vvglr	vogl
vvgl	vogl
vvg	ag
vvjak	vojak
vvk	vik
vvlard	allard
vvlard	allard
vvlmn	velma
vvltrnyng	coltrane
vvly	daly
vvlz	volz
vvn	van
vvn	van
vvrdn	vardan
vvrylav	arya
vvrylv	beryl
vvs	avs
vvtr	ivar
vyann	ann
vybh	ayah
vybkh	ayah
vybrnd	abend
vybvvv	bev
vyb	yb
vyby	abby
vycard	picard
vycvra	lycra
vydad	ayda
vydal	vidal
vydal	vidal
vyda	ayda
vydd	ayda
vydfang	neufang
vydman	ayman
vydmn	lymn
vydmr	ryder
vydry	badry
vydvn	ryden
vyd	ved
vydyr	ryder
vydy	addy
vydyv	addy
vyfal	rafal
vygand	hyland
vygand	hyland
vygjyn	bygden
vygly	lyly
vygmvr	gymer
vygn	ayn
vygrt	agra
vygstvn	wigston
vygtvn	bygden
vyg	ag
vygynz	vigen
vyjbrand	wijbrand
vyjbrnd	wijbrand
vyjdan	vardan
vyjnand	wijnand
vyjnd	abend
vyjnnd	dymond
vyjn	ayn
vykamp	eckam
vykas	vikas
vykavn	ayman
vykfyld	alfeld
vykham	vikram
vyklvnd	eklund
vyknz	ayn
vykram	vikram
vykrs	ayers
vykrz	ayers
vyks	bks
vyks	bks
vyktvr	viktor
vyktvr	viktor
vyktym	varty
vyk	vik
vyk	vik
vyk	vik
vyk	vik
vyladvt	viladot
vylard	allard
vylard	allard
vylaskv	alaska
vylas	vilas
vylatz	blatz
vyla	vela
vyla	vela
vylbr	aylor
vyldkat	veldman
vyldrmn	aldrin
vyldyng	ayling
vylfrd	alford
vylfrd	alford
vylhayt	melhart
vylhlmas	valhallas
vylhlmvs	valhallas
vylhlm	balham
vyljv	viljo
vylkaks	balkans
vylkans	balkans
vylkas	velmas
vylkns	dylans
vylkn	dylan
vylkrsvn	fulkerson
vylkynsn	balkans
vylkynsvn	wilkinson
vylkyn	allyn
vylkynz	allyn
vyllmvs	velmas
vylmntjy	almaty
vylmr	aylor
vylmtjy	aaltje
vylmt	velma
vylmvr	aylor
vylmvt	aylott
vylmynth	belmont
vylmyntjh	belmont
vylmyntj	belmont
vylmynt	belmont
vylmynyth	aliyyah
vylnd	hyland
vylnd	hyland
vylnr	aylor
vylr	aylor
vylr	aylor
vylsvn	ayson
vyls	vals
vyl	val
vyl	val
vyl	val
vylyam	alya
vylyamyna	lamina
vylyany	albany
vylyngham	bingham
vylyngz	ayling
vylyr	aylor
vyly	lyly
vyly	lyly
vyly	lyly
vylz	volz
vylz	volz
vymal	vimal
vyman	ayman
vyman	ayman
vymbrly	kimberly
vymn	lymn
vymph	rumph
vympjh	rumph
vympj	ayman
vympjy	campey
vymp	kemp
vympyj	ampon
vymr	byer
vynata	vinata
vynbrg	nyberg
vyncstr	anchor
vyndn	bynon
vyndrz	vandry
vyndvm	lynda
vynd	and
vynklman	monkman
vynkl	vinko
vynklz	finkle
vynkv	vinko
vynlt	aint
vynnd	lynn
vynn	lynn
vynrt	aint
vynr	ayn
vynsnt	anant
vynsn	bynon
vynsr	tynor
vynstd	ernst
vynstrvm	winstrom
vynstvk	alnitak
vynstvn	dunstan
vynsvn	vinson
vynth	lynch
vyntjh	eyntje
vyntj	eyntje
vyntjy	eyntje
vyntrfyld	winterfeld
vyntrmyvt	gantry
vyntrr	anntar
vyntr	pyotr
vyntrz	bentz
vyntvn	anton
vynt	aint
vyntz	bentz
vyn	ayn
vynvkr	denver
vyn	ayn
vynybl	lyndel
vynyky	funky
vynyngr	venner
vynyngstd	byungse
vynyz	allyz
vynz	ayn
vypkjh	ayah
vypkj	eyck
vypkjy	gypsy
vypk	eyck
vypyn	vipin
vyraf	viraf
vyrcval	lyrical
vyrjyl	beryl
vyrjynya	arjuna
vyrndra	virendra
vyrn	vern
vyrsma	varma
vyrtann	virtanen
vyrt	art
vyr	cyr
vyr	cyr
vyr	cyr
vyryana	wiryana
vyrz	byra
vysal	lysol
vyska	laska
vysl	ayse
vyspy	vispi
vysr	ayse
vysr	ayse
vystfal	vestal
vystvn	alston
vyst	myst
vys	tys
vysvn	ayson
vysvn	ayson
vysy	ayse
vysyvs	dysons
vytaka	jataka
vytakr	altair
vytal	antal
vytfyld	alfeld
vytkamb	kamb
vytkvs	antevs
vytmr	vitor
vytmvr	gymer
vytnbrg	byung
vytn	ayn
vytn	ayn
vytsh	ayush
vytsvn	aitsen
vyt	ait
vytvl	antal
vytvr	vitor
vytvrya	arya
vytv	kyte
vyt	ait
vyt	ait
vyt	ait
vytykr	vetter
vytyk	vitek
vytyngtvn	symington
vytz	bitz
vyva	viva
vy	ivy
vyvks	eycks
vyvk	eyck
vyvla	ayala
vyvr	byer
vyvvr	aylor
vyvyanh	vivian
vyvyan	vivian
vyvyk	vivek
vy	ivy
vy	ivy
vy	ivy
vyyrs	ayers
vyzbrand	brand
vyznand	anand
vyznry	henry
vyzn	ayn
vyzrnr	byrne
vyzvn	vizen
vzda	veda
vzyna	azana
xaldah	aldan
xalydh	aaliyah
xan	dan
xay	day
xlyda	alya
xlydh	blyth
xlylh	blyth
xrdl	aral
yagla	yagla
yagr	yager
yakvb	yacob
yakvlty	kelty
yakvtah	yakootah
yakvta	akita
yamaha	yamaha
yamaha	yamaha
yamha	yamha
yamn	yan
yamynah	yaminah
yamyna	aamina
yangr	yang
yang	yang
yangy	yang
yansvn	yanson
yanvvytz	yanowitz
yan	yan
yanyv	yaniv
yanzk	yank
yap	yap
yargr	argo
yarla	carla
yarman	yarman
yarvn	yaron
yarvs	yaros
yaryan	yaryan
yasar	yasar
yasr	yasar
yasyn	yasin
yasyrah	yasirah
yasyrh	yasar
yasy	amy
yats	ats
yav	av
yayn	ayn
ykvtah	akilah
ylnd	and
ylyc	alec
ylyf	alf
ymha	yamha
ymn	lymn
ymynh	myth
'yn	ayn
yrbry	drury
yrmys	amys
ysra	afra
ysryh	arch
ysyrah	sarah
ysyra	byra
ysyrh	ayah
ytr	air
yvbyra	byra
yvfyngtvn	uffington
yvhans	chans
yvkylv	jekyll
yvk	yok
yvlyn	allyn
yvmans	ammans
yvmn	yumn
yvmvra	almira
yvnal	kanal
yvnas	yonas
yvngsap	yongsup
yvn	yan
yvnsvn	yanson
yvn	yan
yvnyza	kenya
yvranym	avraham
yvrbanyk	burbank
yvrk	york
yvrmv	yermo
yvryna	arya
yvsf	avs
yvstn	yasin
yvs	avs
yvsyv	avs
yvsy	avs
yvsy	avs
yvzf	yves
yvzr	ivar
yyka	yeka
yyk	yok
yytz	bitz
yytz	bitz
yzak	yzaak
yzk	yok
yzyd	azad
zabl	zabel
zabz	aba
zacary	zachary
zafyna	zafina
zagar	zagar
zahd	fahd
zahyd	zahid
zakvb	zaki
zakvb	zaki
zakvmyntay	jacomyntie
zakyvs	akers
zak	bak
zaky	laky
zalan	zalan
zamvr	amir
zamyt	amit
zangrl	zangerl
zan	dan
zankh	bank
zanky	anay
zank	bank
zans	gans
zant	iant
zapara	zapara
zara	zara
zarrytn	arron
zarvs	zaras
zarya	arya
zaryh	arch
zarytn	aryan
zarytzn	aryan
zatrvvd	aird
zaynah	zaynah
zayna	zaynah
zayra	mayra
zayr	dayr
zaza	zaza
zfry	fry
zfyna	dyna
zfynh	zaynah
zhra	zahra
zhra	zahra
zhra	zahra
zhyd	boyd
zhyrah	zahirah
zhyra	byra
zhyrh	ahern
zjarytjn	marytje
zjarytn	aryan
zkh	aka
zkyah	ayah
zkyh	sky
zky	sky
zk	bk
zk	bk
zla	ala
zlr	lr
zltj	alta
zlykah	lylah
zlyxa	alya
zmank	amand
zman	man
zmyran	amran
zmyt	amit
zng	eng
znk	zn
zntnr	zentner
znykh	ayah
zn	zn
zpka	zepka
zra	ara
zrya	arya
zryfa	arya
zryf	arya
zryh	arch
zrynk	brink
zry	fry
zvhans	chans
zvhansn	chans
zvka	aka
zvld	zold
zvl	zyl
zvlmr	zelma
zvly	daly
zvlyka	alya
zvntk	zontek
zvrynk	zurink
zvrysyka	alaska
zvtrvd	astrid
zvtrvvd	astrid
zvvayta	vaya
zvvyta	avesta
zvyta	evita
zvytrvvd	astrid
zvzf	zaza
zygmvnt	zygmunt
zylt	zyl
zyl	zyl
zymran	amran
zynah	zaynah
zyna	dyna
zynb	ayn
zynh	ayah
zynsr	tynor
zyra	byra
zyryly	bayly
zyr	cyr
zytv	kyte
zyvrynk	zoerink
zyvtrvd	astrid
zyzy	lyly
zza	zaza
zz	hz
